state,positive,negative,pending,hospitalizedCurrently,hospitalizedCumulative,inIcuCurrently,inIcuCumulative,onVentilatorCurrently,onVentilatorCumulative,recovered,dataQualityGrade,death,hospitalized,totalTestsViral,positiveTestsViral,negativeTestsViral,positiveCasesViral,deathConfirmed,deathProbable,positiveIncrease,negativeIncrease,total,totalTestResults,totalTestResultsIncrease,posNeg,deathIncrease,hospitalizedIncrease
AL,82366,583033,0,1598,9893,379,1094,180,584,32510,B,1491,9893,663342,39620,407151,80309,1446,45,1251,6189,665399,665399,7440,665399,0,199
AR,40181,449725,0,501,2686,379,759,110,377,33188,A,428,2686,489906,39620,407151,40181,1900,149,734,4281,489906,489906,5015,489906,20,62
AS,0,1037,0,961,5109,379,759,180,197,0,C,0,5109,485619,39620,407151,0,1900,149,0,0,1037,1037,0,1037,0,0
AZ,165934,724997,0,2564,9394,814,759,574,197,21626,A+,3408,9394,890931,39620,407151,137710,2431,152,2107,10491,890931,890931,12598,890931,104,1643
CA,466550,6951316,0,8317,5109,2198,759,180,197,0,B,8518,5109,7417866,39620,407151,466550,1900,149,6000,115288,7417866,7417866,121288,7417866,73,0
CO,44565,455865,0,359,6271,379,759,180,197,5212,A,1668,6271,485619,39620,407151,41400,1900,149,229,2413,500430,500430,2642,500430,7,3
CT,49077,703611,0,54,10712,379,759,180,197,8516,B,4423,10712,750700,39620,407151,47089,3541,882,94,7543,752688,752688,7637,752688,5,0
DC,11945,166077,0,106,5109,20,759,9,197,9664,A+,583,5109,485619,39620,407151,38775,1900,149,87,3787,178022,178022,3874,178022,1,0
DE,14476,160147,0,62,5109,14,759,180,197,8076,A+,580,5109,485619,39620,407151,13480,510,70,70,1494,174623,174623,1564,174623,1,0
FL,441977,3038322,3017,8992,25280,379,759,180,197,0,A,6240,25280,4485040,555415,3912374,441977,6240,149,9230,39572,3483316,3480299,48802,3480299,191,590
GA,175052,1312274,0,3157,17544,379,3236,180,197,0,A,3563,17544,1487326,160824,1326502,175052,1900,149,4209,30154,1487326,1487326,34363,1487326,54,406
GU,349,20443,0,5,5109,2,759,180,197,291,B,5,5109,20773,39620,407151,341,1900,149,3,308,20792,20792,311,20792,0,0
HI,1711,112432,0,39,165,379,759,180,197,1191,D,26,165,143791,39620,407151,38775,1900,149,28,0,114143,114143,28,114143,0,2
IA,42777,414658,0,253,5109,75,759,31,197,30623,A+,839,5109,485619,39620,407151,42777,1900,149,223,2367,457435,457435,2590,457435,6,0
ID,18694,152023,0,209,750,40,224,180,197,5964,A,152,750,169588,39620,407151,17565,130,22,517,2206,170717,170717,2723,170717,6,9
IL,174973,2396734,0,1383,5109,329,759,128,197,0,A,7638,5109,2570465,39620,407151,173731,7446,192,1076,27255,2571707,2571707,28331,2571707,30,0
IN,63678,653131,0,907,8505,304,1772,69,197,44548,A+,2924,8505,485619,39620,407151,38775,2725,199,771,8247,716809,716809,9018,716809,18,61
KS,26172,252764,0,212,1644,58,465,24,171,1108,A+,335,1644,485619,39620,407151,38775,1900,149,0,0,278936,278936,0,278936,0,0
KY,28126,529587,0,584,3279,115,1132,180,197,7470,B,719,3279,485619,39620,407151,26656,715,4,525,9738,557713,557713,10263,557713,10,3
LA,111038,1165266,0,1583,5109,379,759,214,197,61456,A,3812,5109,485619,39620,407151,38775,3700,112,1121,15161,1276304,1276304,16282,1276304,26,0
MA,116182,1024934,0,364,11855,54,759,27,197,96452,A+,8551,11855,1468395,39620,407151,108740,8331,220,256,9703,1141116,1141116,9959,1141116,15,22
MD,85524,782732,0,544,12389,150,759,180,197,5592,A,3458,12389,1144696,39620,407151,85524,3327,131,648,12090,868256,868256,12738,868256,11,50
ME,3838,155262,0,12,384,7,759,2,197,3319,A+,121,384,158695,4786,153711,3433,120,1,6,1653,159100,159100,1659,159100,2,1
MI,87958,1639924,0,670,5109,195,759,135,197,57502,A+,6421,5109,1751875,111951,1639924,79176,6170,251,785,26608,1727882,1727882,27393,1727882,16,0
MN,52281,927707,0,294,5028,138,1474,180,197,45987,A,1620,5028,979988,39620,407151,52281,1580,40,478,8784,979988,979988,9262,979988,4,67
MO,42101,610823,0,797,5109,379,759,112,197,0,B,1213,5109,846657,50511,794773,42101,1900,149,-949,11969,652924,652924,11020,652924,12,0
MP,40,11719,0,961,4,379,759,180,197,29,D,2,4,12745,39620,407151,40,2,149,0,0,11759,11759,0,11759,0,0
MS,54299,378834,0,1184,4103,288,759,169,197,35071,A+,1543,4103,432422,39620,407151,53588,1504,39,1342,4194,433133,433133,5536,433133,42,71
MT,3475,157933,0,62,205,379,759,180,197,2104,C,51,205,485619,39620,407151,3475,1900,149,94,2659,161408,161408,2753,161408,4,4
NC,116087,1547453,0,1244,5109,364,759,180,197,92302,A+,1820,5109,485619,39620,407151,116087,1820,149,1749,26315,1663540,1663540,28064,1663540,30,0
ND,6141,143905,0,35,343,379,759,180,197,4957,C,92,343,297512,39620,407151,6141,88,4,155,1525,150046,150046,1680,150046,1,6
NE,24899,236204,0,117,1587,379,759,180,197,18520,A,317,1587,485619,39620,407151,24899,1900,149,281,1995,261103,261103,2276,261103,1,17
NH,6500,149583,0,21,690,379,202,180,197,5688,B,409,690,485619,39620,407151,6500,1900,149,64,2410,156083,156083,2474,156083,0,2
NJ,180295,1804009,0,718,21321,112,759,50,197,32313,A+,15825,21321,485619,39620,407151,180295,13905,1920,483,-20,1984304,1984304,463,1984304,21,0
NM,19502,509388,0,159,2590,379,759,180,197,7459,B,619,2590,485619,39620,407151,19502,1900,149,460,7712,528890,528890,8172,528890,5,30
NV,44936,405950,0,1147,5109,319,759,191,197,1054,A+,759,5109,585736,39620,407151,44936,1900,149,1105,5102,450886,450886,6207,450886,20,0
NY,412878,5271668,0,648,89995,152,759,81,197,72813,A,25126,89995,485619,39620,407151,412878,1900,149,534,56863,5684546,5684546,57397,5684546,9,0
OH,86497,1312236,0,1144,10425,363,2488,176,197,61056,B,3382,10425,485619,39620,407151,81896,3118,264,1320,53315,1398733,1398733,54635,1398733,38,140
OK,33775,555351,0,596,2987,207,759,180,197,26363,A+,509,2987,595277,38785,555351,33775,1900,149,1089,19723,589126,589126,20812,589126,13,115
OR,17416,370240,0,230,1537,58,759,31,197,3736,A+,303,1537,485619,39620,370240,16546,1900,149,328,4762,387656,387656,5090,387656,14,23
PA,109384,1059776,0,716,5109,379,759,98,197,82038,A+,7146,5109,485619,39620,407151,106331,1900,149,1120,17352,1169160,1169160,18472,1169160,24,0
PR,15840,305972,0,469,5109,66,759,37,197,0,B,209,5109,310546,7002,303412,5585,104,105,409,0,321812,321812,409,321812,8,0
RI,18725,182235,0,68,2182,10,759,7,197,1803,A+,1005,2182,352500,27247,325253,18725,1900,149,210,4132,200960,200960,4342,200960,1,8
SC,84109,586221,0,1575,5117,401,759,256,197,32859,A+,1565,5117,669941,105449,564492,83720,1505,60,1692,9737,670330,670330,11429,670330,59,290
SD,8492,98999,0,49,808,379,759,180,197,7474,B,123,808,485619,39620,407151,38775,1900,149,48,616,107491,107491,664,107491,0,2
TN,96489,1314963,0,1420,4280,379,759,180,197,57239,A,978,4280,1410396,113557,1296839,95433,943,35,0,0,1411452,1411452,0,1411452,0,0
TX,394265,3082661,0,9593,5109,3136,759,180,197,244449,A,5877,5109,3476926,39620,407151,394265,1900,149,8342,39702,3476926,3476926,48044,3476926,164,0
UT,38855,475654,0,233,2295,90,592,180,240,25905,A+,286,2295,613190,39620,407151,38855,1900,149,446,4205,514509,514509,4651,514509,5,42
VA,86994,972416,436,1294,12844,261,759,153,197,11550,A+,2095,12844,1056148,39620,407151,83732,1991,104,922,19277,1059846,1059410,20199,1059410,13,704
VI,375,8295,37,961,5109,379,759,180,197,292,C,7,5109,485619,39620,407151,38775,7,149,11,262,8707,8670,273,8670,0,0
VT,1405,90456,0,18,5109,379,759,180,197,1194,B,56,5109,485619,39620,407151,1405,56,149,3,1241,91861,91861,1244,91861,0,0
WA,53321,879983,0,386,5397,379,759,49,197,0,B,1518,5397,485619,39620,407151,53321,1518,149,686,13271,933304,933304,13957,933304,17,23
WI,54064,837567,110,246,4493,86,880,180,197,39513,A+,913,4493,485619,39620,407151,50179,906,7,783,13662,891741,891631,14445,891631,13,73
WV,6173,263671,0,94,5109,37,759,15,197,4481,B,111,5109,485619,39620,407151,6033,1900,149,119,3692,269844,269844,3811,269844,5,0
WY,2589,48191,0,15,162,379,759,180,197,1970,B,26,162,71866,2155,69710,2136,1900,149,69,2368,50780,50780,2437,50780,1,4
AK,3206,204162,0,38,5109,379,759,3,197,817,A,21,5109,207264,39620,407151,3206,21,149,104,0,207368,207368,104,207368,1,0
AL,81115,576844,0,1599,9694,379,1081,180,577,32510,B,1491,9694,655973,39620,407151,79129,1446,45,1821,6452,657959,657959,8273,657959,18,537
AR,39447,445444,0,489,2624,379,759,110,369,32365,A,408,2624,484891,39620,407151,39447,1900,149,824,6800,484891,484891,7624,484891,7,82
AS,0,1037,0,961,5109,379,759,180,197,0,C,0,5109,485619,39620,407151,0,1900,149,0,0,1037,1037,0,1037,0,0
AZ,163827,714506,0,2626,7751,820,759,567,197,21321,A+,3304,7751,878333,39620,407151,137710,2431,152,1813,9417,878333,878333,11230,878333,-1,45
CA,460550,6836028,0,8820,5109,2284,759,180,197,0,B,8445,5109,7296578,39620,407151,460550,1900,149,6891,121548,7296578,7296578,128439,7296578,29,0
CO,44336,453452,0,365,6268,379,759,180,197,5182,A,1661,6268,485619,39620,407151,41174,1900,149,547,6845,497788,497788,7392,497788,0,7
CT,48983,696068,0,59,10712,379,759,180,197,8516,B,4418,10712,743062,39620,407151,46994,3536,882,207,31772,745051,745051,31979,745051,5,0
DC,11858,162290,0,102,5109,20,759,8,197,9639,A+,582,5109,485619,39620,407151,38775,1900,149,78,2472,174148,174148,2550,174148,1,0
DE,14406,158653,0,63,5109,18,759,180,197,8035,A+,579,5109,485619,39620,407151,13410,509,70,116,2950,173059,173059,3066,173059,0,0
FL,432747,2998750,2902,9098,24690,379,759,180,197,0,A,6049,24690,4411284,542920,3851809,432747,6049,149,8892,36102,3434399,3431497,44994,3431497,77,269
GA,170843,1282120,0,3181,17138,379,3172,180,197,0,A,3509,17138,1452963,156693,1296270,170843,1900,149,2890,21128,1452963,1452963,24018,1452963,11,47
GU,346,20135,0,4,5109,379,759,180,197,291,B,5,5109,20472,39620,407151,338,1900,149,9,440,20481,20481,449,20481,0,0
HI,1683,112432,0,26,163,379,759,180,197,1179,D,26,163,142900,39620,407151,38775,1900,149,63,0,114115,114115,63,114115,0,2
IA,42554,412291,0,241,5109,78,759,32,197,29873,A+,833,5109,485619,39620,407151,42554,1900,149,354,3892,454845,454845,4246,454845,6,0
ID,18177,149817,0,204,741,45,222,180,197,5731,A,146,741,166903,39620,407151,17086,125,21,350,1420,167994,167994,1770,167994,0,18
IL,173897,2369479,0,1417,5109,350,759,124,197,0,A,7608,5109,2542134,39620,407151,172655,7416,192,1231,29336,2543376,2543376,30567,2543376,18,0
IN,62907,644884,0,835,8444,291,1767,66,197,44124,A+,2906,8444,485619,39620,407151,38775,2709,197,535,5945,707791,707791,6480,707791,3,43
KS,26172,252764,0,212,1644,58,465,24,171,1108,A+,335,1644,485619,39620,407151,38775,1900,149,1063,-94,278936,278936,969,278936,9,48
KY,27601,519849,0,609,3276,131,1129,180,197,7466,B,709,3276,485619,39620,407151,26209,705,4,522,5030,547450,547450,5552,547450,9,10
LA,109917,1150105,0,1600,5109,379,759,208,197,61456,A,3786,5109,485619,39620,407151,38775,3674,112,2343,24415,1260022,1260022,26758,1260022,23,0
MA,115926,1015231,0,350,11833,57,759,28,197,96452,A+,8536,11833,1454584,39620,407151,108562,8317,219,289,10109,1131157,1131157,10398,1131157,7,5
MD,84876,770642,0,536,12339,145,759,180,197,5434,A,3447,12339,1120761,39620,407151,84876,3315,132,1128,15818,855518,855518,16946,855518,7,56
ME,3832,153609,0,13,383,8,759,3,197,3292,A+,119,383,157031,4766,152067,3422,118,1,18,2105,157441,157441,2123,157441,0,2
MI,87173,1613316,0,670,5109,195,759,113,197,57502,A+,6405,5109,1723892,110576,1613316,78507,6154,251,512,29233,1700489,1700489,29745,1700489,5,0
MN,51803,918923,0,257,4961,126,1458,180,197,45198,A,1616,4961,970726,39620,407151,51803,1576,40,650,12702,970726,970726,13352,970726,2,41
MO,43050,598854,0,1057,5109,379,759,159,197,0,B,1201,5109,830014,47812,780858,43050,1900,149,1123,13830,641904,641904,14953,641904,4,0
MP,40,11719,0,961,4,379,759,180,197,29,D,2,4,12745,39620,407151,40,2,149,0,419,11759,11759,419,11759,0,0
MS,52957,374640,0,1179,4032,304,759,166,197,35071,A+,1501,4032,426926,39620,407151,52286,1464,37,653,3851,427597,427597,4504,427597,6,50
MT,3381,155274,0,61,201,379,759,180,197,2090,C,47,201,485619,39620,407151,3381,1900,149,39,6301,158655,158655,6340,158655,1,2
NC,114338,1521138,0,1169,5109,352,759,180,197,92302,A+,1790,5109,485619,39620,407151,114338,1790,149,1625,20466,1635476,1635476,22091,1635476,5,0
ND,5986,142380,0,43,337,379,759,180,197,4829,C,91,337,293191,39620,407151,5986,87,4,110,1777,148366,148366,1887,148366,0,4
NE,24618,234209,0,109,1570,379,759,180,197,18097,A,316,1570,485619,39620,407151,24618,1900,149,223,3140,258827,258827,3363,258827,0,3
NH,6436,147173,0,20,688,379,200,180,197,5438,B,409,688,485619,39620,407151,6436,1900,149,0,0,153609,153609,0,153609,0,0
NJ,179812,1804029,0,695,21321,128,759,54,197,32275,A+,15804,21321,485619,39620,407151,179812,13884,1920,449,30103,1983841,1983841,30552,1983841,17,7
NM,19042,501676,0,144,2560,379,759,180,197,7349,B,614,2560,485619,39620,407151,19042,1900,149,254,8039,520718,520718,8293,520718,7,18
NV,43831,400848,0,1112,5109,310,759,184,197,1019,A+,739,5109,575427,39620,407151,43831,1900,149,988,4760,444679,444679,5748,444679,5,0
NY,412344,5214805,0,642,89995,149,759,84,197,72766,A,25117,89995,485619,39620,407151,412344,1900,149,608,56662,5627149,5627149,57270,5627149,11,0
OH,85177,1258921,0,1110,10285,356,2466,164,197,59413,B,3344,10285,485619,39620,407151,80628,3082,262,1104,16563,1344098,1344098,17667,1344098,37,86
OK,32686,535628,0,625,2872,225,759,180,197,25252,A+,496,2872,573185,36489,535628,32686,1900,149,1401,0,568314,568314,1401,568314,0,37
OR,17088,365478,0,237,1514,58,759,27,197,3684,A+,289,1514,485619,39620,365478,16240,1900,149,330,3761,382566,382566,4091,382566,0,40
PA,108264,1042424,0,704,5109,379,759,98,197,81198,A+,7122,5109,485619,39620,407151,105228,1900,149,839,13648,1150688,1150688,14487,1150688,4,0
PR,15431,305972,0,509,5109,66,759,37,197,0,B,201,5109,310546,7002,303412,5416,99,102,288,0,321403,321403,288,321403,0,0
RI,18515,178103,0,71,2174,8,759,6,197,1792,A+,1004,2174,345652,26961,318691,18515,1900,149,291,6299,196618,196618,6590,196618,2,28
SC,82417,576484,0,1668,4827,379,759,263,197,29378,A+,1506,4827,658555,103238,555317,82071,1452,54,1218,9870,658901,658901,11088,658901,15,0
SD,8444,98383,0,47,806,379,759,180,197,7404,B,123,806,485619,39620,407151,38775,1900,149,49,-148,106827,106827,-99,106827,0,5
TN,96489,1314963,0,1328,4280,379,759,180,197,57239,A,978,4280,1410396,113557,1296839,95433,943,35,2553,26047,1411452,1411452,28600,1411452,11,36
TX,385923,3042959,0,10893,5109,3281,759,180,197,229107,A,5713,5109,3428882,39620,407151,385923,1900,149,4267,54640,3428882,3428882,58907,3428882,675,0
UT,38409,471449,0,225,2253,83,580,180,239,25321,A+,281,2253,607008,39620,407151,38409,1900,149,436,4071,509858,509858,4507,509858,7,19
VA,86072,953139,379,1200,12140,260,759,140,197,10940,A+,2082,12140,1036010,39620,407151,82871,1978,104,1505,9466,1039590,1039211,10971,1039211,4,84
VI,364,8033,13,961,5109,379,759,180,197,250,C,7,5109,485619,39620,407151,38775,7,149,3,42,8410,8397,45,8397,0,0
VT,1402,89215,0,13,5109,379,759,180,197,1190,B,56,5109,485619,39620,407151,1402,56,149,2,806,90617,90617,808,90617,0,0
WA,52635,866712,0,396,5374,379,759,42,197,0,B,1501,5374,485619,39620,407151,52635,1501,149,786,14887,919347,919347,15673,919347,7,33
WI,53281,823905,104,250,4420,85,872,180,197,38633,A+,900,4420,485619,39620,407151,49417,893,7,601,6356,877290,877186,6957,877186,1,26
WV,6054,259979,0,85,5109,37,759,10,197,4332,B,106,5109,485619,39620,407151,5913,1900,149,94,4213,266033,266033,4307,266033,3,0
WY,2520,45823,0,17,158,379,759,180,197,1915,B,25,158,67700,2031,65669,2072,1900,149,45,0,48343,48343,45,48343,0,0
AK,3102,204162,0,43,5109,379,759,4,197,817,A,20,5109,207264,39620,407151,3102,20,149,234,1964,207264,207264,2198,207264,0,0
AL,79294,570392,0,1505,9157,379,1076,180,573,32510,B,1473,9157,647743,39620,407151,77351,1428,45,1164,6911,649686,649686,8075,649686,17,0
AR,38623,438644,0,479,2542,379,759,105,358,31622,A+,401,2542,477267,39620,407151,38623,1900,149,1374,14429,477267,477267,15803,477267,7,181
AS,0,1037,0,961,5109,379,759,180,197,0,C,0,5109,485619,39620,407151,0,1900,149,0,0,1037,1037,0,1037,0,0
AZ,162014,705089,0,2650,7706,837,759,581,197,20978,A+,3305,7706,867103,39620,407151,137710,2431,152,1973,7521,867103,867103,9494,867103,19,79
CA,453659,6714480,0,8820,5109,2284,759,180,197,0,B,8416,5109,7168139,39620,407151,453659,1900,149,8259,112525,7168139,7168139,120784,7168139,79,0
CO,43789,446607,0,338,6261,379,759,180,197,5158,A,1661,6261,485619,39620,407151,40628,1900,149,809,9843,490396,490396,10652,490396,0,34
CT,48776,664296,0,71,10712,379,759,180,197,8516,B,4413,10712,711102,39620,407151,46806,3531,882,0,0,713072,713072,0,713072,0,0
DC,11780,159818,0,85,5109,22,759,9,197,9607,A+,581,5109,485619,39620,407151,38775,1900,149,63,2526,171598,171598,2589,171598,0,0
DE,14290,155703,0,57,5109,9,759,180,197,7996,A+,579,5109,485619,39620,407151,13294,509,70,115,2956,169993,169993,3071,169993,0,0
FL,423855,2962648,2871,8951,24421,379,759,180,197,0,A,5972,24421,4340661,531369,3793442,423855,5972,149,9344,40782,3389374,3386503,50126,3386503,78,335
GA,167953,1260992,0,3079,17091,379,3168,180,197,0,A,3498,17091,1428945,153305,1275640,167953,1900,149,2765,18340,1428945,1428945,21105,1428945,3,62
GU,337,19695,0,1,5109,379,759,180,197,244,B,5,5109,19791,39620,407151,329,1900,149,0,0,20032,20032,0,20032,0,0
HI,1620,112432,0,29,161,379,759,180,197,1167,D,26,161,140442,39620,407151,38775,1900,149,71,1191,114052,114052,1262,114052,0,5
IA,42200,408399,0,226,5109,77,759,29,197,29625,A+,827,5109,485619,39620,407151,42200,1900,149,529,3807,450599,450599,4336,450599,1,0
ID,17827,148397,0,204,723,45,217,180,197,5483,A,146,723,165132,39620,407151,16735,125,21,563,2221,166224,166224,2784,166224,2,14
IL,172666,2340143,0,1394,5109,345,759,119,197,0,A,7590,5109,2511567,39620,407151,171424,7398,192,1541,39303,2512809,2512809,40844,2512809,1,0
IN,62372,638939,0,834,8401,282,1758,62,197,43809,A+,2903,8401,485619,39620,407151,38775,2706,197,852,10185,701311,701311,11037,701311,8,221
KS,25109,252858,0,315,1596,98,459,24,166,1077,A+,326,1596,485619,39620,407151,38775,1900,149,0,0,277967,277967,0,277967,0,0
KY,27079,514819,0,595,3266,132,1126,180,197,7421,B,700,3266,485619,39620,407151,25699,696,4,315,0,541898,541898,315,541898,4,0
LA,107574,1125690,0,1557,5109,379,759,184,197,61456,A,3763,5109,485619,39620,407151,38775,3651,112,3840,29698,1233264,1233264,33538,1233264,48,0
MA,115637,1005122,0,364,11828,56,759,30,197,96452,A+,8529,11828,1440717,39620,407151,108380,8310,219,369,9507,1120759,1120759,9876,1120759,19,15
MD,83748,754824,0,540,12283,153,759,180,197,5434,A,3440,12283,1097361,39620,407151,83748,3309,131,694,12552,838572,838572,13246,838572,7,95
ME,3814,151504,0,14,381,10,759,3,197,3284,A+,119,381,154912,4744,149972,3408,118,1,24,1921,155318,155318,1945,155318,0,2
MI,86661,1584083,0,680,5109,210,759,113,197,57502,A+,6400,5109,1693712,109629,1584083,78019,6149,251,1589,54509,1670744,1670744,56098,1670744,0,0
MN,51153,906221,0,273,4920,115,1448,180,197,44431,A,1614,4920,957374,39620,407151,51153,1574,40,862,15816,957374,957374,16678,957374,3,31
MO,41927,585024,0,1057,5109,379,759,159,197,0,B,1197,5109,806753,47784,757625,41927,1900,149,1218,6012,626951,626951,7230,626951,15,0
MP,40,11300,0,961,4,379,759,180,197,29,D,2,4,12745,39620,407151,40,2,149,1,0,11340,11340,1,11340,0,0
MS,52304,370789,0,1172,3982,295,759,159,197,30315,A+,1495,3982,421233,39620,407151,51639,1458,37,1207,0,423093,423093,1207,423093,15,0
MT,3342,148973,0,62,199,379,759,180,197,2079,C,46,199,485619,39620,407151,3342,1900,149,82,1218,152315,152315,1300,152315,0,4
NC,112713,1500672,0,1170,5109,350,759,180,197,78707,A+,1785,5109,485619,39620,407151,112713,1785,149,1621,32722,1613385,1613385,34343,1613385,7,0
ND,5876,140603,0,42,333,379,759,180,197,4752,C,91,333,288801,39620,407151,5876,87,4,140,2079,146479,146479,2219,146479,0,5
NE,24395,231069,0,103,1567,379,759,180,197,18097,A,316,1567,485619,39620,407151,24395,1900,149,221,2638,255464,255464,2859,255464,0,19
NH,6436,147173,0,20,688,379,200,180,197,5438,B,409,688,485619,39620,407151,6436,1900,149,21,1298,153609,153609,1319,153609,0,2
NJ,179363,1773926,0,725,21314,126,759,54,197,32133,A+,15787,21314,485619,39620,407151,179363,13867,1920,505,64627,1953289,1953289,65132,1953289,11,0
NM,18788,493637,0,148,2542,379,759,180,197,7268,B,607,2542,485619,39620,407151,18788,1900,149,313,6935,512425,512425,7248,512425,6,17
NV,42843,396088,0,1147,5109,314,759,180,197,994,A+,734,5109,566376,39620,407151,42843,1900,149,1027,7383,438931,438931,8410,438931,2,0
NY,411736,5158143,0,637,89995,155,759,90,197,72716,A,25106,89995,485619,39620,407151,411736,1900,149,536,53032,5569879,5569879,53568,5569879,3,0
OH,84073,1242358,0,1075,10199,357,2444,177,197,58465,B,3307,10199,485619,39620,407151,79573,3049,258,889,31720,1326431,1326431,32609,1326431,10,54
OK,31285,535628,0,625,2835,225,759,180,197,24698,A+,496,2835,573185,36489,535628,31285,1900,149,1204,0,566913,566913,1204,566913,0,67
OR,16758,361717,0,233,1474,58,759,30,197,3541,A+,289,1474,485619,39620,361717,15273,1900,149,266,4199,378475,378475,4465,378475,3,0
PA,107425,1028776,0,707,5109,379,759,104,197,80568,A+,7118,5109,485619,39620,407151,104401,1900,149,800,12071,1136201,1136201,12871,1136201,4,0
PR,15143,305972,0,496,5109,61,759,34,197,0,B,201,5109,310546,7002,303412,5236,99,102,603,0,321115,321115,603,321115,0,0
RI,18224,171804,0,66,2146,6,759,5,197,1769,A+,1002,2146,329556,26593,302963,18224,1900,149,0,0,190028,190028,0,190028,0,0
SC,81199,566614,0,1668,4827,379,759,263,197,29378,A+,1491,4827,647470,101570,545900,80856,1436,55,1191,8132,647813,647813,9323,647813,26,0
SD,8395,98531,0,48,801,379,759,180,197,7364,B,123,801,485619,39620,407151,38775,1900,149,90,923,106926,106926,1013,106926,1,3
TN,93936,1288916,0,1313,4244,379,759,180,197,54730,A,967,4244,1381859,110435,1271424,92943,933,34,3140,47338,1382852,1382852,50478,1382852,3,48
TX,381656,2988319,0,10893,5109,3281,759,180,197,229107,A,5038,5109,3369975,39620,407151,381656,1900,149,5810,58123,3369975,3369975,63933,3369975,153,0
UT,37973,467378,0,251,2234,83,577,180,239,24798,A+,274,2234,600765,39620,407151,37973,1900,149,350,4862,505351,505351,5212,505351,0,21
VA,84567,943673,393,1174,12056,268,759,143,197,10882,A+,2078,12056,1025066,39620,407151,81393,1975,103,958,16839,1028633,1028240,17797,1028240,3,55
VI,361,7991,20,961,5109,379,759,180,197,238,C,7,5109,485619,39620,407151,38775,7,149,9,90,8372,8352,99,8352,0,0
VT,1400,88409,0,10,5109,379,759,180,197,1186,B,56,5109,485619,39620,407151,1400,56,149,4,989,89809,89809,993,89809,0,0
WA,51849,851825,0,407,5341,379,759,51,197,0,B,1494,5341,485619,39620,407151,51849,1494,149,1025,18667,903674,903674,19692,903674,-1,40
WI,52680,817549,77,165,4394,64,870,180,197,37971,A+,899,4394,485619,39620,407151,48827,892,7,965,9021,870306,870229,9986,870229,1,26
WV,5960,255766,0,82,5109,35,759,11,197,4168,B,103,5109,485619,39620,407151,5825,1900,149,139,4673,261726,261726,4812,261726,0,0
WY,2475,45823,0,14,158,379,759,180,197,1883,B,25,158,67700,2031,65669,2029,1900,149,29,0,48298,48298,29,48298,0,0
AK,2868,202198,0,38,5109,379,759,2,197,815,A,20,5109,205066,39620,407151,2868,20,149,120,4374,205066,205066,4494,205066,1,0
AL,78130,563481,0,1425,9157,379,1069,180,567,32510,B,1456,9157,639795,39620,407151,76314,1413,43,2125,10502,641611,641611,12627,641611,18,0
AR,37249,424215,0,497,2361,379,759,109,329,29827,A+,394,2361,461464,39620,407151,37249,1900,149,0,0,461464,461464,0,461464,0,0
AS,0,1037,0,961,5109,379,759,180,197,0,C,0,5109,485619,39620,407151,0,1900,149,0,0,1037,1037,0,1037,0,0
AZ,160041,697568,0,2758,7627,842,759,594,197,20566,A+,3286,7627,857609,39620,407151,137710,2431,152,3740,17052,857609,857609,20792,857609,144,166
CA,445400,6601955,0,8820,5109,2284,759,180,197,0,B,8337,5109,7047355,39620,407151,445400,1900,149,10066,121413,7047355,7047355,131479,7047355,151,0
CO,42980,436764,0,357,6227,379,759,180,197,5133,A,1661,6227,485619,39620,407151,39822,1900,149,666,8201,479744,479744,8867,479744,16,78
CT,48776,664296,0,71,10712,379,759,180,197,8516,B,4413,10712,711102,39620,407151,46806,3531,882,0,0,713072,713072,0,713072,0,0
DC,11717,157292,0,97,5109,28,759,9,197,9603,A+,581,5109,485619,39620,407151,38775,1900,149,68,3681,169009,169009,3749,169009,0,0
DE,14175,152747,0,55,5109,11,759,180,197,7961,A+,579,5109,485619,39620,407151,13179,509,70,-27,2623,166922,166922,2596,166922,1,0
FL,414511,2921866,2850,9035,24086,379,759,180,197,0,A,5894,24086,4263177,519405,3728507,414511,5894,149,12199,47542,3339227,3336377,59741,3336377,126,511
GA,165188,1242652,0,3094,17029,379,3158,180,197,0,A,3495,17029,1407840,150626,1257214,165188,1900,149,3787,21609,1407840,1407840,25396,1407840,53,277
GU,337,19695,0,1,5109,379,759,180,197,244,B,5,5109,19791,39620,407151,329,1900,149,0,563,20032,20032,563,20032,0,0
HI,1549,111241,0,29,156,379,759,180,197,1148,D,26,156,138354,39620,407151,38775,1900,149,59,1440,112790,112790,1499,112790,0,1
IA,41671,404592,0,220,5109,72,759,28,197,29477,A+,826,5109,485619,39620,407151,41671,1900,149,400,3990,446263,446263,4390,446263,3,0
ID,17264,146176,0,204,709,45,210,180,197,5251,A,144,709,162384,39620,407151,16208,123,21,528,2719,163440,163440,3247,163440,6,12
IL,171125,2300840,0,1438,5109,341,759,110,197,0,A,7589,5109,2470723,39620,407151,169883,7397,192,1426,36774,2471965,2471965,38200,2471965,12,0
IN,61520,628754,0,824,8180,281,1736,63,197,43535,A+,2895,8180,485619,39620,407151,38775,2698,197,922,10603,690274,690274,11525,690274,11,52
KS,25109,252858,0,315,1596,98,459,24,166,1077,A+,326,1596,485619,39620,407151,38775,1900,149,0,0,277967,277967,0,277967,0,0
KY,26764,514819,0,595,3266,132,1126,180,197,7421,B,696,3266,485619,39620,407151,25390,692,4,833,7274,541583,541583,8107,541583,5,18
LA,103734,1095992,0,1600,5109,379,759,197,197,61456,A,3715,5109,485619,39620,407151,38775,3603,112,0,0,1199726,1199726,0,1199726,0,0
MA,115268,995615,0,371,11813,50,759,27,197,96452,A+,8510,11813,1425973,39620,407151,108107,8291,219,621,24010,1110883,1110883,24631,1110883,26,43
MD,83054,742272,0,545,12188,157,759,180,197,5434,A,3433,12188,1075316,39620,407151,83054,3304,129,1288,19688,825326,825326,20976,825326,11,69
ME,3790,149583,0,11,379,8,759,2,197,3281,A+,119,379,152970,4715,148061,3387,118,1,33,2720,153373,153373,2753,153373,1,1
MI,85072,1529574,0,751,5109,215,759,113,197,55162,A+,6400,5109,1637017,107443,1529574,76541,6151,249,0,0,1614646,1614646,0,1614646,0,0
MN,50291,890405,0,287,4889,115,1440,180,197,43625,A,1611,4889,940696,39620,407151,50291,1571,40,803,17017,940696,940696,17820,940696,5,37
MO,40709,579012,0,1057,5109,379,759,159,197,0,B,1182,5109,795966,45726,748933,40709,1900,149,1357,5749,619721,619721,7106,619721,4,0
MP,39,11300,0,961,4,379,759,180,197,29,D,2,4,12745,39620,407151,39,2,149,1,0,11339,11339,1,11339,0,0
MS,51097,370789,0,1172,3982,295,759,159,197,30315,A+,1480,3982,421233,39620,407151,50444,1443,37,1434,8972,421886,421886,10406,421886,17,59
MT,3260,147755,0,59,195,379,759,180,197,1977,C,46,195,485619,39620,407151,3260,1900,149,221,1594,151015,151015,1815,151015,0,4
NC,111092,1467950,0,1168,5109,362,759,180,197,78707,A+,1778,5109,485619,39620,407151,111092,1778,149,2097,26648,1579042,1579042,28745,1579042,32,0
ND,5736,138524,0,39,328,379,759,180,197,4671,C,91,328,284082,39620,407151,5736,87,4,122,1430,144260,144260,1552,144260,3,3
NE,24174,228431,0,122,1548,379,759,180,197,17999,A,316,1548,485619,39620,407151,24174,1900,149,356,3175,252605,252605,3531,252605,0,0
NH,6415,145875,0,27,686,379,200,180,197,5438,B,409,686,485619,39620,407151,6415,1900,149,97,2401,152290,152290,2498,152290,4,5
NJ,178858,1709299,0,831,21314,143,759,56,197,32061,A+,15776,21314,485619,39620,407151,178858,13856,1920,513,0,1888157,1888157,513,1888157,11,130
NM,18475,486702,0,161,2525,379,759,180,197,7156,B,601,2525,485619,39620,407151,18475,1900,149,312,7880,505177,505177,8192,505177,5,25
NV,41816,388705,0,1147,5109,314,759,180,197,994,A+,732,5109,552480,39620,407151,41816,1900,149,931,7719,430521,430521,8650,430521,10,0
NY,411200,5105111,0,646,89995,149,759,94,197,72632,A,25103,89995,485619,39620,407151,411200,1900,149,750,70716,5516311,5516311,71466,5516311,13,0
OH,83184,1210638,0,1054,10145,356,2437,167,197,57731,B,3297,10145,485619,39620,407151,78735,3039,258,1438,24756,1293822,1293822,26194,1293822,0,73
OK,30081,535628,0,625,2768,225,759,180,197,24053,A+,496,2768,573185,36489,535628,30081,1900,149,965,41702,565709,565709,42667,565709,12,81
OR,16492,357518,0,233,1474,58,759,30,197,3541,A+,286,1474,485619,39620,357518,15273,1900,149,388,7055,374010,374010,7443,374010,4,0
PA,106625,1016705,0,709,5109,379,759,102,197,79968,A+,7114,5109,485619,39620,407151,103632,1900,149,1054,17328,1123330,1123330,18382,1123330,13,0
PR,14540,305972,0,496,5109,57,759,35,197,0,B,201,5109,310546,7002,303412,5042,99,102,573,0,320512,320512,573,320512,10,0
RI,18224,171804,0,66,2146,6,759,5,197,1769,A+,1002,2146,329556,26593,302963,18224,1900,149,0,0,190028,190028,0,190028,0,0
SC,80008,558482,0,1668,4827,379,759,263,197,29378,A+,1465,4827,638156,100090,538066,79674,1412,53,1401,7717,638490,638490,9118,638490,80,0
SD,8305,97608,0,46,798,379,759,180,197,7307,B,122,798,485619,39620,407151,38775,1900,149,105,2318,105913,105913,2423,105913,0,2
TN,90796,1241578,0,1414,4196,379,759,180,197,53808,A,964,4196,1331428,104656,1226772,89850,930,34,1718,8043,1332374,1332374,9761,1332374,26,76
TX,375846,2930196,0,10893,5109,3281,759,180,197,221510,A,4885,5109,3306042,39620,407151,375846,1900,149,6020,68091,3306042,3306042,74111,3306042,168,0
UT,37623,462516,0,232,2213,79,576,180,238,24390,A+,274,2213,594012,39620,407151,37623,1900,149,661,5407,500139,500139,6068,500139,1,25
VA,83609,926834,416,1201,12001,266,759,138,197,10800,A+,2075,12001,1007314,39620,407151,80480,1972,103,1245,18899,1010859,1010443,20144,1010443,8,175
VI,352,7901,20,961,5109,379,759,180,197,236,C,7,5109,485619,39620,407151,38775,7,149,16,401,8273,8253,417,8253,0,0
VT,1396,87420,0,13,5109,379,759,180,197,1182,B,56,5109,485619,39620,407151,1396,56,149,11,1113,88816,88816,1124,88816,0,0
WA,50824,833158,0,407,5301,379,759,52,197,0,B,1495,5301,485619,39620,407151,50824,1495,149,815,12404,883982,883982,13219,883982,13,25
WI,51715,808528,91,209,4368,75,868,180,197,37287,A+,898,4368,485619,39620,407151,47870,891,7,988,13248,860334,860243,14236,860243,13,41
WV,5821,251093,0,80,5109,35,759,11,197,4115,B,103,5109,485619,39620,407151,5687,1900,149,126,3615,256914,256914,3741,256914,0,0
WY,2446,45823,0,14,158,379,759,180,197,1866,B,25,158,67700,2031,65669,2008,1900,149,41,0,48269,48269,41,48269,0,3
AK,2748,197824,0,37,5109,379,759,1,197,800,A,19,5109,200572,39620,407151,2748,19,149,64,10999,200572,200572,11063,200572,0,0
AL,76005,552979,0,1570,9157,379,1058,180,565,32510,B,1438,9157,627344,39620,407151,74365,1395,43,1793,7664,628984,628984,9457,628984,41,162
AR,37249,424215,0,497,2361,379,759,109,329,29827,A+,394,2361,461464,39620,407151,37249,1900,149,990,13994,461464,461464,14984,461464,8,0
AS,0,1037,0,961,5109,379,759,180,197,0,C,0,5109,485619,39620,407151,0,1900,149,0,0,1037,1037,0,1037,0,0
AZ,156301,680516,0,2844,7461,837,759,575,197,20171,A+,3142,7461,836817,39620,407151,137710,2431,152,3357,10747,836817,836817,14104,836817,79,225
CA,435334,6480542,0,8820,5109,2284,759,180,197,0,B,8186,5109,6915876,39620,407151,435334,1900,149,9718,127854,6915876,6915876,137572,6915876,159,0
CO,42314,428563,0,356,6149,379,759,180,197,5122,A,1645,6149,485619,39620,407151,39163,1900,149,616,4850,470877,470877,5466,470877,2,16
CT,48776,664296,0,71,10712,379,759,180,197,8516,B,4413,10712,711102,39620,407151,46806,3531,882,544,24640,713072,713072,25184,713072,3,0
DC,11649,153611,0,97,5109,21,759,9,197,9582,A+,581,5109,485619,39620,407151,38775,1900,149,78,3161,165260,165260,3239,165260,0,0
DE,14202,150124,0,55,5109,9,759,180,197,7936,A+,578,5109,485619,39620,407151,13205,508,70,278,1697,164326,164326,1975,164326,49,0
FL,402312,2874324,2727,9200,23575,379,759,180,197,0,A,5768,23575,4166644,502625,3649517,402312,5768,149,12444,53250,3279363,3276636,65694,3276636,136,584
GA,161401,1221043,0,3135,16752,379,3119,180,197,0,A,3442,16752,1382444,147195,1235249,161401,1900,149,4813,40693,1382444,1382444,45506,1382444,82,399
GU,337,19132,0,0,5109,379,759,180,197,244,B,5,5109,19791,39620,407151,329,1900,149,5,0,19469,19469,5,19469,0,0
HI,1490,109801,0,39,155,379,759,180,197,1125,D,26,155,136008,39620,407151,38775,1900,149,55,2423,111291,111291,2478,111291,1,1
IA,41271,400602,0,230,5109,72,759,27,197,29216,A+,823,5109,485619,39620,407151,41271,1900,149,637,4950,441873,441873,5587,441873,5,0
ID,16736,143457,0,204,697,46,207,180,197,5008,A,138,697,159163,39620,407151,15706,117,21,414,2953,160193,160193,3367,160193,3,23
IL,169699,2264066,0,1471,5109,325,759,115,197,0,A,7577,5109,2432523,39620,407151,168457,7385,192,1599,42798,2433765,2433765,44397,2433765,17,0
IN,60598,618151,0,850,8128,313,1725,69,197,43066,A+,2884,8128,485619,39620,407151,38775,2687,197,996,11470,678749,678749,12466,678749,4,62
KS,25109,252858,0,961,1596,98,459,24,166,1077,A+,326,1596,485619,39620,407151,38775,1900,149,1005,8276,277967,277967,9281,277967,18,51
KY,25931,507545,0,618,3248,130,1125,180,197,7396,B,691,3248,485619,39620,407151,24615,687,4,784,7897,533476,533476,8681,533476,7,327
LA,103734,1095992,0,1600,5109,379,759,197,197,61456,A,3715,5109,485619,39620,407151,38775,3603,112,2084,22774,1199726,1199726,24858,1199726,29,0
MA,114647,971605,0,351,11770,59,759,30,197,96452,A+,8484,11770,1391221,39620,407151,107683,8265,219,327,15863,1086252,1086252,16190,1086252,16,9
MD,81766,722584,0,533,12119,143,759,180,197,5434,A,3422,12119,1040442,39620,407151,81766,3293,129,930,14379,804350,804350,15309,804350,13,82
ME,3757,146863,0,12,378,9,759,3,197,3259,A+,118,378,150220,4678,145352,3357,117,1,20,2925,150620,150620,2945,150620,0,0
MI,85072,1529574,0,751,5109,215,759,113,197,55162,A+,6400,5109,1637017,107443,1529574,76541,6151,249,641,27281,1614646,1614646,27922,1614646,5,0
MN,49488,873388,0,278,4852,108,1437,180,197,42882,A,1606,4852,922876,39620,407151,49488,1566,40,767,16794,922876,922876,17561,922876,5,34
MO,39352,573263,0,1057,5109,379,759,159,197,0,B,1178,5109,784770,43687,739825,39352,1900,149,1652,7679,612615,612615,9331,612615,-1,0
MP,38,11300,0,961,4,379,759,180,197,29,D,2,4,12745,39620,407151,38,2,149,0,0,11338,11338,0,11338,0,0
MS,49663,361817,0,1216,3923,279,759,163,197,30315,A+,1463,3923,410867,39620,407151,49050,1428,35,1610,5858,411480,411480,7468,411480,27,45
MT,3039,146161,0,56,191,379,759,180,197,1815,C,46,191,485619,39620,407151,3039,1900,149,129,2853,149200,149200,2982,149200,3,8
NC,108995,1441302,0,1182,5109,363,759,180,197,78707,A+,1746,5109,485619,39620,407151,108995,1746,149,2102,24520,1550297,1550297,26622,1550297,20,0
ND,5614,137094,0,37,325,379,759,180,197,4545,C,88,325,279909,39620,407151,5614,84,4,121,1771,142708,142708,1892,142708,0,3
NE,23818,225256,0,126,1548,379,759,180,197,17745,A,316,1548,485619,39620,407151,23818,1900,149,332,3169,249074,249074,3501,249074,5,26
NH,6318,143474,0,26,681,379,198,180,197,5345,B,405,681,485619,39620,407151,6318,1900,149,23,2890,149792,149792,2913,149792,3,1
NJ,178345,1709299,0,800,21184,138,759,62,197,32001,A+,15765,21184,485619,39620,407151,178345,13845,1920,458,27548,1887644,1887644,28006,1887644,35,0
NM,18163,478822,0,167,2500,379,759,180,197,7056,B,596,2500,485619,39620,407151,18163,1900,149,335,7316,496985,496985,7651,496985,5,30
NV,40885,380986,0,1160,5109,315,759,165,197,994,A+,722,5109,537720,39620,407151,40885,1900,149,966,6769,421871,421871,7735,421871,13,0
NY,410450,5034395,0,650,89995,156,759,93,197,72552,A,25090,89995,485619,39620,407151,410450,1900,149,753,75754,5444845,5444845,76507,5444845,9,0
OH,81746,1185882,0,1085,10072,354,2419,169,197,56823,B,3297,10072,485619,39620,407151,77309,3039,258,1560,21042,1267628,1267628,22602,1267628,41,104
OK,29116,493926,0,628,2687,260,759,180,197,23277,A+,484,2687,527895,32927,493926,29116,1900,149,1147,8720,523042,523042,9867,523042,7,91
OR,16104,350463,0,233,1474,58,759,30,197,3541,A+,282,1474,485619,39620,350463,15273,1900,149,391,7685,366567,366567,8076,366567,9,9
PA,105571,999377,0,736,5109,379,759,96,197,79178,A+,7101,5109,485619,39620,407151,102602,1900,149,1213,18118,1104948,1104948,19331,1104948,22,0
PR,13967,305972,0,460,5109,58,759,31,197,0,B,191,5109,310546,7002,303412,4794,90,101,494,0,319939,319939,494,319939,3,0
RI,18224,171804,0,66,2146,6,759,5,197,1769,A+,1002,2146,329556,26593,302963,18224,1900,149,76,613,190028,190028,689,190028,1,9
SC,78607,550765,0,1668,4827,379,759,263,197,29378,A+,1385,4827,629063,98172,530891,78298,1339,46,2001,8897,629372,629372,10898,629372,51,329
SD,8200,95290,0,45,796,379,759,180,197,7261,B,122,796,485619,39620,407151,38775,1900,149,57,897,103490,103490,954,103490,1,4
TN,89078,1233535,0,1460,4120,379,759,180,197,52983,A,938,4120,1321707,104274,1217433,88172,904,34,2091,24537,1322613,1322613,26628,1322613,13,104
TX,369826,2862105,0,10893,5109,3281,759,180,197,212216,A,4717,5109,3231931,39620,407151,369826,1900,149,8701,58574,3231931,3231931,67275,3231931,196,0
UT,36962,457109,0,250,2188,97,574,180,237,23715,A+,273,2188,585839,39620,407151,36962,1900,149,863,7786,494071,494071,8649,494071,6,38
VA,82364,907935,451,1250,11826,274,759,142,197,10576,A+,2067,11826,987188,39620,407151,79253,1964,103,1127,16972,990750,990299,18099,990299,13,129
VI,336,7500,54,961,5109,379,759,180,197,182,C,7,5109,485619,39620,407151,38775,7,149,0,0,7890,7836,0,7836,0,0
VT,1385,86307,0,12,5109,379,759,180,197,1177,B,56,5109,485619,39620,407151,1385,56,149,8,1102,87692,87692,1110,87692,0,0
WA,50009,820754,0,386,5276,379,759,47,197,0,B,1482,5276,485619,39620,407151,50009,1482,149,762,14849,870763,870763,15611,870763,14,65
WI,50727,795280,177,312,4327,60,861,180,197,36333,A+,885,4327,485619,39620,407151,46917,878,7,1058,16438,846184,846007,17496,846007,0,54
WV,5695,247478,0,76,5109,37,759,15,197,4013,B,103,5109,485619,39620,407151,5562,1900,149,145,1956,253173,253173,2101,253173,0,0
WY,2405,45823,0,14,155,379,759,180,197,1857,B,25,155,67700,2031,65669,1972,1900,149,59,0,48228,48228,59,48228,0,2
AK,2684,186825,0,36,5109,379,759,1,197,787,A,19,5109,189509,39620,407151,2684,19,149,65,4111,189509,189509,4176,189509,0,0
AL,74212,545315,0,1547,8995,379,1043,180,553,32510,B,1397,8995,618011,39620,407151,72696,1357,40,2399,7640,619527,619527,10039,619527,33,457
AR,36259,410221,0,480,2361,379,759,107,329,28864,A+,386,2361,445467,39620,407151,36259,1900,149,1013,5241,446480,446480,6254,446480,6,44
AS,0,1037,0,961,5109,379,759,180,197,0,C,0,5109,485619,39620,407151,0,1900,149,0,0,1037,1037,0,1037,0,0
AZ,152944,669769,0,2966,7236,851,759,617,197,19737,A+,3063,7236,822713,39620,407151,137710,2431,152,2335,6397,822713,822713,8732,822713,89,189
CA,425616,6352688,0,8820,5109,2284,759,180,197,0,B,8027,5109,6778304,39620,407151,425616,1900,149,12040,101845,6778304,6778304,113885,6778304,157,0
CO,41698,423713,0,351,6133,379,759,180,197,5095,A,1643,6133,485619,39620,407151,38562,1900,149,639,7370,465411,465411,8009,465411,0,23
CT,48232,639656,0,72,10712,379,759,180,197,8516,B,4410,10712,685869,39620,407151,46213,3530,880,9,13473,687888,687888,13482,687888,4,58
DC,11571,150450,0,91,5109,22,759,9,197,2020,A+,581,5109,485619,39620,407151,38775,1900,149,42,2407,162021,162021,2449,162021,1,0
DE,13924,148427,0,56,5109,7,759,180,197,7893,A+,529,5109,485619,39620,407151,12933,471,58,132,2786,162351,162351,2918,162351,2,0
FL,389868,2821074,2626,9422,22991,379,759,180,197,0,A,5632,22991,4075056,486782,3574573,389868,5632,149,10249,45982,3213568,3210942,56231,3210942,173,403
GA,156588,1180350,0,3157,16353,379,3034,180,197,0,A,3360,16353,1336938,142092,1194846,156588,1900,149,4286,15808,1336938,1336938,20094,1336938,25,431
GU,332,19132,0,0,5109,379,759,180,197,244,B,5,5109,19456,39620,407151,324,1900,149,2,380,19464,19464,382,19464,0,0
HI,1435,107378,0,39,154,379,759,180,197,1113,D,25,154,132361,39620,407151,38775,1900,149,17,614,108813,108813,631,108813,1,3
IA,40634,395652,0,232,5109,73,759,32,197,28924,A+,818,5109,485619,39620,407151,40634,1900,149,841,9009,436286,436286,9850,436286,10,0
ID,16322,140504,0,188,674,46,201,180,197,4746,A,135,674,155825,39620,407151,15321,114,21,500,2355,156826,156826,2855,156826,9,18
IL,168100,2221268,0,1473,5109,309,759,135,197,0,A,7560,5109,2388193,39620,407151,166925,7367,193,1624,38082,2389368,2389368,39706,2389368,20,0
IN,59602,606681,0,869,8066,327,1708,85,197,42603,A+,2880,8066,485619,39620,407151,38775,2683,197,929,10941,666283,666283,11870,666283,17,46
KS,24104,244582,0,961,1545,112,450,28,164,1050,A+,308,1545,485619,39620,407151,38775,1900,149,0,0,268686,268686,0,268686,0,0
KY,25147,499648,0,581,2921,135,1040,180,197,7046,B,684,2921,485619,39620,407151,23882,680,4,607,5113,524795,524795,5720,524795,7,7
LA,101650,1073218,0,1585,5109,379,759,197,197,61456,A,3686,5109,485619,39620,407151,38775,3574,112,2296,19671,1174868,1174868,21967,1174868,16,0
MA,114320,955742,0,532,11761,63,759,37,197,96452,A+,8468,11761,1369551,39620,407151,107413,8249,219,0,0,1070062,1070062,0,1070062,0,0
MD,80836,708205,0,528,12037,133,759,180,197,5434,A,3409,12037,1016222,39620,407151,80836,3281,128,664,5544,789041,789041,6208,789041,4,40
ME,3737,143938,0,12,378,8,759,3,197,3239,A+,118,378,147272,4648,142434,3334,117,1,14,2643,147675,147675,2657,147675,0,1
MI,84431,1502293,0,680,5109,210,759,120,197,55162,A+,6395,5109,1608660,106367,1502293,75947,6148,247,701,26410,1586724,1586724,27111,1586724,7,0
MN,48721,856594,0,282,4818,107,1431,180,197,42524,A,1601,4818,905315,39620,407151,48721,1561,40,760,16004,905315,905315,16764,905315,9,47
MO,37700,565584,0,875,5109,379,759,86,197,0,B,1179,5109,769616,42073,726302,37700,1900,149,1637,12187,603284,603284,13824,603284,20,0
MP,38,11300,0,961,4,379,759,180,197,29,D,2,4,12745,39620,407151,38,2,149,0,-1407,11338,11338,-1407,11338,0,0
MS,48053,355959,0,1207,3878,293,759,140,197,30315,A+,1436,3878,402474,39620,407151,47468,1401,35,982,0,404012,404012,982,404012,13,34
MT,2910,143308,0,54,183,379,759,180,197,1587,C,43,183,485619,39620,407151,2910,1900,149,97,2603,146218,146218,2700,146218,1,4
NC,106893,1416782,0,1188,5109,360,759,180,197,78707,A+,1726,5109,485619,39620,407151,106893,1726,149,1892,29963,1523675,1523675,31855,1523675,28,0
ND,5493,135323,0,57,322,379,759,180,197,4475,C,88,322,275255,39620,407151,5493,84,4,126,1424,140816,140816,1550,140816,0,5
NE,23486,222087,0,125,1522,379,759,180,197,17499,A,311,1522,485619,39620,407151,23486,1900,149,296,2656,245573,245573,2952,245573,1,14
NH,6295,140584,0,24,680,379,198,180,197,5341,B,402,680,485619,39620,407151,6295,1900,149,33,1308,146879,146879,1341,146879,2,3
NJ,177887,1681751,0,869,21184,152,759,73,197,31925,A+,15730,21184,485619,39620,407151,177887,13810,1920,242,18467,1859638,1859638,18709,1859638,23,0
NM,17828,471506,0,178,2470,379,759,180,197,6974,B,591,2470,485619,39620,407151,17828,1900,149,311,7492,489334,489334,7803,489334,3,37
NV,39919,374217,0,1136,5109,306,759,156,197,975,A+,709,5109,526274,39620,407151,39919,1900,149,1262,8566,414136,414136,9828,414136,5,0
NY,409697,4958641,0,706,89995,160,759,93,197,72466,A,25081,89995,485619,39620,407151,409697,1900,149,811,68887,5368338,5368338,69698,5368338,13,0
OH,80186,1164840,0,1105,9968,365,2403,178,197,55702,B,3256,9968,485619,39620,407151,75819,2997,259,1444,21987,1245026,1245026,23431,1245026,21,104
OK,27969,485206,0,607,2596,255,759,180,197,22441,A+,477,2596,518134,31903,485206,27969,1900,149,668,6909,513175,513175,7577,513175,3,56
OR,15713,342778,0,225,1465,52,759,28,197,3509,A+,273,1465,485619,39620,342778,14900,1900,149,320,5377,358491,358491,5697,358491,4,32
PA,104358,981259,0,736,5109,379,759,96,197,78268,A+,7079,5109,485619,39620,407151,101408,1900,149,962,13178,1085617,1085617,14140,1085617,16,0
PR,13473,305972,0,442,5109,56,759,40,197,0,B,188,5109,310546,7002,303412,4574,87,101,435,50206,319445,319445,50641,319445,3,0
RI,18148,171191,0,67,2137,7,759,4,197,1759,A+,1001,2137,325979,26489,299490,18148,1900,149,86,2397,189339,189339,2483,189339,4,10
SC,76606,541868,0,1723,4498,379,759,180,197,27062,A,1334,4498,618183,95676,522507,76315,1294,40,1564,7750,618474,618474,9314,618474,49,0
SD,8143,94393,0,50,792,379,759,180,197,7214,B,121,792,485619,39620,407151,38775,1900,149,66,1412,102536,102536,1478,102536,2,2
TN,86987,1208998,0,1465,4016,379,759,180,197,51661,A,925,4016,1295115,101782,1193333,86117,891,34,2570,29587,1295985,1295985,32157,1295985,37,109
TX,361125,2803531,0,10893,5109,3281,759,180,197,203826,A,4521,5109,3164656,39620,407151,361125,1900,149,9507,51001,3164656,3164656,60508,3164656,173,0
UT,36099,449323,0,249,2150,98,568,180,234,23093,A+,267,2150,574216,39620,407151,36099,1900,149,521,3499,485422,485422,4020,485422,7,15
VA,81237,890963,417,1218,11697,257,759,136,197,10479,A+,2054,11697,969145,39620,407151,78182,1951,103,844,17169,972617,972200,18013,972200,3,209
VI,336,7500,54,961,5109,379,759,180,197,182,C,7,5109,485619,39620,407151,38775,7,149,16,354,7890,7836,370,7836,0,0
VT,1377,85205,0,12,5109,379,759,180,197,1156,B,56,5109,485619,39620,407151,1377,56,149,11,829,86582,86582,840,86582,0,0
WA,49247,805905,0,385,5211,379,759,55,197,0,B,1468,5211,485619,39620,407151,49247,1468,149,672,13296,855152,855152,13968,855152,3,50
WI,49669,778842,82,187,4273,51,857,180,197,35502,A+,885,4273,485619,39620,407151,45899,878,7,1086,14212,828593,828511,15298,828511,13,48
WV,5550,245522,0,88,5109,38,759,16,197,3913,B,103,5109,485619,39620,407151,5420,1900,149,344,8341,251072,251072,8685,251072,2,0
WY,2346,45823,0,15,153,379,759,180,197,1794,B,25,153,67700,2031,65669,1922,1900,149,58,3896,48169,48169,3954,48169,0,1
AK,2619,182714,0,34,5109,379,759,1,197,753,A,19,5109,185333,39620,407151,2619,19,149,94,6613,185333,185333,6707,185333,1,0
AL,71813,537675,0,1547,8538,379,1018,180,540,29736,B,1364,8538,608088,39620,407151,70413,1325,39,1455,7652,609488,609488,9107,609488,61,0
AR,35246,404980,0,474,2317,379,759,107,323,27990,A+,380,2317,439635,39620,407151,35246,1900,149,591,0,440226,440226,591,440226,6,60
AS,0,1037,0,961,5109,379,759,180,197,0,C,0,5109,485619,39620,407151,0,1900,149,0,0,1037,1037,0,1037,0,0
AZ,150609,663372,0,3094,7047,870,759,609,197,19293,A+,2974,7047,813981,39620,407151,137710,2431,152,1926,4389,813981,813981,6315,813981,56,153
CA,413576,6250843,0,8820,5109,2284,759,180,197,0,B,7870,5109,6664419,39620,407151,413576,1900,149,12807,114680,6664419,6664419,127487,6664419,115,0
CO,41059,416343,0,373,6110,379,759,180,197,5064,A,1643,6110,485619,39620,407151,37947,1900,149,493,5610,457402,457402,6103,457402,28,53
CT,48223,626183,0,63,10654,379,759,180,197,8466,B,4406,10654,672386,39620,407151,46203,3527,879,127,11442,674406,674406,11569,674406,0,0
DC,11529,148043,0,81,5109,18,759,11,197,1974,A+,580,5109,485619,39620,407151,38775,1900,149,102,3759,159572,159572,3861,159572,0,0
DE,13792,145641,0,61,5109,7,759,180,197,7859,A+,527,5109,485619,39620,407151,12804,469,58,46,1040,159433,159433,1086,159433,2,0
FL,379619,2775092,2524,9475,22588,379,759,180,197,0,A,5459,22588,3993867,473128,3507785,379619,5459,149,9785,45176,3157235,3154711,54961,3154711,140,465
GA,152302,1164542,0,3179,15922,379,2967,180,197,0,A,3335,15922,1316844,138662,1178182,152302,1900,149,3314,18239,1316844,1316844,21553,1316844,81,428
GU,330,18752,0,3,5109,379,759,180,197,242,B,5,5109,19074,39620,407151,322,1900,149,3,322,19082,19082,325,19082,0,0
HI,1418,106764,0,47,151,379,759,180,197,1084,D,24,151,131371,39620,407151,38775,1900,149,25,1374,108182,108182,1399,108182,0,1
IA,39793,386643,0,224,5109,71,759,31,197,28607,A+,808,5109,485619,39620,407151,39793,1900,149,319,3684,426436,426436,4003,426436,6,0
ID,15822,138149,0,188,656,46,197,180,197,4504,A,126,656,153009,39620,407151,14860,103,33,556,2344,153971,153971,2900,153971,4,35
IL,166476,2183186,0,1456,5109,337,759,132,197,0,A,7540,5109,2348487,39620,407151,165301,7347,193,1598,38035,2349662,2349662,39633,2349662,23,0
IN,58673,595740,0,869,8020,327,1703,85,197,41322,A+,2863,8020,485619,39620,407151,38775,2666,197,757,8851,654413,654413,9608,654413,17,79
KS,24104,244582,0,961,1545,112,450,28,164,1050,A+,308,1545,485619,39620,407151,38775,1900,149,770,6385,268686,268686,7155,268686,1,48
KY,24540,494535,0,603,2914,145,1039,180,197,7000,B,677,2914,485619,39620,407151,23336,673,4,480,9902,519075,519075,10382,519075,3,14
LA,99354,1053547,0,1581,5109,379,759,188,197,61456,A,3670,5109,485619,39620,407151,38775,3558,112,2771,27168,1152901,1152901,29939,1152901,62,0
MA,114320,955742,0,532,11761,63,759,37,197,96452,A+,8468,11761,1369551,39620,407151,107413,8249,219,287,10594,1070062,1070062,10881,1070062,18,15
MD,80172,702661,0,505,11997,137,759,180,197,5434,A,3405,11997,1000179,39620,407151,80172,3276,129,627,17839,782833,782833,18466,782833,3,48
ME,3723,141295,0,10,377,8,759,4,197,3216,A+,118,377,144616,4619,139810,3321,117,1,0,2775,145018,145018,2775,145018,0,0
MI,83730,1475883,0,680,5109,210,759,120,197,55162,A+,6388,5109,1581285,105402,1475883,75248,6141,247,671,29567,1559613,1559613,30238,1559613,6,0
MN,47961,840590,0,273,4771,119,1423,180,197,42234,A,1592,4771,888551,39620,407151,47961,1552,40,504,11188,888551,888551,11692,888551,4,48
MO,36063,553397,0,875,5109,379,759,86,197,0,B,1159,5109,749051,40767,707077,36063,1900,149,1301,7839,589460,589460,9140,589460,16,0
MP,38,12707,0,961,4,379,759,180,197,29,D,2,4,12745,39620,407151,38,2,149,0,1652,12745,12745,1652,12745,0,0
MS,47071,355959,0,1165,3844,293,759,138,197,30315,A+,1423,3844,402474,39620,407151,46515,1390,33,1547,6285,403030,403030,7832,403030,34,47
MT,2813,140705,0,52,179,379,759,180,197,1543,C,42,179,485619,39620,407151,2813,1900,149,101,2415,143518,143518,2516,143518,2,5
NC,105001,1386819,0,1137,5109,338,759,180,197,78707,A+,1698,5109,485619,39620,407151,105001,1698,149,2140,30683,1491820,1491820,32823,1491820,30,0
ND,5367,133899,0,52,317,379,759,180,197,4407,C,88,317,270943,39620,407151,5367,84,4,160,1813,139266,139266,1973,139266,4,8
NE,23190,219431,0,118,1508,379,759,180,197,17389,A,310,1508,485619,39620,407151,23190,1900,149,343,3837,242621,242621,4180,242621,4,6
NH,6262,139276,0,23,677,379,196,180,197,5316,B,400,677,485619,39620,407151,6262,1900,149,13,703,145538,145538,716,145538,2,4
NJ,177645,1663284,0,873,21184,151,759,77,197,31850,A+,15707,21184,485619,39620,407151,177645,13787,1920,389,22585,1840929,1840929,22974,1840929,-30,85
NM,17517,464014,0,154,2433,379,759,180,197,6870,B,588,2433,485619,39620,407151,17517,1900,149,302,4732,481531,481531,5034,481531,10,34
NV,38657,365651,0,1102,5109,299,759,154,197,917,A+,704,5109,510977,39620,407151,38657,1900,149,1129,4357,404308,404308,5486,404308,28,0
NY,408886,4889754,0,714,89995,179,759,96,197,72386,A,25068,89995,485619,39620,407151,408886,1900,149,705,66954,5298640,5298640,67659,5298640,10,0
OH,78742,1142853,0,1098,9864,347,2386,169,197,54426,B,3235,9864,485619,39620,407151,74409,2976,259,1527,20045,1221595,1221595,21572,1221595,16,128
OK,27301,478297,0,630,2540,257,759,180,197,21596,A+,474,2540,510359,31051,478297,27301,1900,149,975,6240,505598,505598,7215,505598,13,137
OR,15393,337401,0,231,1433,61,759,30,197,3381,A+,269,1433,485619,39620,337401,14586,1900,149,254,7277,352794,352794,7531,352794,0,27
PA,103396,968081,0,735,5109,379,759,100,197,77547,A+,7063,5109,485619,39620,407151,100483,1900,149,631,15083,1071477,1071477,15714,1071477,25,0
PR,13038,255766,0,415,5109,49,759,31,197,0,B,185,5109,258001,3966,253922,4330,84,101,98,0,268804,268804,98,268804,5,0
RI,18062,168794,0,67,2127,5,759,3,197,1749,A+,997,2127,321872,26350,295522,18062,1900,149,76,1816,186856,186856,1892,186856,1,11
SC,75042,534118,0,1607,4498,379,759,180,197,27062,A,1285,4498,608879,93527,513352,74761,1242,43,1705,8762,609160,609160,10467,609160,64,0
SD,8077,92981,0,56,790,379,759,180,197,7159,B,119,790,485619,39620,407151,38775,1900,149,58,1155,101058,101058,1213,101058,1,14
TN,84417,1179411,0,1451,3907,379,759,180,197,49748,A,888,3907,1262993,98743,1164250,83582,855,33,2473,23122,1263828,1263828,25595,1263828,17,109
TX,351618,2752530,0,10893,5109,3281,759,180,197,195315,A,4348,5109,3104148,39620,407151,351618,1900,149,9879,50695,3104148,3104148,60574,3104148,197,0
UT,35578,445824,0,234,2135,94,563,180,231,22532,A+,260,2135,569107,39620,407151,35578,1900,149,566,5393,481402,481402,5959,481402,9,26
VA,80393,873794,385,1157,11488,253,759,136,197,10331,A+,2051,11488,951174,39620,407151,77380,1948,103,1022,13073,954572,954187,14095,954187,3,64
VI,320,7146,91,961,5109,379,759,180,197,172,C,7,5109,485619,39620,407151,38775,7,149,12,293,7557,7466,305,7466,1,0
VT,1366,84376,0,14,5109,379,759,180,197,1152,B,56,5109,485619,39620,407151,1366,56,149,0,795,85742,85742,795,85742,0,0
WA,48575,792609,0,392,5161,379,759,51,197,0,B,1465,5161,485619,39620,407151,48575,1465,149,832,13998,841184,841184,14830,841184,12,59
WI,48583,764630,51,167,4225,63,848,180,197,34682,A+,872,4225,485619,39620,407151,44847,865,7,747,14068,813264,813213,14815,813213,6,31
WV,5206,237181,0,78,5109,33,759,16,197,3625,B,101,5109,485619,39620,407151,5081,1900,149,7,2054,242387,242387,2061,242387,0,0
WY,2288,41927,0,13,152,379,759,180,197,1745,B,25,152,61032,1769,59262,1864,1900,149,50,0,44215,44215,50,44215,0,6
AK,2525,176101,0,32,5109,379,759,1,197,737,A,18,5109,178626,39620,407151,2525,18,149,111,2929,178626,178626,3040,178626,0,0
AL,70358,530023,0,1547,8538,379,1009,180,535,29736,B,1303,8538,599098,39620,407151,69075,1268,35,1467,5126,600381,600381,6593,600381,12,170
AR,34655,404980,0,488,2257,379,759,111,316,27283,A+,374,2257,439635,39620,407151,34655,1900,149,728,6091,439635,439635,6819,439635,17,55
AS,0,1037,0,961,5109,379,759,180,197,0,C,0,5109,485619,39620,407151,0,1900,149,0,0,1037,1037,0,1037,0,0
AZ,148683,658983,0,3041,6894,865,759,608,197,18863,A+,2918,6894,807666,39620,407151,137710,2431,152,3500,10643,807666,807666,14143,807666,134,196
CA,400769,6136163,0,8681,5109,2226,759,180,197,0,B,7755,5109,6536932,39620,407151,400769,1900,149,9231,113380,6536932,6536932,122611,6536932,61,0
CO,40566,410733,0,386,6057,379,759,180,197,5019,A,1615,6057,485619,39620,407151,37471,1900,149,424,8706,451299,451299,9130,451299,0,25
CT,48096,614741,0,62,10654,379,759,180,197,8466,B,4406,10654,660857,39620,407151,46116,3527,879,41,0,662837,662837,41,662837,0,0
DC,11427,144284,0,83,5109,19,759,13,197,1932,A+,580,5109,485619,39620,407151,38775,1900,149,88,3883,155711,155711,3971,155711,1,0
DE,13746,144601,0,58,5109,11,759,180,197,7362,A+,525,5109,485619,39620,407151,12763,467,58,227,5125,158347,158347,5352,158347,2,0
FL,369834,2729916,2462,9520,22123,379,759,180,197,0,A,5319,22123,3912910,460918,3439642,369834,5319,149,9440,38204,3102212,3099750,47644,3099750,136,518
GA,148988,1146303,0,3155,15494,379,2904,180,197,0,A,3254,15494,1295291,136015,1159276,148988,1900,149,3413,18097,1295291,1295291,21510,1295291,78,447
GU,327,18430,0,3,5109,379,759,180,197,235,B,5,5109,18583,39620,407151,319,1900,149,8,178,18757,18757,186,18757,0,0
HI,1393,105390,0,46,150,379,759,180,197,1057,D,24,150,129510,39620,407151,38775,1900,149,12,815,106783,106783,827,106783,0,0
IA,39474,382959,0,223,5109,74,759,32,197,28388,A+,802,5109,485619,39620,407151,39474,1900,149,308,3581,422433,422433,3889,422433,5,0
ID,15266,135805,0,188,621,46,186,180,197,4335,A,122,621,150142,39620,407151,14337,100,22,393,2790,151071,151071,3183,151071,3,21
IL,164878,2145151,0,1466,5109,320,759,142,197,0,A,7517,5109,2308854,39620,407151,163703,7324,193,955,28790,2310029,2310029,29745,2310029,23,0
IN,57916,586889,0,803,7941,267,1691,82,197,41322,A+,2846,7941,485619,39620,407151,38775,2652,194,710,8435,644805,644805,9145,644805,21,0
KS,23334,238197,0,961,1497,111,439,21,162,1016,A,307,1497,485619,39620,407151,38775,1900,149,0,0,261531,261531,0,261531,0,0
KY,24060,484633,0,532,2900,136,1036,180,197,6927,B,674,2900,485619,39620,407151,22916,670,4,646,13893,508693,508693,14539,508693,3,18
LA,96583,1026379,0,1527,5109,379,759,186,197,53288,B,3608,5109,485619,39620,407151,38775,3498,110,1691,18347,1122962,1122962,20038,1122962,36,0
MA,114033,945148,0,513,11746,63,759,33,197,95390,A+,8450,11746,1353802,39620,407151,107221,8231,219,244,7656,1059181,1059181,7900,1059181,17,24
MD,79545,684822,0,484,11949,131,759,180,197,5380,A,3402,11949,979158,39620,407151,79545,3272,130,860,14228,764367,764367,15088,764367,20,52
ME,3723,138520,0,12,377,8,759,4,197,3191,A+,118,377,141820,4586,137047,3300,117,1,12,3009,142243,142243,3021,142243,1,2
MI,83059,1446316,0,680,5109,210,759,130,197,55162,A+,6382,5109,1550697,104381,1446316,74725,6135,247,664,21922,1529375,1529375,22586,1529375,9,0
MN,47457,829402,0,266,4723,112,1412,180,197,41511,A,1588,4723,876859,39620,407151,47457,1548,40,350,9099,876859,876859,9449,876859,3,45
MO,34762,545558,0,875,5109,379,759,86,197,0,B,1143,5109,739140,39567,698398,34762,1900,149,1138,7270,580320,580320,8408,580320,11,0
MP,38,11055,0,961,4,379,759,180,197,29,D,2,4,12236,39620,407151,38,2,149,1,0,11093,11093,1,11093,0,0
MS,45524,349674,0,1154,3797,293,759,140,197,30315,A,1389,3797,394673,39620,407151,44999,1358,31,1635,3588,395198,395198,5223,395198,31,31
MT,2712,138290,0,49,174,379,759,180,197,1493,C,40,174,485619,39620,407151,2712,1900,149,91,1869,141002,141002,1960,141002,1,7
NC,102861,1356136,0,1179,5109,379,759,180,197,78707,A,1668,5109,485619,39620,407151,102861,1668,149,1815,33294,1458997,1458997,35109,1458997,26,0
ND,5207,132086,0,46,309,379,759,180,197,4319,D,84,309,266690,39620,407151,5207,80,4,81,1234,137293,137293,1315,137293,2,4
NE,22847,215594,0,115,1502,379,759,180,197,17237,B,306,1502,485619,39620,407151,22847,1900,149,264,3281,238441,238441,3545,238441,5,20
NH,6249,138573,0,20,673,379,193,180,197,5286,B,398,673,485619,39620,407151,6249,1900,149,46,1398,144822,144822,1444,144822,0,0
NJ,177256,1640699,0,833,21099,169,759,79,197,31781,A+,15737,21099,485619,39620,407151,177256,13763,1974,293,14788,1817955,1817955,15081,1817955,22,41
NM,17215,459282,0,154,2399,379,759,180,197,6814,B,578,2399,485619,39620,407151,17215,1900,149,244,7038,476497,476497,7282,476497,7,12
NV,37528,361294,0,1095,5109,301,759,143,197,874,A+,676,5109,503464,39620,407151,37528,1900,149,815,2586,398822,398822,3401,398822,28,0
NY,408181,4822800,0,724,89995,163,759,91,197,72302,A,25058,89995,485619,39620,407151,408181,1900,149,855,65314,5230981,5230981,66169,5230981,2,0
OH,77215,1122808,0,1097,9736,342,2367,168,197,53077,B,3219,9736,485619,39620,407151,72963,2959,260,1047,17064,1200023,1200023,18111,1200023,30,126
OK,26326,472057,0,613,2403,248,759,180,197,20663,A+,461,2403,503326,30273,472057,26326,1900,149,893,21382,498383,498383,22275,498383,9,0
OR,15139,330124,0,237,1406,64,759,34,197,3381,A+,269,1406,485619,39620,330124,14355,1900,149,292,4927,345263,345263,5219,345263,7,19
PA,102765,952998,0,736,5109,379,759,98,197,77073,A+,7038,5109,485619,39620,407151,99875,1900,149,1027,14823,1055763,1055763,15850,1055763,20,0
PR,12940,255766,0,375,5109,40,759,24,197,0,B,180,5109,258001,3966,253922,4255,81,99,479,0,268706,268706,479,268706,0,0
RI,17986,166978,0,64,2116,4,759,2,197,1741,A+,996,2116,317544,26222,291322,17986,1900,149,82,1257,184964,184964,1339,184964,1,6
SC,73337,525356,0,1593,4498,379,759,180,197,27062,A,1221,4498,598457,91459,506998,73101,1203,18,1892,8485,598693,598693,10377,598693,57,316
SD,8019,91826,0,62,776,379,759,180,197,7081,B,118,776,485619,39620,407151,38775,1900,149,76,1115,99845,99845,1191,99845,0,2
TN,81944,1156289,0,1461,3798,379,759,180,197,47852,A,871,3798,1237411,95765,1141646,81122,840,31,2190,20876,1238233,1238233,23066,1238233,24,86
TX,341739,2701835,0,10848,5109,379,759,180,197,186529,B,4151,5109,3043574,39620,407151,341739,1900,149,9305,49715,3043574,3043574,59020,3043574,131,0
UT,35012,440431,0,219,2109,96,554,180,229,22032,A+,251,2109,561500,39620,407151,35012,1900,149,486,5553,475443,475443,6039,475443,4,43
VA,79371,860721,427,1189,11424,258,759,127,197,10235,A+,2048,11424,937148,39620,407151,76427,1945,103,996,18635,940519,940092,19631,940092,17,159
VI,308,6853,118,961,5109,379,759,180,197,158,C,6,5109,485619,39620,407151,38775,6,149,4,236,7279,7161,240,7161,0,0
VT,1366,83581,0,19,5109,379,759,180,197,1148,B,56,5109,485619,39620,407151,1366,56,149,6,1073,84947,84947,1079,84947,0,0
WA,47743,778611,0,365,5102,379,759,43,197,0,B,1453,5102,485619,39620,407151,47743,1453,149,797,16218,826354,826354,17015,826354,6,39
WI,47836,750562,190,354,4194,101,838,180,197,33902,A+,866,4194,485619,39620,407151,44135,859,7,1161,13371,798588,798398,14532,798398,13,65
WV,5199,235127,0,77,5109,33,759,16,197,3546,B,101,5109,485619,39620,407151,5074,1900,149,57,5289,240326,240326,5346,240326,1,0
WY,2238,41927,0,13,146,379,759,180,197,1694,B,25,146,61032,1769,59262,1830,1900,149,51,0,44165,44165,51,44165,1,2
AK,2414,173172,0,29,5109,379,759,0,197,712,A,18,5109,175586,39620,407151,2414,18,149,137,2439,175586,175586,2576,175586,0,0
AL,68891,524897,0,1571,8368,379,994,180,528,29736,B,1291,8368,592608,39620,407151,67711,1257,34,1880,6375,593788,593788,8255,593788,4,586
AR,33927,398889,0,471,2202,379,759,111,309,26397,A+,357,2202,432816,39620,407151,33927,1900,149,1394,12251,432816,432816,13645,432816,0,25
AS,0,1037,0,961,5109,379,759,180,197,0,C,0,5109,485619,39620,407151,0,1900,149,0,0,1037,1037,0,1037,0,0
AZ,145183,648340,0,3084,6698,886,759,622,197,18518,A+,2784,6698,793523,39620,407151,137710,2431,152,1559,5985,793523,793523,7544,793523,23,66
CA,391538,6022783,0,8419,5109,2157,759,180,197,0,B,7694,5109,6414321,39620,407151,391538,1900,149,6846,120623,6414321,6414321,127469,6414321,9,0
CO,40142,402027,0,397,6032,379,759,180,197,4969,A,1615,6032,485619,39620,407151,37041,1900,149,354,5877,442169,442169,6231,442169,0,13
CT,48055,614741,0,54,10654,379,759,180,197,8466,B,4406,10654,660857,39620,407151,46116,3525,881,162,5503,662796,662796,5665,662796,10,0
DC,11339,140401,0,83,5109,19,759,12,197,1909,A+,579,5109,485619,39620,407151,38775,1900,149,78,3897,151740,151740,3975,151740,1,0
DE,13519,139476,0,47,5109,9,759,180,197,7362,A+,523,5109,485619,39620,407151,12537,465,58,0,0,152995,152995,0,152995,0,0
FL,360394,2691712,2391,9489,21605,379,759,180,197,0,A,5183,21605,3845270,448764,3384679,360394,5183,149,10347,39118,3054497,3052106,49465,3052106,92,296
GA,145575,1128206,0,3183,15047,379,2829,180,197,0,A,3176,15047,1273781,133027,1140754,145575,1900,149,2452,16010,1273781,1273781,18462,1273781,3,37
GU,319,18252,0,3,5109,379,759,180,197,235,B,5,5109,18583,39620,407151,311,1900,149,4,314,18571,18571,318,18571,0,0
HI,1381,104575,0,33,150,379,759,180,197,1043,D,24,150,128374,39620,407151,38775,1900,149,27,1294,105956,105956,1321,105956,0,10
IA,39166,379378,0,221,5109,76,759,30,197,28024,A+,797,5109,485619,39620,407151,39166,1900,149,443,2610,418544,418544,3053,418544,3,0
ID,14873,133015,0,224,600,33,181,180,197,4149,A,119,600,146994,39620,407151,13979,97,22,571,1131,147888,147888,1702,147888,0,17
IL,163923,2116361,0,1410,5109,308,759,133,197,0,A,7494,5109,2279109,39620,407151,162748,7301,193,1173,33425,2280284,2280284,34598,2280284,6,0
IN,57206,578454,0,805,7941,248,1691,85,197,41322,A+,2825,7941,485619,39620,407151,38775,2632,193,635,8145,635660,635660,8780,635660,3,46
KS,23334,238197,0,961,1497,111,439,21,162,1016,A,307,1497,485619,39620,407151,38775,1900,149,1369,10809,261531,261531,12178,261531,8,44
KY,23414,470740,0,542,2882,114,1035,180,197,6876,B,671,2882,485619,39620,407151,22328,667,4,253,1177,494154,494154,1430,494154,1,2
LA,94892,1008032,0,1508,5109,379,759,192,197,53288,B,3572,5109,485619,39620,407151,38775,3462,110,3186,30434,1102924,1102924,33620,1102924,29,0
MA,113789,937492,0,483,11722,67,759,38,197,95390,A+,8433,11722,1342652,39620,407151,107056,8214,219,255,10491,1051281,1051281,10746,1051281,2,5
MD,78685,670594,0,463,11897,136,759,180,197,5344,A,3382,11897,958608,39620,407151,78685,3252,130,554,8940,749279,749279,9494,749279,5,56
ME,3711,135511,0,12,375,10,759,4,197,3159,A+,117,375,138798,4567,134046,3287,116,1,24,1761,139222,139222,1785,139222,0,0
MI,82395,1424394,0,680,5109,210,759,102,197,55162,A+,6373,5109,1527804,103410,1424394,74152,6126,247,527,21803,1506789,1506789,22330,1506789,7,0
MN,47107,820303,0,247,4678,115,1397,180,197,40742,A,1585,4678,867410,39620,407151,47107,1545,40,903,13319,867410,867410,14222,867410,4,51
MO,33624,538288,0,875,5109,379,759,86,197,0,B,1132,5109,728137,38855,688187,33624,1900,149,530,12303,571912,571912,12833,571912,3,0
MP,37,11055,0,961,4,379,759,180,197,29,D,2,4,12236,39620,407151,37,2,149,0,391,11092,11092,391,11092,0,0
MS,43889,346086,0,1119,3766,284,759,143,197,30315,A,1358,3766,389466,39620,407151,43380,1327,31,1251,10647,389975,389975,11898,389975,3,39
MT,2621,136421,0,48,167,379,759,180,197,1334,C,39,167,485619,39620,407151,2621,1900,149,88,5795,139042,139042,5883,139042,2,2
NC,101046,1322842,0,1086,5109,379,759,180,197,78707,A,1642,5109,485619,39620,407151,101046,1642,149,1268,27756,1423888,1423888,29024,1423888,8,0
ND,5126,130852,0,47,305,379,759,180,197,4219,D,82,305,262924,39620,407151,5126,78,4,107,2017,135978,135978,2124,135978,0,3
NE,22583,212313,0,121,1482,379,759,180,197,17112,B,301,1482,485619,39620,407151,22583,1900,149,102,2393,234896,234896,2495,234896,0,1
NH,6203,137175,0,17,673,379,193,180,197,5251,B,398,673,485619,39620,407151,6203,1900,149,0,0,143378,143378,0,143378,0,0
NJ,176963,1625911,0,798,21058,146,759,72,197,31448,A+,15715,21058,485619,39620,407151,176963,13741,1974,180,11557,1802874,1802874,11737,1802874,9,-6
NM,16971,452244,0,161,2387,379,759,180,197,6764,B,571,2387,485619,39620,407151,16971,1900,149,235,8316,469215,469215,8551,469215,2,23
NV,36713,358708,0,1086,5109,304,759,156,197,867,A+,648,5109,498739,39620,407151,36713,1900,149,948,4685,395421,395421,5633,395421,1,0
NY,407326,4757486,0,716,89995,158,759,93,197,72229,A,25056,89995,485619,39620,407151,407326,1900,149,519,48823,5164812,5164812,49342,5164812,8,0
OH,76168,1105744,0,1065,9610,318,2344,165,197,51860,B,3189,9610,485619,39620,407151,71952,2931,258,1236,17762,1181912,1181912,18998,1181912,15,55
OK,25433,450675,0,604,2403,232,759,180,197,19750,A+,452,2403,479547,27903,450675,25433,1900,149,168,0,476108,476108,168,476108,1,15
OR,14847,325197,0,233,1387,70,759,34,197,3338,A+,262,1387,485619,39620,325197,14085,1900,149,268,4186,340044,340044,4454,340044,2,60
PA,101738,938175,0,706,5109,379,759,98,197,76780,A+,7018,5109,485619,39620,407151,98872,1900,149,711,11823,1039913,1039913,12534,1039913,3,0
PR,12461,255766,0,336,5109,31,759,20,197,0,B,180,5109,258001,3966,253922,4011,81,99,398,0,268227,268227,398,268227,2,0
RI,17904,165721,0,61,2110,2,759,2,197,1738,A+,995,2110,315156,26152,289004,17904,1900,149,111,4313,183625,183625,4424,183625,5,22
SC,71445,516871,0,1593,4182,379,759,180,197,22553,A,1164,4182,588084,89107,498977,71213,1147,17,1459,9471,588316,588316,10930,588316,9,0
SD,7943,90711,0,65,774,379,759,180,197,6996,B,118,774,485619,39620,407151,38775,1900,149,37,530,98654,98654,567,98654,0,0
TN,79754,1135413,0,1368,3712,379,759,180,197,45974,A,847,3712,1214383,93257,1121126,78970,816,31,1639,16231,1215167,1215167,17870,1215167,4,31
TX,332434,2652120,0,10569,5109,379,759,180,197,177871,B,4020,5109,2984554,39620,407151,332434,1900,149,7404,44786,2984554,2984554,52190,2984554,62,0
UT,34526,434878,0,247,2066,105,543,180,224,21504,A+,247,2066,553616,39620,407151,34526,1900,149,409,6173,469404,469404,6582,469404,4,33
VA,78375,842086,415,1158,11265,265,759,125,197,10107,A+,2031,11265,917501,39620,407151,75415,1927,104,945,12153,920876,920461,13098,920461,4,62
VI,304,6617,51,961,5109,379,759,180,197,135,C,6,5109,485619,39620,407151,38775,6,149,7,30,6972,6921,37,6921,0,0
VT,1360,82508,0,22,5109,379,759,180,197,1139,B,56,5109,485619,39620,407151,1360,56,149,10,1358,83868,83868,1368,83868,0,0
WA,46946,762393,0,354,5063,379,759,42,197,0,B,1447,5063,485619,39620,407151,46946,1447,149,920,16633,809339,809339,17553,809339,3,30
WI,46675,737191,146,368,4129,111,829,180,197,33130,A+,853,4129,485619,39620,407151,43018,846,7,727,6289,784012,783866,7016,783866,2,22
WV,5142,229838,0,77,5109,33,759,17,197,3466,B,100,5109,485619,39620,407151,5019,1900,149,100,3892,234980,234980,3992,234980,0,0
WY,2187,41927,0,13,144,379,759,180,197,1652,B,24,144,61032,1769,59262,1790,1900,149,61,0,44114,44114,61,44114,0,1
AK,2277,170733,0,27,5109,379,759,1,197,712,A,18,5109,173010,39620,407151,2277,18,149,118,4529,173010,173010,4647,173010,0,0
AL,67011,518522,0,1524,7782,379,988,180,526,29736,B,1287,7782,584387,39620,407151,65865,1254,33,1777,9261,585533,585533,11038,585533,1,0
AR,32533,386638,0,453,2177,379,759,97,307,25292,A+,357,2177,419171,39620,407151,32533,1900,149,771,5395,419171,419171,6166,419171,4,42
AS,0,1037,0,961,5109,379,759,180,197,0,C,0,5109,485619,39620,407151,0,1900,149,0,0,1037,1037,0,1037,0,0
AZ,143624,642355,0,3136,6632,894,759,622,197,18149,A+,2761,6632,785979,39620,407151,137710,2431,152,2359,11629,785979,785979,13988,785979,31,65
CA,384692,5902160,0,8398,5109,2107,759,180,197,0,B,7685,5109,6286852,39620,407151,384692,1900,149,9329,110305,6286852,6286852,119634,6286852,90,0
CO,39788,396150,0,401,6019,379,759,180,197,4948,A,1615,6019,485619,39620,407151,36698,1900,149,444,4711,435938,435938,5155,435938,0,25
CT,47893,609238,0,66,10654,379,759,180,197,8466,B,4396,10654,655309,39620,407151,46071,3519,877,0,27162,657131,657131,27162,657131,0,0
DC,11261,136504,0,91,5109,17,759,12,197,1886,A+,578,5109,485619,39620,407151,38775,1900,149,67,2743,147765,147765,2810,147765,0,0
DE,13519,139476,0,47,5109,9,759,180,197,7362,A+,523,5109,485619,39620,407151,12537,465,58,90,2148,152995,152995,2238,152995,0,0
FL,350047,2652594,2406,9363,21309,379,759,180,197,0,A,5091,21309,3775936,435616,3329053,350047,5091,149,12478,58175,3005047,3002641,70653,3002641,89,340
GA,143123,1112196,0,3036,15010,379,2822,180,197,0,A,3173,15010,1255319,130490,1124829,143123,1900,149,3251,20262,1255319,1255319,23513,1255319,5,49
GU,315,17938,0,4,5109,379,759,180,197,222,B,5,5109,18244,39620,407151,307,1900,149,0,0,18253,18253,0,18253,0,0
HI,1354,103281,0,39,140,379,759,180,197,1019,D,24,140,126454,39620,407151,38775,1900,149,20,1620,104635,104635,1640,104635,1,1
IA,38723,376768,0,214,5109,75,759,31,197,27894,A+,794,5109,485619,39620,407151,38723,1900,149,816,10946,415491,415491,11762,415491,7,0
ID,14302,131884,0,224,583,33,180,180,197,3989,A,119,583,145303,39620,407151,13419,97,22,550,3131,146186,146186,3681,146186,1,13
IL,162750,2082936,0,1356,5109,320,759,132,197,0,A,7488,5109,2244511,39620,407151,161575,7295,193,965,31148,2245686,2245686,32113,2245686,5,0
IN,56571,570309,0,786,7895,244,1675,81,197,40965,A+,2822,7895,485619,39620,407151,38775,2629,193,917,11508,626880,626880,12425,626880,2,34
KS,21965,227388,0,961,1453,58,427,14,161,983,A,299,1453,485619,39620,407151,38775,1900,149,0,0,249353,249353,0,249353,0,0
KY,23161,469563,0,511,2880,102,1035,180,197,6874,B,670,2880,485619,39620,407151,22095,666,4,977,1546,492724,492724,2523,492724,3,5
LA,91706,977598,0,1469,5109,379,759,177,197,53288,B,3543,5109,485619,39620,407151,38775,3433,110,3116,22248,1069304,1069304,25364,1069304,34,0
MA,113534,927001,0,498,11717,64,759,41,197,95390,A+,8431,11717,1328399,39620,407151,106882,8213,218,296,13406,1040535,1040535,13702,1040535,12,8
MD,78131,661654,0,449,11841,131,759,180,197,5344,A,3377,11841,943853,39620,407151,78131,3247,130,925,17874,739785,739785,18799,739785,9,53
ME,3687,133750,0,10,375,9,759,7,197,3148,A+,117,375,137016,4542,132293,3266,116,1,41,2467,137437,137437,2508,137437,0,0
MI,81868,1402591,0,680,5109,201,759,102,197,55162,A+,6366,5109,1505204,102613,1402591,73663,6119,247,530,27851,1484459,1484459,28381,1484459,2,0
MN,46204,806984,0,258,4627,120,1389,180,197,40001,A,1581,4627,853188,39620,407151,46204,1541,40,734,16492,853188,853188,17226,853188,3,25
MO,33094,525985,0,875,5109,379,759,86,197,0,B,1129,5109,709043,37936,670037,33094,1900,149,846,7357,559079,559079,8203,559079,-1,0
MP,37,10664,0,961,4,379,759,180,197,29,D,2,4,11335,39620,407151,37,2,149,0,0,10701,10701,0,10701,0,0
MS,42638,335439,0,1129,3727,278,759,132,197,25932,A,1355,3727,376793,39620,407151,42130,1324,31,792,0,378077,378077,792,378077,9,0
MT,2533,130626,0,47,165,379,759,180,197,1075,C,37,165,485619,39620,407151,2533,1900,149,62,1218,133159,133159,1280,133159,0,1
NC,99778,1295086,0,1115,5109,379,759,180,197,67124,A,1634,5109,485619,39620,407151,99778,1634,149,1820,13901,1394864,1394864,15721,1394864,5,0
ND,5019,128835,0,45,302,379,759,180,197,4131,D,82,302,257223,39620,407151,5019,78,4,112,2227,133854,133854,2339,133854,0,7
NE,22481,209920,0,113,1481,379,759,180,197,16801,B,301,1481,485619,39620,407151,22481,1900,149,120,1130,232401,232401,1250,232401,0,1
NH,6203,137175,0,17,673,379,193,180,197,5251,B,398,673,485619,39620,407151,6203,1900,149,38,1554,143378,143378,1592,143378,3,3
NJ,176783,1614354,0,766,21064,149,759,65,197,31405,A+,15706,21064,485619,39620,407151,176783,13732,1974,-31,9718,1791137,1791137,9687,1791137,7,0
NM,16736,443928,0,160,2364,379,759,180,197,6736,B,569,2364,485619,39620,407151,16736,1900,149,280,8086,460664,460664,8366,460664,4,27
NV,35765,354023,0,1045,5109,287,759,149,197,842,A+,647,5109,490644,39620,407151,35765,1900,149,1288,5963,389788,389788,7251,389788,1,0
NY,406807,4708663,0,722,89995,160,759,96,197,72161,A,25048,89995,485619,39620,407151,406807,1900,149,502,45702,5115470,5115470,46204,5115470,13,0
OH,74932,1087982,0,1065,9555,318,2315,163,197,51086,B,3174,9555,485619,39620,407151,70755,2916,258,1110,23368,1162914,1162914,24478,1162914,42,42
OK,25265,450675,0,547,2388,232,759,180,197,19466,A+,451,2388,479547,27903,450675,25265,1900,149,209,0,475940,475940,209,475940,0,13
OR,14579,321011,0,242,1327,64,759,34,197,3225,A+,260,1327,485619,39620,321011,13085,1900,149,430,4367,335590,335590,4797,335590,3,0
PA,101027,926352,0,703,5109,379,759,96,197,76780,A+,7015,5109,485619,39620,407151,98164,1900,149,786,13866,1027379,1027379,14652,1027379,8,0
PR,12063,255766,0,315,5109,26,759,18,197,0,B,178,5109,258001,3966,253922,3791,81,97,610,0,267829,267829,610,267829,0,0
RI,17793,161408,0,62,2088,4,759,2,197,1717,A+,990,2088,304770,25966,278804,17793,1900,149,0,0,179201,179201,0,179201,0,0
SC,69986,507400,0,1593,4182,379,759,180,197,22553,A,1155,4182,577165,87357,489808,69765,1138,17,2374,13019,577386,577386,15393,577386,20,0
SD,7906,90181,0,63,774,379,759,180,197,6952,B,118,774,485619,39620,407151,38775,1900,149,44,796,98087,98087,840,98087,2,3
TN,78115,1119182,0,1327,3681,379,759,180,197,44319,A,843,3681,1196543,91295,1105248,77361,812,31,1779,21866,1197297,1197297,23645,1197297,5,32
TX,325030,2607334,0,10592,5109,379,759,180,197,172936,B,3958,5109,2932364,39620,407151,325030,1900,149,7300,82379,2932364,2932364,89679,2932364,93,0
UT,34117,428705,0,296,2033,102,543,180,222,20915,A+,243,2033,545296,39620,407151,34117,1900,149,785,5797,462822,462822,6582,462822,0,19
VA,77430,829933,453,1186,11203,249,759,127,197,10017,A+,2027,11203,904423,39620,407151,74490,1923,104,1057,16605,907816,907363,17662,907363,2,61
VI,297,6587,54,961,5109,379,759,180,197,135,C,6,5109,485619,39620,407151,38775,6,149,14,348,6938,6884,362,6884,0,0
VT,1350,81150,0,24,5109,379,759,180,197,1137,B,56,5109,485619,39620,407151,1350,56,149,12,2042,82500,82500,2054,82500,0,0
WA,46026,745760,0,364,5033,379,759,62,197,0,B,1444,5033,485619,39620,407151,46026,1444,149,959,23170,791786,791786,24129,791786,10,49
WI,45948,730902,139,339,4107,99,826,180,197,32628,A+,851,4107,485619,39620,407151,42315,844,7,849,7259,776989,776850,8108,776850,1,25
WV,5042,225946,0,76,5109,32,759,15,197,3373,B,100,5109,485619,39620,407151,4918,1900,149,148,5329,230988,230988,5477,230988,0,0
WY,2126,41927,0,17,143,379,759,180,197,1615,B,24,143,61032,1769,59262,1728,1900,149,18,0,44053,44053,18,44053,0,1
AK,2159,166204,0,26,5109,379,759,1,197,708,A,18,5109,168363,39620,407151,2159,18,149,78,2871,168363,168363,2949,168363,1,0
AL,65234,509261,0,1463,7782,379,982,180,524,29736,B,1286,7782,573441,39620,407151,64180,1253,33,2143,9237,574495,574495,11380,574495,21,198
AR,31762,381243,0,464,2135,379,759,97,304,24776,A+,353,2135,413005,39620,407151,31762,1900,149,0,5508,413005,413005,5508,413005,0,65
AS,0,1037,0,961,5109,379,759,180,197,0,C,0,5109,485619,39620,407151,0,1900,149,0,0,1037,1037,0,1037,0,0
AZ,141265,630726,0,3238,6567,894,759,657,197,17661,A+,2730,6567,771991,39620,407151,137710,2431,152,2742,4281,771991,771991,7023,771991,147,165
CA,375363,5791855,0,8502,5109,2125,759,180,197,0,B,7595,5109,6167218,39620,407151,375363,1900,149,9199,113920,6167218,6167218,123119,6167218,120,0
CO,39344,391439,0,394,5994,379,759,180,197,4927,A,1615,5994,485619,39620,407151,36260,1900,149,618,5816,430783,430783,6434,430783,0,28
CT,47893,582076,0,66,10654,379,759,180,197,8466,B,4396,10654,627986,39620,407151,45910,3519,877,0,-139,629969,629969,-139,629969,0,0
DC,11194,133761,0,88,5109,17,759,12,197,1877,A+,578,5109,485619,39620,407151,38775,1900,149,79,3269,144955,144955,3348,144955,1,0
DE,13429,137328,0,51,5109,8,759,180,197,7362,A+,523,5109,485619,39620,407151,12447,465,58,92,2055,150757,150757,2147,150757,2,0
FL,337569,2594419,2320,9144,20969,379,759,180,197,0,A,5002,20969,3677144,420156,3246327,337569,5002,149,10328,40892,2934308,2931988,51220,2931988,90,443
GA,139872,1091934,0,2929,14961,379,2819,180,197,0,A,3168,14961,1231806,127413,1104393,139872,1900,149,4689,28439,1231806,1231806,33128,1231806,36,314
GU,315,17938,0,4,5109,379,759,180,197,222,B,5,5109,18244,39620,407151,307,1900,149,1,0,18253,18253,1,18253,0,0
HI,1334,101661,0,39,139,379,759,180,197,994,D,23,139,124068,39620,407151,38775,1900,149,23,1768,102995,102995,1791,102995,1,1
IA,37907,365822,0,210,5109,70,759,27,197,27820,A+,787,5109,485619,39620,407151,37907,1900,149,185,1091,403729,403729,1276,403729,3,0
ID,13752,128753,0,224,570,33,170,180,197,3827,A,118,570,141636,39620,407151,12883,96,22,619,1567,142505,142505,2186,142505,4,16
IL,161785,2051788,0,1360,5109,326,759,119,197,0,A,7483,5109,2212398,39620,407151,160610,7290,193,1276,44823,2213573,2213573,46099,2213573,18,0
IN,55654,558801,0,798,7861,245,1667,84,197,40722,A+,2820,7861,485619,39620,407151,38775,2627,193,841,8979,614455,614455,9820,614455,17,47
KS,21965,227388,0,961,1453,58,427,14,161,983,A,299,1453,485619,39620,407151,38775,1900,149,0,0,249353,249353,0,249353,0,0
KY,22184,468017,0,514,2875,109,1033,180,197,6824,B,667,2875,485619,39620,407151,21128,662,5,579,6560,490201,490201,7139,490201,9,11
LA,88590,955350,0,1413,5109,379,759,161,197,53288,B,3509,5109,485619,39620,407151,38775,3399,110,0,0,1043940,1043940,0,1043940,0,0
MA,113238,913595,0,499,11709,86,759,43,197,95390,A+,8419,11709,1309804,39620,407151,106664,8201,218,359,11887,1026833,1026833,12246,1026833,17,18
MD,77206,643780,0,448,11788,137,759,180,197,5344,A,3368,11788,914954,39620,407151,77206,3238,130,835,11935,720986,720986,12770,720986,9,60
ME,3646,131283,0,9,375,8,759,5,197,3136,A+,117,375,134535,4510,129845,3252,116,1,10,1474,134929,134929,1484,134929,2,0
MI,81338,1374740,0,680,5109,201,759,102,197,55162,A+,6364,5109,1476385,101645,1374740,73180,6117,247,745,29827,1456078,1456078,30572,1456078,9,0
MN,45470,790492,0,265,4602,117,1377,180,197,39310,A,1578,4602,835962,39620,407151,45470,1538,40,457,15994,835962,835962,16451,835962,5,39
MO,32248,518628,0,875,5109,379,759,86,197,0,B,1130,5109,696291,36842,658406,32248,1900,149,960,12020,550876,550876,12980,550876,9,0
MP,37,10664,0,961,4,379,759,180,197,29,D,2,4,11335,39620,407151,37,2,149,0,0,10701,10701,0,10701,0,0
MS,41846,335439,0,1076,3727,253,759,129,197,25932,A,1346,3727,376793,39620,407151,41354,1316,30,1017,4804,377285,377285,5821,377285,14,15
MT,2471,129408,0,46,164,379,759,180,197,1075,C,37,164,485619,39620,407151,2471,1900,149,105,1370,131879,131879,1475,131879,0,5
NC,97958,1281185,0,1154,5109,379,759,180,197,67124,A,1629,5109,485619,39620,407151,97958,1629,149,2481,32688,1379143,1379143,35169,1379143,23,0
ND,4907,126608,0,38,295,379,759,180,197,4029,D,82,295,251695,39620,407151,4907,78,4,115,1925,131515,131515,2040,131515,0,5
NE,22361,208790,0,105,1480,379,759,180,197,16665,B,301,1480,485619,39620,407151,22361,1900,149,227,4728,231151,231151,4955,231151,2,27
NH,6165,135621,0,24,670,379,192,180,197,5188,B,395,670,485619,39620,407151,6165,1900,149,0,0,141786,141786,0,141786,0,0
NJ,176814,1604636,0,800,21064,141,759,73,197,31400,A+,15699,21064,485619,39620,407151,176814,13725,1974,263,12259,1781450,1781450,12522,1781450,15,61
NM,16456,435842,0,166,2337,379,759,180,197,6654,B,565,2337,485619,39620,407151,16456,1900,149,318,8612,452298,452298,8930,452298,3,25
NV,34477,348060,0,1006,5109,285,759,150,197,842,A+,646,5109,480442,39620,407151,34477,1900,149,1182,4348,382537,382537,5530,382537,9,0
NY,406305,4662961,0,743,89995,172,759,100,197,72064,A,25035,89995,485619,39620,407151,406305,1900,149,754,69063,5069266,5069266,69817,5069266,11,0
OH,73822,1064614,0,1024,9513,315,2311,159,197,50280,B,3132,9513,485619,39620,407151,69684,2875,257,1542,20770,1138436,1138436,22312,1138436,20,68
OK,25056,450675,0,547,2375,232,759,180,197,19186,A+,451,2375,479547,27903,450675,25056,1900,149,916,9771,475731,475731,10687,475731,6,86
OR,14149,316644,0,242,1327,64,759,34,197,3225,A+,257,1327,485619,39620,316644,13085,1900,149,347,6251,330793,330793,6598,330793,3,0
PA,100241,912486,0,699,5109,379,759,93,197,76183,A+,7007,5109,485619,39620,407151,97388,1900,149,763,12574,1012727,1012727,13337,1012727,15,0
PR,11453,255766,0,316,5109,29,759,25,197,0,B,178,5109,258001,3966,253922,3461,81,97,333,0,267219,267219,333,267219,1,0
RI,17793,161408,0,62,2088,4,759,2,197,1717,A+,990,2088,304770,25966,278804,17793,1900,149,0,0,179201,179201,0,179201,0,0
SC,67612,494381,0,1593,4182,379,759,180,197,23849,A,1135,4182,561777,84547,477230,67396,1117,18,1552,7066,561993,561993,8618,561993,39,0
SD,7862,89385,0,70,771,379,759,180,197,6891,B,116,771,485619,39620,407151,38775,1900,149,73,1201,97247,97247,1274,97247,0,8
TN,76336,1097316,0,1378,3649,379,759,180,197,43706,A,838,3649,1172913,89132,1083781,75597,807,31,2517,20463,1173652,1173652,22980,1173652,23,87
TX,317730,2524955,0,10658,5109,379,759,180,197,169581,B,3865,5109,2842685,39620,407151,317730,1900,149,10158,65206,2842685,2842685,75364,2842685,130,0
UT,33332,422908,0,251,2014,91,541,180,222,20421,A+,243,2014,536950,39620,407151,33332,1900,149,760,7674,456240,456240,8434,456240,8,30
VA,76373,813328,421,1166,11142,254,759,108,197,9976,A+,2025,11142,886748,39620,407151,73420,1921,104,940,12057,890122,889701,12997,889701,12,88
VI,283,6239,132,961,5109,379,759,180,197,133,C,6,5109,485619,39620,407151,38775,6,149,20,449,6654,6522,469,6522,0,0
VT,1338,79108,0,25,5109,379,759,180,197,1125,B,56,5109,485619,39620,407151,1338,56,149,4,1076,80446,80446,1080,80446,0,0
WA,45067,722590,0,348,4984,379,759,46,197,0,B,1434,4984,485619,39620,407151,45067,1434,149,754,13729,767657,767657,14483,767657,7,40
WI,45099,723643,159,315,4082,89,823,180,197,32004,A+,850,4082,485619,39620,407151,41485,843,7,1031,11446,768901,768742,12477,768742,10,51
WV,4894,220617,0,74,5109,33,759,16,197,3295,B,100,5109,485619,39620,407151,4768,1900,149,111,2848,225511,225511,2959,225511,0,0
WY,2108,41927,0,16,142,379,759,180,197,1611,B,24,142,61032,1769,59262,1713,1900,149,39,0,44035,44035,39,44035,0,2
AK,2081,163333,0,32,5109,379,759,0,197,697,A,17,5109,165414,39620,407151,2081,17,149,49,2343,165414,165414,2392,165414,0,0
AL,63091,500024,0,1433,7584,379,967,180,521,29736,B,1265,7584,562135,39620,407151,62111,1232,33,2003,10003,563115,563115,12006,563115,35,0
AR,31762,375735,0,464,2070,379,759,97,298,24776,A,353,2070,406849,39620,407151,31762,1900,149,648,5888,407497,407497,6536,407497,12,76
AS,0,1037,0,961,5109,379,759,180,197,0,C,0,5109,485619,39620,407151,0,1900,149,0,0,1037,1037,0,1037,0,0
AZ,138523,626445,0,3466,6402,944,759,687,197,17184,A+,2583,6402,764155,39620,407151,137710,2431,152,3910,11792,764968,764968,15702,764968,91,106
CA,366164,5677935,0,8450,5109,2153,759,180,197,0,B,7475,5109,6044099,39620,407151,366164,1900,149,9986,118605,6044099,6044099,128591,6044099,130,0
CO,38726,385623,0,412,5966,379,759,180,197,4909,A,1615,5966,485619,39620,407151,35690,1900,149,571,7562,424349,424349,8133,424349,14,16
CT,47893,582215,0,66,10654,379,759,180,197,8466,B,4396,10654,627986,39620,407151,45771,3519,877,143,-118,630108,630108,25,630108,7,0
DC,11115,130492,0,87,5109,17,759,14,197,1863,A+,577,5109,485619,39620,407151,38775,1900,149,39,1326,141607,141607,1365,141607,3,0
DE,13337,135273,0,55,5109,7,759,180,197,7315,A+,521,5109,485619,39620,407151,12355,463,58,223,3517,148610,148610,3740,148610,0,0
FL,327241,2553527,2250,8961,20526,379,759,180,197,0,A,4912,20526,3600738,407133,3183379,327241,4912,149,11466,53684,2883018,2880768,65150,2880768,130,372
GA,135183,1063495,0,2902,14647,379,2781,180,197,0,A,3132,14647,1198678,123040,1075638,135183,1900,149,3908,16548,1198678,1198678,20456,1198678,28,301
GU,314,17938,0,4,5109,379,759,180,197,214,B,5,5109,18224,39620,407151,306,1900,149,0,241,18252,18252,241,18252,0,0
HI,1311,99893,0,39,138,379,759,180,197,975,D,22,138,121512,39620,407151,38775,1900,149,19,1798,101204,101204,1817,101204,0,1
IA,37722,364731,0,210,5109,70,759,32,197,27609,A+,784,5109,485619,39620,407151,37722,1900,149,590,5412,402453,402453,6002,402453,6,0
ID,13133,127186,0,153,554,35,165,180,197,3676,A,114,554,139481,39620,407151,12295,93,21,688,2768,140319,140319,3456,140319,4,28
IL,160509,2006965,0,1431,5109,309,759,128,197,0,A,7465,5109,2166299,39620,407151,159334,7272,193,1427,42308,2167474,2167474,43735,2167474,13,0
IN,54813,549822,0,815,7814,258,1658,80,197,40421,A+,2803,7814,485619,39620,407151,38775,2610,193,733,8344,604635,604635,9077,604635,8,67
KS,21965,227388,0,961,1453,58,427,14,161,983,A,299,1453,485619,39620,407151,38775,1900,149,1032,8947,249353,249353,9979,249353,0,60
KY,21605,461457,0,452,2864,89,1031,180,197,6772,B,658,2864,485619,39620,407151,20607,653,5,522,14536,483062,483062,15058,483062,8,22
LA,88590,955350,0,1413,5109,379,759,161,197,53288,B,3509,5109,485619,39620,407151,38775,3399,110,2179,17624,1043940,1043940,19803,1043940,24,0
MA,112879,901708,0,515,11691,76,759,34,197,95390,A+,8402,11691,1293162,39620,407151,106487,8184,218,298,12605,1014587,1014587,12903,1014587,22,28
MD,76371,631845,0,434,11728,128,759,180,197,5286,A,3359,11728,896990,39620,407151,76371,3227,132,707,14980,708216,708216,15687,708216,12,41
ME,3636,129809,0,12,375,11,759,5,197,3114,A+,115,375,133048,4491,128380,3239,114,1,38,2945,133445,133445,2983,133445,1,1
MI,80593,1344913,0,680,5109,201,759,88,197,53867,A+,6355,5109,1445361,100448,1344913,72502,6108,247,754,29598,1425506,1425506,30352,1425506,7,0
MN,45013,774498,0,252,4563,110,1369,180,197,38568,A,1573,4563,819511,39620,407151,45013,1533,40,666,13633,819511,819511,14299,819511,7,37
MO,31288,506608,0,875,5109,379,759,86,197,0,B,1121,5109,677038,36023,639989,31288,1900,149,866,7729,537896,537896,8595,537896,8,0
MP,37,10664,0,961,4,379,759,180,197,29,D,2,4,11335,39620,407151,37,2,149,1,0,10701,10701,1,10701,0,0
MS,40829,330635,0,1076,3712,253,759,129,197,25932,A,1332,3712,370993,39620,407151,40358,1303,29,1032,6532,371464,371464,7564,371464,24,37
MT,2366,128038,0,45,159,379,759,180,197,992,C,37,159,485619,39620,407151,2366,1900,149,135,2429,130404,130404,2564,130404,2,9
NC,95477,1248497,0,1180,5109,379,759,180,197,67124,A,1606,5109,485619,39620,407151,95477,1606,149,2051,29166,1343974,1343974,31217,1343974,18,0
ND,4792,124683,0,36,290,379,759,180,197,3903,D,82,290,246903,39620,407151,4792,78,4,124,1295,129475,129475,1419,129475,0,5
NE,22134,204062,0,96,1453,379,759,180,197,16501,B,299,1453,485619,39620,407151,22134,1900,149,155,2812,226196,226196,2967,226196,8,0
NH,6165,135621,0,24,670,379,192,180,197,5188,B,395,670,485619,39620,407151,6165,1900,149,52,3462,141786,141786,3514,141786,1,2
NJ,176551,1592377,0,868,21003,141,759,66,197,31400,A+,15684,21003,485619,39620,407151,176551,13710,1974,50,8974,1768928,1768928,9024,1768928,19,229
NM,16138,427230,0,170,2312,379,759,180,197,6578,B,562,2312,485619,39620,407151,16138,1900,149,297,6066,443368,443368,6363,443368,5,28
NV,33295,343712,0,1000,5109,269,759,134,197,842,A+,637,5109,472989,39620,407151,33295,1900,149,1380,4784,377007,377007,6164,377007,11,0
NY,405551,4593898,0,765,89995,179,759,98,197,71970,A,25024,89995,485619,39620,407151,405551,1900,149,776,77463,4999449,4999449,78239,4999449,10,0
OH,72280,1043844,0,1016,9445,319,2305,161,197,49302,B,3112,9445,485619,39620,407151,68175,2858,254,1679,25652,1116124,1116124,27331,1116124,9,121
OK,24140,440904,0,604,2289,247,759,180,197,18766,A+,445,2289,468644,26785,440904,24140,1900,149,699,7528,465044,465044,8227,465044,7,71
OR,13802,310393,0,242,1327,64,759,34,197,3199,A+,254,1327,485619,39620,310393,13085,1900,149,293,4956,324195,324195,5249,324195,5,16
PA,99478,899912,0,680,5109,379,759,98,197,75603,A+,6992,5109,485619,39620,407151,96651,1900,149,1032,14717,999390,999390,15749,999390,19,0
PR,11120,255766,0,302,5109,34,759,27,197,0,B,177,5109,258001,3966,253922,3272,80,97,546,0,266886,266886,546,266886,5,0
RI,17793,161408,0,62,2088,4,759,2,197,1717,A+,990,2088,304770,25966,278804,17793,1900,149,82,1731,179201,179201,1813,179201,2,4
SC,66060,487315,0,1593,4182,379,759,180,197,23849,A,1096,4182,553172,82636,470536,65857,1078,18,1977,11434,553375,553375,13411,553375,26,438
SD,7789,88184,0,61,763,379,759,180,197,6808,B,116,763,485619,39620,407151,38775,1900,149,95,1842,95973,95973,1937,95973,1,6
TN,73819,1076853,0,1436,3562,379,759,180,197,42734,A,815,3562,1149991,86064,1063927,73138,785,30,2279,24696,1150672,1150672,26975,1150672,19,65
TX,307572,2459749,0,10632,5109,379,759,180,197,162191,B,3735,5109,2767321,39620,407151,307572,1900,149,14916,52550,2767321,2767321,67466,2767321,174,0
UT,32572,415234,0,256,1984,96,532,180,220,19862,A+,235,1984,526288,39620,407151,32572,1900,149,727,7551,447806,447806,8278,447806,1,28
VA,75433,801271,470,1171,11054,247,759,118,197,9883,A+,2013,11054,873787,39620,407151,72516,1909,104,1002,14529,877174,876704,15531,876704,6,276
VI,263,5790,112,961,5109,379,759,180,197,126,C,6,5109,485619,39620,407151,38775,6,149,14,754,6165,6053,768,6053,0,0
VT,1334,78032,0,33,5109,379,759,180,197,1121,B,56,5109,485619,39620,407151,1334,56,149,9,317,79366,79366,326,79366,0,0
WA,44313,708861,0,379,4944,379,759,45,197,0,B,1427,4944,485619,39620,407151,44313,1427,149,1267,18021,753174,753174,19288,753174,6,115
WI,44068,712197,170,333,4031,97,816,180,197,31258,A+,840,4031,485619,39620,407151,40507,833,7,929,12527,756435,756265,13456,756265,2,63
WV,4783,217769,0,69,5109,37,759,15,197,3267,B,100,5109,485619,39620,407151,4658,1900,149,126,3252,222552,222552,3378,222552,1,0
WY,2069,41927,0,19,140,379,759,180,197,1590,B,24,140,61032,1769,59262,1678,1900,149,43,501,43996,43996,544,43996,0,9
AK,2032,160990,0,32,5109,379,759,0,197,688,A,17,5109,163022,39620,407151,2032,17,149,401,6528,163022,163022,6929,163022,0,0
AL,61088,490021,0,1395,7584,379,950,180,516,29736,B,1230,7584,550179,39620,407151,60158,1200,30,2021,8039,551109,551109,10060,551109,19,293
AR,31114,369847,0,470,1994,379,759,101,286,24195,A,341,1994,400144,39620,407151,31114,1900,149,817,4368,400961,400961,5185,400961,6,46
AS,0,1037,0,961,5109,379,759,180,197,0,C,0,5109,485619,39620,407151,0,1900,149,0,221,1037,1037,221,1037,0,0
AZ,134613,614653,0,3454,6296,918,759,657,197,16684,A+,2492,6296,748491,39620,407151,133838,2353,139,3259,10045,749266,749266,13304,749266,58,193
CA,356178,5559330,0,8363,5109,2120,759,180,197,0,B,7345,5109,5915508,39620,407151,356178,1900,149,8544,113688,5915508,5915508,122232,5915508,118,0
CO,38155,378061,0,389,5950,379,759,180,197,4880,A,1601,5950,485619,39620,407151,35126,1900,149,469,5757,416216,416216,6226,416216,7,-13
CT,47750,582333,0,66,10654,379,759,180,197,8466,B,4389,10654,627986,39620,407151,45653,3515,874,114,14311,630083,630083,14425,630083,9,102
DC,11076,129166,0,86,5109,24,759,14,197,1843,A+,574,5109,485619,39620,407151,38775,1900,149,50,2248,140242,140242,2298,140242,3,0
DE,13114,131756,0,50,5109,8,759,180,197,7269,A+,521,5109,485619,39620,407151,12131,463,58,64,1418,144870,144870,1482,144870,0,0
FL,315775,2499843,2163,9112,20154,379,759,180,197,0,A,4782,20154,3509789,393209,3106801,315775,4782,149,13965,65700,2817781,2815618,79665,2815618,156,495
GA,131275,1046947,0,2841,14346,379,2736,180,197,0,A,3104,14346,1178222,119761,1058461,131275,1900,149,3441,19798,1178222,1178222,23239,1178222,13,244
GU,314,17697,0,4,5109,379,759,180,197,214,B,5,5109,18003,39620,407151,306,1900,149,1,183,18011,18011,184,18011,0,0
HI,1292,98095,0,40,137,379,759,180,197,951,D,22,137,118842,39620,407151,38775,1900,149,28,1802,99387,99387,1830,99387,0,4
IA,37132,359319,0,195,5109,65,759,34,197,27404,A+,778,5109,485619,39620,407151,37132,1900,149,841,8298,396451,396451,9139,396451,16,0
ID,12445,124418,0,153,526,35,151,180,197,3513,A,110,526,136055,39620,407151,11637,89,21,727,2222,136863,136863,2949,136863,7,16
IL,159082,1964657,0,1434,5109,311,759,127,197,0,A,7452,5109,2122607,39620,407151,157950,7251,201,1257,41749,2123739,2123739,43006,2123739,25,0
IN,54080,541478,0,827,7747,292,1643,86,197,40004,A+,2795,7747,485619,39620,407151,38775,2602,193,710,8259,595558,595558,8969,595558,10,61
KS,20933,218441,0,961,1393,65,418,21,159,948,A,299,1393,485619,39620,407151,38775,1900,149,0,0,239374,239374,0,239374,0,0
KY,21083,446921,0,418,2842,92,1030,180,197,5500,B,650,2842,485619,39620,407151,20118,646,4,406,8411,468004,468004,8817,468004,5,19
LA,86411,937726,0,1401,5109,379,759,162,197,53288,B,3485,5109,485619,39620,407151,38775,3375,110,2280,20657,1024137,1024137,22937,1024137,24,0
MA,112581,889103,0,557,11663,77,759,38,197,95390,A+,8380,11663,1274585,39620,407151,106271,8163,217,234,12737,1001684,1001684,12971,1001684,12,12
MD,75664,616865,0,436,11687,137,759,180,197,5286,A,3347,11687,872832,39620,407151,75664,3215,132,648,11793,692529,692529,12441,692529,6,62
ME,3598,126864,0,13,374,11,759,4,197,3094,A+,114,374,130071,4445,125450,3207,113,1,20,2511,130462,130462,2531,130462,0,1
MI,79839,1315315,0,680,5109,201,759,107,197,53867,A+,6348,5109,1414802,99487,1315315,71842,6101,247,926,26309,1395154,1395154,27235,1395154,18,0
MN,44347,760865,0,249,4526,103,1357,180,197,38290,A,1566,4526,805212,39620,407151,44347,1526,40,605,14110,805212,805212,14715,805212,8,31
MO,30422,498879,0,875,5109,379,759,86,197,0,B,1113,5109,664810,35179,628610,30422,1900,149,708,10646,529301,529301,11354,529301,11,0
MP,36,10664,0,961,4,379,759,180,197,29,D,2,4,11335,39620,407151,36,2,149,0,0,10700,10700,0,10700,0,0
MS,39797,324103,0,1117,3675,247,759,125,197,25932,A,1308,3675,363487,39620,407151,39384,1283,25,1230,5813,363900,363900,7043,363900,18,46
MT,2231,125609,0,37,150,379,759,180,197,970,C,35,150,485619,39620,407151,2231,1900,149,135,3947,127840,127840,4082,127840,1,5
NC,93426,1219331,0,1134,5109,379,759,180,197,67124,A,1588,5109,485619,39620,407151,93426,1588,149,2160,25960,1312757,1312757,28120,1312757,20,0
ND,4668,123388,0,38,285,379,759,180,197,3796,D,82,285,242778,39620,407151,4668,78,4,103,1389,128056,128056,1492,128056,1,1
NE,21979,201250,0,103,1453,379,759,180,197,16324,B,291,1453,485619,39620,407151,21979,1900,149,262,3224,223229,223229,3486,223229,5,11
NH,6113,132159,0,24,668,379,192,180,197,5125,B,394,668,485619,39620,407151,6113,1900,149,22,1141,138272,138272,1163,138272,2,3
NJ,176501,1583403,0,862,20774,146,759,64,197,31400,A+,15665,20774,485619,39620,407151,176501,13691,1974,223,17334,1759904,1759904,17557,1759904,58,0
NM,15841,421164,0,174,2284,379,759,180,197,6496,B,557,2284,485619,39620,407151,15841,1900,149,327,6672,437005,437005,6999,437005,6,23
NV,31915,338928,0,1051,5109,251,759,124,197,834,A+,626,5109,465682,39620,407151,31915,1900,149,1447,4971,370843,370843,6418,370843,8,0
NY,404775,4516435,0,813,89995,165,759,88,197,71867,A,25014,89995,485619,39620,407151,404775,1900,149,769,71916,4921210,4921210,72685,4921210,11,0
OH,70601,1018192,0,1024,9324,310,2280,150,197,48330,B,3103,9324,485619,39620,407151,66540,2849,254,1290,24880,1088793,1088793,26170,1088793,28,115
OK,23441,433376,0,638,2218,235,759,180,197,18095,A+,438,2218,460246,25931,433376,23441,1900,149,628,8864,456817,456817,9492,456817,6,48
OR,13509,305437,0,219,1311,63,759,33,197,3199,A+,249,1311,485619,39620,305437,12807,1900,149,428,6732,318946,318946,7160,318946,2,21
PA,98446,885195,0,652,5109,379,759,95,197,74818,A+,6973,5109,485619,39620,407151,95632,1900,149,781,14211,983641,983641,14992,983641,16,0
PR,10574,255766,0,280,5109,25,759,14,197,0,B,172,5109,258001,3966,253922,3119,75,97,195,0,266340,266340,195,266340,1,0
RI,17711,159677,0,64,2084,4,759,3,197,1711,A+,988,2084,300801,25850,274951,17711,1900,149,71,1442,177388,177388,1513,177388,1,9
SC,64083,475881,0,1578,3744,379,759,180,197,23849,A,1070,3744,539761,80112,459649,63880,1053,17,1838,12143,539964,539964,13981,539964,72,0
SD,7694,86342,0,61,757,379,759,180,197,6737,B,115,757,485619,39620,407151,38775,1900,149,42,451,94036,94036,493,94036,4,5
TN,71540,1052157,0,1416,3497,379,759,180,197,41250,A,796,3497,1123038,83227,1039811,70881,767,29,2479,23545,1123697,1123697,26024,1123697,13,63
TX,292656,2407199,0,10457,5109,379,759,180,197,155937,B,3561,5109,2699855,39620,407151,292656,1900,149,10291,47365,2699855,2699855,57656,2699855,129,0
UT,31845,407683,0,236,1956,89,523,180,214,19214,A+,234,1956,516003,39620,407151,31845,1900,149,954,6494,439528,439528,7448,439528,1,43
VA,74431,786742,444,1134,10778,248,759,118,197,9644,A+,2007,10778,858312,39620,407151,71570,1903,104,904,15287,861617,861173,16191,861173,15,170
VI,249,5036,168,961,5109,379,759,180,197,120,C,6,5109,485619,39620,407151,38775,6,149,6,399,5453,5285,405,5285,0,0
VT,1325,77715,0,25,5109,379,759,180,197,1111,B,56,5109,485619,39620,407151,1325,56,149,7,675,79040,79040,682,79040,0,0
WA,43046,690840,0,372,4829,379,759,53,197,0,B,1421,4829,485619,39620,407151,43046,1421,149,742,14910,733886,733886,15652,733886,17,41
WI,43139,699670,154,310,3968,88,811,180,197,30555,A+,838,3968,485619,39620,407151,39627,831,7,942,13371,742963,742809,14313,742809,4,45
WV,4657,214517,0,65,5109,29,759,13,197,3128,B,99,5109,485619,39620,407151,4535,1900,149,100,1170,219174,219174,1270,219174,2,0
WY,2026,41426,0,18,131,379,759,180,197,1540,B,24,131,60203,1745,58457,1644,1900,149,41,497,43452,43452,538,43452,2,0
AK,1631,154462,0,32,5109,379,759,0,197,669,A,17,5109,156093,39620,407151,1631,17,149,52,6568,156093,156093,6620,156093,0,0
AL,59067,481982,0,1332,7291,379,941,180,514,29736,B,1211,7291,540207,39620,407151,58225,1183,28,1812,10148,541049,541049,11960,541049,47,168
AR,30297,365479,0,458,1948,379,759,94,279,23523,A,335,1948,395212,39620,407151,30297,1900,149,564,4913,395776,395776,5477,395776,4,76
AS,0,816,0,961,5109,379,759,180,197,0,C,0,5109,485619,39620,407151,0,1900,149,0,0,816,816,0,816,0,0
AZ,131354,604608,0,3493,6103,929,759,671,197,16155,A+,2434,6103,735184,39620,407151,130576,2295,139,3257,10762,735962,735962,14019,735962,97,161
CA,347634,5445642,0,8353,5109,2110,759,180,197,0,B,7227,5109,5793276,39620,407151,347634,1900,149,11126,107195,5793276,5793276,118321,5793276,140,0
CO,37686,372304,0,368,5963,379,759,180,197,4844,A,1594,5963,485619,39620,407151,34663,1900,149,444,4591,409990,409990,5035,409990,5,22
CT,47636,568022,0,67,10552,379,759,180,197,8351,B,4380,10552,613569,39620,407151,45547,3505,875,106,11429,615658,615658,11535,615658,8,0
DC,11026,126918,0,95,5109,24,759,15,197,1809,A+,571,5109,485619,39620,407151,38775,1900,149,80,3948,137944,137944,4028,137944,3,0
DE,13050,130338,0,51,5109,11,759,180,197,7236,A+,521,5109,485619,39620,407151,12069,463,58,81,1707,143388,143388,1788,143388,3,0
FL,301810,2434143,2189,8217,19659,379,759,180,197,0,A,4626,19659,3404892,376345,3019257,301810,4626,149,10181,40529,2738142,2735953,50710,2735953,112,458
GA,127834,1027149,0,2786,14102,379,2702,180,197,0,A,3091,14102,1154983,116295,1038688,127834,1900,149,3871,20078,1154983,1154983,23949,1154983,37,417
GU,313,17514,0,4,5109,379,759,180,197,213,B,5,5109,17819,39620,407151,305,1900,149,1,289,17827,17827,290,17827,0,0
HI,1264,96293,0,31,133,379,759,180,197,921,D,22,133,116275,39620,407151,38775,1900,149,21,1466,97557,97557,1487,97557,0,5
IA,36291,351021,0,190,5109,62,759,30,197,27177,A+,762,5109,485619,39620,407151,36291,1900,149,442,6462,387312,387312,6904,387312,5,0
ID,11718,122196,0,153,510,35,151,180,197,3360,A,103,510,133142,39620,407151,10946,83,20,316,3314,133914,133914,3630,133914,1,10
IL,157825,1922908,0,1454,5109,324,759,130,197,0,A,7427,5109,2079601,39620,407151,156693,7226,201,1187,36974,2080733,2080733,38161,2080733,8,0
IN,53370,533219,0,881,7686,284,1634,79,197,39571,A+,2785,7686,485619,39620,407151,38775,2592,193,685,7495,586589,586589,8180,586589,10,53
KS,20933,218441,0,961,1393,65,418,21,159,948,A,299,1393,485619,39620,407151,38775,1900,149,875,7324,239374,239374,8199,239374,11,50
KY,20677,438510,0,445,2823,92,1028,180,197,5475,B,645,2823,485619,39620,407151,19737,641,4,454,3177,459187,459187,3631,459187,10,21
LA,84131,917069,0,1369,5109,379,759,149,197,53288,B,3461,5109,485619,39620,407151,38775,3351,110,2089,22656,1001200,1001200,24745,1001200,16,0
MA,112347,876366,0,580,11651,80,759,40,197,95390,A+,8368,11651,1256303,39620,407151,106128,8152,216,217,10282,988713,988713,10499,988713,28,26
MD,75016,605072,0,447,11625,129,759,180,197,5238,A,3341,11625,855941,39620,407151,75016,3209,132,756,13263,680088,680088,14019,680088,7,140
ME,3578,124353,0,12,373,9,759,4,197,3079,A+,114,373,127539,4415,122948,3186,113,1,12,2444,127931,127931,2456,127931,0,0
MI,78913,1289006,0,543,5109,184,759,107,197,53867,A+,6330,5109,1387545,98539,1289006,71197,6085,245,1049,33084,1367919,1367919,34133,1367919,4,0
MN,43742,746755,0,254,4495,106,1353,180,197,38179,A,1558,4495,790497,39620,407151,43742,1518,40,572,12311,790497,790497,12883,790497,10,43
MO,29714,488233,0,875,5109,379,759,86,197,0,B,1102,5109,646880,34290,611600,29714,1900,149,888,11956,517947,517947,12844,517947,9,0
MP,36,10664,0,961,4,379,759,180,197,29,D,2,4,11335,39620,407151,36,2,149,3,0,10700,10700,3,10700,0,0
MS,38567,318290,0,1099,3629,240,759,132,197,25932,A,1290,3629,356488,39620,407151,38198,1266,24,1025,5619,356857,356857,6644,356857,18,44
MT,2096,121662,0,37,145,379,759,180,197,915,C,34,145,485619,39620,407151,2096,1900,149,144,2218,123758,123758,2362,123758,0,9
NC,91266,1193371,0,1142,5109,379,759,180,197,67124,A,1568,5109,485619,39620,407151,91266,1568,149,1782,28009,1284637,1284637,29791,1284637,16,0
ND,4565,121999,0,42,284,379,759,180,197,3760,D,81,284,238586,39620,407151,4565,77,4,72,1459,126564,126564,1531,126564,3,4
NE,21717,198026,0,110,1442,379,759,180,197,16205,B,286,1442,485619,39620,407151,21717,1900,149,318,3190,219743,219743,3508,219743,-2,11
NH,6091,131018,0,23,665,379,191,180,197,5101,B,392,665,485619,39620,407151,6091,1900,149,23,1058,137109,137109,1081,137109,1,76
NJ,176278,1566069,0,923,20774,151,759,78,197,31400,A+,15607,20774,485619,39620,407151,176278,13660,1947,363,20753,1742347,1742347,21116,1742347,25,142
NM,15514,414492,0,171,2261,379,759,180,197,6429,B,551,2261,485619,39620,407151,15514,1900,149,223,5428,430006,430006,5651,430006,3,34
NV,30468,333957,0,1051,5109,251,759,124,197,826,A+,618,5109,457521,39620,407151,30468,1900,149,849,3396,364425,364425,4245,364425,6,0
NY,404006,4444519,0,831,89995,165,759,94,197,71782,A,25003,89995,485619,39620,407151,404006,1900,149,831,62767,4848525,4848525,63598,4848525,9,0
OH,69311,993312,0,1027,9209,316,2259,146,197,47303,B,3075,9209,485619,39620,407151,65287,2819,256,1316,17558,1062623,1062623,18874,1062623,6,160
OK,22813,424512,0,561,2170,231,759,180,197,17366,A+,432,2170,450388,24954,424512,22813,1900,149,1075,4956,447325,447325,6031,447325,4,54
OR,13081,298705,0,207,1290,53,759,30,197,3129,A+,247,1290,485619,39620,298705,12406,1900,149,276,6054,311786,311786,6330,311786,3,36
PA,97665,870984,0,667,5109,379,759,92,197,74436,A+,6957,5109,485619,39620,407151,94873,1900,149,994,20372,968649,968649,21366,968649,26,0
PR,10379,255766,0,254,5109,18,759,11,197,0,B,171,5109,258001,3966,253922,3043,75,96,256,0,266145,266145,256,266145,2,0
RI,17640,158235,0,59,2075,5,759,3,197,1707,A+,987,2075,296933,25734,271199,17640,1900,149,52,1165,175875,175875,1217,175875,2,5
SC,62245,463738,0,1560,3744,379,759,180,197,23849,A,998,3744,525983,77107,448876,62071,984,14,1856,6646,525983,525983,8502,525983,5,0
SD,7652,85891,0,59,752,379,759,180,197,6663,B,111,752,485619,39620,407151,38775,1900,149,80,1299,93543,93543,1379,93543,2,8
TN,69061,1028612,0,1282,3434,379,759,180,197,39857,A,783,3434,1097053,80368,1016685,68441,755,28,2273,23512,1097673,1097673,25785,1097673,16,56
TX,282365,2359834,0,10471,5109,379,759,180,197,149276,B,3432,5109,2642199,39620,407151,282365,1900,149,7307,36212,2642199,2642199,43519,2642199,110,0
UT,30891,401189,0,250,1913,83,515,180,214,18593,A+,233,1913,485619,39620,407151,30891,1900,149,413,7146,432080,432080,7559,432080,7,25
VA,73527,771455,382,1081,10608,246,759,113,197,9527,A+,1992,10608,842124,39620,407151,70669,1882,110,1084,13048,845364,844982,14132,844982,15,58
VI,243,4637,199,961,5109,379,759,180,197,112,C,6,5109,485619,39620,407151,38775,6,149,37,553,5079,4880,590,4880,0,0
VT,1318,77040,0,19,5109,379,759,180,197,1104,B,56,5109,485619,39620,407151,1318,56,149,13,721,78358,78358,734,78358,0,0
WA,42304,675930,0,353,4788,379,759,55,197,0,B,1404,4788,485619,39620,407151,42304,1404,149,547,9413,718234,718234,9960,718234,5,10
WI,42197,686299,177,295,3923,88,810,180,197,29923,A+,834,3923,485619,39620,407151,38727,827,7,848,13104,728673,728496,13952,728496,1,31
WV,4557,213347,0,63,5109,26,759,13,197,2999,B,97,5109,485619,39620,407151,4439,1900,149,150,3742,217904,217904,3892,217904,0,0
WY,1985,40929,0,17,131,379,759,180,197,1506,B,22,131,59347,1780,57566,1605,1900,149,34,2852,42914,42914,2886,42914,0,3
AK,1579,147894,0,25,5109,379,759,1,197,642,A,17,5109,149473,39620,407151,1579,17,149,40,2843,149473,149473,2883,149473,0,0
AL,57255,471834,0,1362,7123,379,931,180,511,25783,B,1164,7123,485619,39620,407151,56441,1136,28,1710,7775,529089,529089,9485,529089,40,378
AR,29733,360566,0,445,1872,379,759,91,273,22844,A,331,1872,389505,39620,407151,29733,1900,149,794,6531,390299,390299,7325,390299,8,36
AS,0,816,0,961,5109,379,759,180,197,0,C,0,5109,485619,39620,407151,0,1900,149,0,0,816,816,0,816,0,0
AZ,128097,593846,0,3517,5942,970,759,674,197,15678,A+,2337,5942,721191,39620,407151,127345,2208,129,4273,15244,721943,721943,19517,721943,92,103
CA,336508,5338447,0,8145,5109,2083,759,180,197,0,B,7087,5109,5674955,39620,407151,336508,1900,149,7346,123244,5674955,5674955,130590,5674955,47,0
CO,37242,367713,0,378,5941,379,759,180,197,4808,A,1589,5941,485619,39620,407151,34229,1900,149,329,5261,404955,404955,5590,404955,3,46
CT,47530,556593,0,66,10552,379,759,180,197,8351,B,4372,10552,602116,39620,407151,45523,3497,875,20,12123,604123,604123,12143,604123,1,0
DC,10946,122970,0,91,5109,21,759,14,197,1774,A+,568,5109,485619,39620,407151,38775,1900,149,40,3656,133916,133916,3696,133916,0,0
DE,12969,128631,0,48,5109,10,759,180,197,7184,A+,518,5109,485619,39620,407151,11989,460,58,90,2147,141600,141600,2237,141600,1,0
FL,291629,2393614,387,8354,19201,379,759,180,197,0,A,4514,19201,3330418,363828,2957751,291629,4514,149,9194,36475,2685630,2685243,45669,2685243,133,384
GA,123963,1007071,0,2741,13685,379,2662,180,197,0,A,3054,13685,1131034,113044,1017990,123963,1900,149,3394,19673,1131034,1131034,23067,1131034,28,209
GU,312,17225,0,3,5109,379,759,180,197,210,B,5,5109,17529,39620,407151,304,1900,149,0,195,17537,17537,195,17537,0,0
HI,1243,94827,0,23,128,379,759,180,197,911,D,22,128,114109,39620,407151,38775,1900,149,23,877,96070,96070,900,96070,3,3
IA,35849,344559,0,186,5109,67,759,32,197,26952,A+,757,5109,485619,39620,407151,35849,1900,149,320,3372,380408,380408,3692,380408,3,0
ID,11402,118882,0,153,500,35,144,180,197,3262,A,102,500,129540,39620,407151,10658,82,20,500,2652,130284,130284,3152,130284,0,23
IL,156638,1885934,0,1416,5109,333,759,126,197,0,A,7419,5109,2041440,39620,407151,155506,7218,201,707,27739,2042572,2042572,28446,2042572,25,0
IN,52685,525724,0,767,7633,266,1620,73,197,39155,A+,2775,7633,485619,39620,407151,38775,2582,193,648,7352,578409,578409,8000,578409,13,59
KS,20058,211117,0,961,1343,379,410,180,160,920,A,288,1343,485619,39620,407151,38775,1900,149,0,0,231175,231175,0,231175,0,0
KY,20223,435333,0,449,2802,84,1019,180,197,5389,B,635,2802,485619,39620,407151,19349,631,4,570,13101,455556,455556,13671,455556,6,11
LA,82042,894413,0,1362,5109,379,759,146,197,46334,B,3445,5109,485619,39620,407151,38775,3337,108,2215,20814,976455,976455,23029,976455,22,0
MA,112130,866084,0,560,11625,93,759,37,197,94347,A+,8340,11625,1241465,39620,407151,105986,8125,215,303,11768,978214,978214,12071,978214,10,14
MD,74260,591809,0,415,11485,118,759,180,197,5238,A,3334,11485,834408,39620,407151,74260,3202,132,733,13379,666069,666069,14112,666069,9,18
ME,3566,121909,0,17,373,7,759,3,197,3062,A+,114,373,125077,4389,120516,3168,113,1,8,1505,125475,125475,1513,125475,0,1
MI,77864,1255922,0,543,5109,184,759,109,197,53867,A+,6326,5109,1353182,97260,1255922,70306,6081,245,666,19693,1333786,1333786,20359,1333786,5,0
MN,43170,734444,0,236,4452,107,1348,180,197,37749,A,1548,4452,777614,39620,407151,43170,1510,38,398,8227,777614,777614,8625,777614,6,28
MO,28826,476277,0,811,5109,379,759,74,197,0,B,1093,5109,633226,33231,599011,28826,1900,149,936,8390,505103,505103,9326,505103,10,0
MP,33,10664,0,961,4,379,759,180,197,19,D,2,4,11335,39620,407151,33,2,149,0,-70,10697,10697,-70,10697,0,0
MS,37542,312671,0,1059,3585,227,759,126,197,25932,A,1272,3585,349869,39620,407151,37198,1249,23,862,5936,350213,350213,6798,350213,22,55
MT,1952,119444,0,29,136,379,759,180,197,884,C,34,136,485619,39620,407151,1952,1900,149,109,2592,121396,121396,2701,121396,2,3
NC,89484,1165362,0,1109,5109,379,759,180,197,67124,A,1552,5109,485619,39620,407151,89484,1552,149,1956,32404,1254846,1254846,34360,1254846,42,0
ND,4493,120540,0,42,280,379,759,180,197,3685,D,78,280,235497,39620,407151,4493,74,4,51,1104,125033,125033,1155,125033,0,3
NE,21399,194836,0,101,1431,379,759,180,197,16025,B,288,1431,485619,39620,407151,21399,1900,149,227,4349,216235,216235,4576,216235,3,10
NH,6068,129960,0,24,589,379,191,180,197,5056,B,391,589,485619,39620,407151,6068,1900,149,14,1148,136028,136028,1162,136028,0,0
NJ,175915,1545316,0,888,20632,149,759,79,197,31318,A+,15582,20632,485619,39620,407151,175915,13635,1947,393,20453,1721231,1721231,20846,1721231,22,0
NM,15291,409064,0,172,2227,379,759,180,197,6363,B,548,2227,485619,39620,407151,15291,1900,149,263,5735,424355,424355,5998,424355,3,23
NV,29619,330561,0,983,5109,247,759,121,197,800,A+,612,5109,452381,39620,407151,29619,1900,149,1104,5883,360180,360180,6987,360180,19,0
NY,403175,4381752,0,820,89995,167,759,101,197,71692,A,24994,89995,485619,39620,407151,403175,1900,149,912,59133,4784927,4784927,60045,4784927,5,0
OH,67995,975754,0,1017,9049,314,2223,156,197,46282,B,3069,9049,485619,39620,407151,64013,2813,256,1142,17856,1043749,1043749,18998,1043749,5,134
OK,21738,419556,0,546,2116,234,759,180,197,16635,A+,428,2116,444852,24383,419556,21738,1900,149,993,19519,441294,441294,20512,441294,4,53
OR,12805,292651,0,235,1254,64,759,35,197,3129,A+,244,1254,485619,39620,292651,12151,1900,149,367,4377,305456,305456,4744,305456,7,20
PA,96671,850612,0,678,5109,379,759,95,197,74436,A+,6931,5109,485619,39620,407151,93906,1900,149,929,14880,947283,947283,15809,947283,20,0
PR,10123,255766,0,206,5109,14,759,9,197,0,B,169,5109,258001,3966,253922,2904,73,96,113,0,265889,265889,113,265889,2,0
RI,17588,157070,0,69,2070,5,759,3,197,1692,A+,985,2070,293844,25653,268191,17588,1900,149,101,1314,174658,174658,1415,174658,1,4
SC,60389,457092,0,1550,3744,379,759,180,197,23849,A,993,3744,517312,75115,442197,60220,984,9,2221,8159,517481,517481,10380,517481,21,346
SD,7572,84592,0,62,744,379,759,180,197,6599,B,109,744,485619,39620,407151,38775,1900,149,48,738,92164,92164,786,92164,0,2
TN,66788,1005100,0,1222,3378,379,759,180,197,38272,A,767,3378,1071320,77673,993647,66220,740,27,1514,16413,1071888,1071888,17927,1071888,18,94
TX,275058,2323622,0,10569,5109,379,759,180,197,142398,B,3322,5109,2598680,39620,407151,275058,1900,149,10745,47810,2598680,2598680,58555,2598680,87,0
UT,30478,394043,0,231,1888,80,505,180,210,18111,A+,226,1888,485619,39620,407151,30478,1900,149,448,5738,424521,424521,6186,424521,10,38
VA,72443,758407,420,1127,10550,249,759,112,197,9423,A+,1977,10550,828017,39620,407151,69610,1870,107,801,16034,831270,830850,16835,830850,9,91
VI,206,4084,6,961,5109,379,759,180,197,96,C,6,5109,485619,39620,407151,38775,6,149,0,0,4296,4290,0,4290,0,0
VT,1305,76319,0,15,5109,379,759,180,197,1099,B,56,5109,485619,39620,407151,1305,56,149,4,1039,77624,77624,1043,77624,0,0
WA,41757,666517,0,332,4778,379,759,39,197,0,B,1399,4778,485619,39620,407151,41757,1399,149,1101,21168,708274,708274,22269,708274,-39,27
WI,41349,673195,147,293,3892,83,804,180,197,29275,A+,833,3892,485619,39620,407151,37906,826,7,967,13716,714691,714544,14683,714544,6,42
WV,4407,209605,0,59,5109,24,759,7,197,2982,B,97,5109,485619,39620,407151,4289,1900,149,148,5639,214012,214012,5787,214012,1,0
WY,1951,38077,0,14,128,379,759,180,197,1462,B,22,128,54917,1592,53324,1581,1900,149,89,0,40028,40028,89,40028,1,4
AK,1539,145051,0,22,5109,379,759,0,197,620,A,17,5109,146590,39620,407151,1539,17,149,60,1055,146590,146590,1115,146590,0,0
AL,55545,464059,0,1335,6745,379,919,180,505,25783,B,1124,6745,485619,39620,407151,54768,1096,28,1958,6140,519604,519604,8098,519604,3,0
AR,28939,354035,0,439,1836,379,759,89,269,22106,A,323,1836,382402,39620,407151,28939,1900,149,572,0,382974,382974,572,382974,2,14
AS,0,816,0,961,5109,379,759,180,197,0,C,0,5109,485619,39620,407151,0,1900,149,0,0,816,816,0,816,0,0
AZ,123824,578602,0,3373,5839,936,759,671,197,15254,A+,2245,5839,701703,39620,407151,123101,2122,123,1357,4897,702426,702426,6254,702426,8,44
CA,329162,5215203,0,7895,5109,2021,759,180,197,0,B,7040,5109,5544365,39620,407151,329162,1900,149,8358,129408,5544365,5544365,137766,5544365,23,0
CO,36913,362452,0,324,5895,379,759,180,197,4780,A,1586,5895,485619,39620,407151,33911,1900,149,322,6940,399365,399365,7262,399365,0,10
CT,47510,544470,0,74,10552,379,759,180,197,8351,B,4371,10552,589778,39620,407151,45308,3492,879,223,2363,591980,591980,2586,591980,23,0
DC,10906,119314,0,93,5109,25,759,16,197,1756,A+,568,5109,485619,39620,407151,38775,1900,149,59,3278,130220,130220,3337,130220,0,0
DE,12879,126484,0,49,5109,12,759,180,197,7139,A+,517,5109,485619,39620,407151,11898,459,58,75,1879,139363,139363,1954,139363,0,0
FL,282435,2357139,1995,8051,18817,379,759,180,197,0,A,4381,18817,3268471,351831,2908137,282435,4381,149,12624,52943,2641569,2639574,65567,2639574,35,227
GA,120569,987398,0,2600,13476,379,2643,180,197,0,A,3026,13476,1107967,109888,998079,120569,1900,149,3643,20908,1107967,1107967,24551,1107967,25,217
GU,312,17030,0,3,5109,379,759,180,197,202,B,5,5109,17334,39620,407151,304,1900,149,0,363,17342,17342,363,17342,0,0
HI,1220,93950,0,961,125,379,759,180,197,890,D,19,125,112882,39620,407151,38775,1900,149,20,1230,95170,95170,1250,95170,0,0
IA,35529,341187,0,186,5109,67,759,32,197,26664,A+,754,5109,485619,39620,407151,35529,1900,149,458,1845,376716,376716,2303,376716,4,0
ID,10902,116230,0,153,477,35,142,180,197,3179,A,102,477,126393,39620,407151,10163,82,20,397,1474,127132,127132,1871,127132,0,9
IL,155931,1858195,0,1362,5109,334,759,136,197,0,A,7394,5109,2012994,39620,407151,154799,7193,201,883,29129,2014126,2014126,30012,2014126,6,0
IN,52037,518372,0,764,7574,255,1601,71,197,38914,A+,2762,7574,485619,39620,407151,38775,2569,193,425,5337,570409,570409,5762,570409,2,47
KS,20058,211117,0,961,1343,379,410,180,160,920,A,288,1343,485619,39620,407151,38775,1900,149,1447,11949,231175,231175,13396,231175,4,39
KY,19653,422232,0,440,2791,87,1017,180,197,5344,B,629,2791,485619,39620,407151,18824,625,4,264,3451,441885,441885,3715,441885,4,12
LA,79827,873599,0,1308,5109,379,759,142,197,46334,B,3423,5109,485619,39620,407151,38775,3315,108,1705,16726,953426,953426,18431,953426,7,0
MA,111827,854316,0,570,11611,89,759,46,197,94347,A+,8330,11611,1225332,39620,407151,105783,8115,215,230,8433,966143,966143,8663,966143,5,3
MD,73527,578430,0,386,11467,108,759,180,197,5230,A,3325,11467,818993,39620,407151,73527,3194,131,418,8148,651957,651957,8566,651957,6,47
ME,3558,120404,0,18,372,8,759,3,197,3008,A+,114,372,123563,4363,119029,3159,113,1,19,1629,123962,123962,1648,123962,0,1
MI,77198,1236229,0,543,5109,184,759,113,197,53867,A+,6321,5109,1332667,96438,1236229,69722,6075,246,422,16850,1313427,1313427,17272,1313427,7,0
MN,42772,726217,0,247,4424,114,1338,180,197,37199,A,1542,4424,768989,39620,407151,42772,1504,38,491,13446,768989,768989,13937,768989,2,25
MO,27890,467887,0,932,5109,379,759,89,197,0,B,1083,5109,621043,32874,587188,27890,1900,149,447,9822,495777,495777,10269,495777,14,0
MP,33,10734,0,961,4,379,759,180,197,19,D,2,4,11335,39620,407151,33,2,149,0,0,10767,10767,0,10767,0,0
MS,36680,306735,0,1020,3530,208,759,110,197,25932,A,1250,3530,343299,39620,407151,36564,1228,22,393,7811,343415,343415,8204,343415,1,35
MT,1843,116852,0,28,133,379,759,180,197,875,C,32,133,485619,39620,407151,1843,1900,149,85,3949,118695,118695,4034,118695,3,5
NC,87528,1132958,0,1040,5109,379,759,180,197,67124,A,1510,5109,485619,39620,407151,87528,1510,149,1827,19084,1220486,1220486,20911,1220486,7,0
ND,4442,119436,0,43,277,379,759,180,197,3653,D,78,277,233097,39620,407151,4442,74,4,108,1291,123878,123878,1399,123878,0,6
NE,21172,190487,0,98,1421,379,759,180,197,15860,B,285,1421,485619,39620,407151,21172,1900,149,174,3382,211659,211659,3556,211659,0,0
NH,6054,128812,0,22,589,379,191,180,197,5027,B,391,589,485619,39620,407151,6054,1900,149,30,1447,134866,134866,1477,134866,0,0
NJ,175522,1524863,0,892,20632,166,759,81,197,31261,A+,15560,20632,485619,39620,407151,175522,13613,1947,224,14557,1700385,1700385,14781,1700385,19,0
NM,15028,403329,0,170,2204,379,759,180,197,6322,B,545,2204,485619,39620,407151,15028,1900,149,255,7348,418357,418357,7603,418357,2,17
NV,28515,324678,0,953,5109,250,759,107,197,789,A+,593,5109,443136,39620,407151,28515,1900,149,832,4805,353193,353193,5637,353193,0,0
NY,402263,4322619,0,792,89995,175,759,103,197,71643,A,24989,89995,485619,39620,407151,402263,1900,149,557,51130,4724882,4724882,51687,4724882,10,0
OH,66853,957898,0,949,8915,293,2201,159,197,45194,B,3064,8915,485619,39620,407151,62913,2807,257,1261,17104,1024751,1024751,18365,1024751,6,73
OK,20745,400037,0,499,2063,186,759,180,197,15815,A+,424,2063,423285,22367,400037,20745,1900,149,510,0,420782,420782,510,420782,2,31
OR,12438,288274,0,246,1234,67,759,35,197,3094,A+,237,1234,485619,39620,288274,11795,1900,149,268,4272,300712,300712,4540,300712,3,54
PA,95742,835732,0,682,5109,379,759,96,197,73721,A+,6911,5109,485619,39620,407151,93015,1900,149,476,6714,931474,931474,7190,931474,7,0
PR,10010,255766,0,159,5109,15,759,8,197,0,B,167,5109,258001,3966,253922,2811,71,96,356,0,265776,265776,356,265776,0,0
RI,17487,155756,0,67,2066,3,759,4,197,1691,A+,984,2066,290756,25518,265238,17487,1900,149,175,6413,173243,173243,6588,173243,8,15
SC,58168,448933,0,1488,3398,379,759,180,197,20957,A,972,3398,506936,72738,434198,58003,961,11,1520,13073,507101,507101,14593,507101,11,0
SD,7524,83854,0,63,742,379,759,180,197,6543,B,109,742,485619,39620,407151,38775,1900,149,25,745,91378,91378,770,91378,0,4
TN,65274,988687,0,1120,3284,379,759,180,197,36996,A,749,3284,1053424,75920,977504,64737,722,27,3314,32632,1053961,1053961,35946,1053961,8,34
TX,264313,2275812,0,10405,5109,379,759,180,197,136419,B,3235,5109,2540125,39620,407151,264313,1900,149,5655,41716,2540125,2540125,47371,2540125,43,0
UT,30030,388305,0,252,1850,86,487,180,208,17728,A+,216,1850,485619,39620,407151,30030,1900,149,546,4731,418335,418335,5277,418335,1,26
VA,71642,742373,466,1129,10459,243,759,105,197,9330,A+,1968,10459,811187,39620,407151,68814,1861,107,972,8998,814481,814015,9970,814015,2,104
VI,206,4084,6,961,5109,379,759,180,197,96,C,6,5109,485619,39620,407151,38775,6,149,25,176,4296,4290,201,4290,0,0
VT,1301,75280,0,10,5109,379,759,180,197,1096,B,56,5109,485619,39620,407151,1301,56,149,5,725,76581,76581,730,76581,0,0
WA,40656,645349,0,331,4751,379,759,35,197,0,B,1438,4751,485619,39620,407151,40656,1438,149,1438,16101,686005,686005,17539,686005,14,89
WI,40382,659479,143,283,3850,85,800,180,197,28670,A+,827,3850,485619,39620,407151,36942,820,7,505,6127,700004,699861,6632,699861,0,26
WV,4259,203966,0,63,5109,22,759,8,197,2825,B,96,5109,485619,39620,407151,4143,1900,149,52,1137,208225,208225,1189,208225,0,0
WY,1862,38077,0,17,124,379,759,180,197,1372,B,21,124,54917,1592,53324,1506,1900,149,0,0,39939,39939,0,39939,0,0
AK,1479,143996,0,27,5109,379,759,0,197,615,A,17,5109,145475,39620,407151,1479,17,149,94,2005,145475,145475,2099,145475,0,0
AL,53587,457919,0,1163,6745,379,911,180,503,25783,B,1121,6745,485619,39620,407151,52908,1093,28,1640,7846,511506,511506,9486,511506,7,0
AR,28367,354035,0,412,1822,379,759,84,266,21591,A,321,1822,382402,39620,407151,28367,1900,149,1564,11189,382402,382402,12753,382402,8,42
AS,0,816,0,961,5109,379,759,180,197,0,C,0,5109,485619,39620,407151,0,1900,149,0,0,816,816,0,816,0,0
AZ,122467,573705,0,3432,5795,922,759,631,197,14829,A+,2237,5795,695463,39620,407151,121758,2114,123,2537,9645,696172,696172,12182,696172,86,45
CA,320804,5085795,0,7854,5109,2020,759,180,197,0,B,7017,5109,5406599,39620,407151,320804,1900,149,8460,122444,5406599,5406599,130904,5406599,72,0
CO,36591,355512,0,324,5885,379,759,180,197,4749,A,1586,5885,485619,39620,407151,33587,1900,149,400,5842,392103,392103,6242,392103,0,21
CT,47287,542107,0,77,10552,379,759,180,197,8351,B,4348,10552,587331,39620,407151,45224,3476,871,0,31006,589394,589394,31006,589394,0,0
DC,10847,116036,0,95,5109,30,759,17,197,1737,A+,568,5109,485619,39620,407151,38775,1900,149,46,2787,126883,126883,2833,126883,0,0
DE,12804,124605,0,58,5109,10,759,180,197,7120,A+,517,5109,485619,39620,407151,11823,459,58,61,3233,137409,137409,3294,137409,0,0
FL,269811,2304196,2096,7542,18590,379,759,180,197,0,A,4346,18590,3165354,337795,2819784,269811,4346,149,15300,83408,2576103,2574007,98708,2574007,45,249
GA,116926,966490,0,2512,13259,379,2621,180,197,0,A,3001,13259,1083416,106089,977327,116926,1900,149,2525,16018,1083416,1083416,18543,1083416,5,54
GU,312,16667,0,3,5109,379,759,180,197,202,B,5,5109,16858,39620,407151,304,1900,149,0,0,16979,16979,0,16979,0,0
HI,1200,92720,0,961,125,379,759,180,197,872,D,19,125,111318,39620,407151,38775,1900,149,42,1644,93920,93920,1686,93920,0,0
IA,35071,339342,0,177,5109,54,759,26,197,26234,A+,750,5109,485619,39620,407151,35071,1900,149,424,5628,374413,374413,6052,374413,2,0
ID,10505,114756,0,140,468,33,139,180,197,3114,A,102,468,124531,39620,407151,9775,82,20,577,2335,125261,125261,2912,125261,1,19
IL,155048,1829066,0,1342,5109,311,759,127,197,0,A,7388,5109,1982982,39620,407151,153916,7187,201,954,37940,1984114,1984114,38894,1984114,19,0
IN,51612,513035,0,702,7527,237,1592,68,197,38623,A+,2760,7527,485619,39620,407151,38775,2567,193,533,5968,564647,564647,6501,564647,4,69
KS,18611,199168,0,961,1304,379,405,180,160,905,A,284,1304,485619,39620,407151,38775,1900,149,0,0,217779,217779,0,217779,0,0
KY,19389,418781,0,370,2779,75,1014,180,197,5322,B,625,2779,485619,39620,407151,18562,621,4,268,0,438170,438170,268,438170,3,0
LA,78122,856873,0,1243,5109,379,759,134,197,46334,B,3416,5109,485619,39620,407151,38775,3308,108,1319,9229,934995,934995,10548,934995,13,0
MA,111597,845883,0,583,11608,93,759,43,197,94347,A+,8325,11608,1213914,39620,407151,105629,8110,215,199,10947,957480,957480,11146,957480,15,8
MD,73109,570282,0,392,11420,114,759,180,197,5230,A,3319,11420,807926,39620,407151,73109,3188,131,642,13472,643391,643391,14114,643391,9,67
ME,3539,118775,0,19,371,9,759,3,197,2994,A+,114,371,121918,4344,117405,3143,113,1,19,2405,122314,122314,2424,122314,2,3
MI,76776,1219379,0,505,5109,174,759,99,197,53867,A+,6314,5109,1315305,95926,1219379,69338,6068,246,406,21627,1296155,1296155,22033,1296155,1,0
MN,42281,712771,0,251,4399,123,1335,180,197,36582,A,1540,4399,755052,39620,407151,42281,1502,38,710,12247,755052,755052,12957,755052,3,33
MO,27443,458065,0,883,5109,379,759,80,197,0,B,1069,5109,605046,32546,571520,27443,1900,149,310,10648,485508,485508,10958,485508,0,0
MP,33,10734,0,961,4,379,759,180,197,19,D,2,4,11335,39620,407151,33,2,149,2,0,10767,10767,2,10767,0,0
MS,36287,298924,0,963,3495,202,759,107,197,22167,A,1249,3495,334029,39620,407151,35961,1227,22,868,0,335211,335211,868,335211,19,0
MT,1758,112903,0,26,128,379,759,180,197,865,C,29,128,485619,39620,407151,1758,1900,149,81,1221,114661,114661,1302,114661,0,1
NC,85701,1113874,0,1070,5109,379,759,180,197,55318,A,1503,5109,485619,39620,407151,85701,1503,149,1908,21609,1199575,1199575,23517,1199575,4,0
ND,4334,118145,0,38,271,379,759,180,197,3570,D,78,271,225535,39620,407151,4334,74,4,91,1537,122479,122479,1628,122479,0,8
NE,20998,187105,0,95,1421,379,759,180,197,15724,B,285,1421,485619,39620,407151,20998,1900,149,221,4028,208103,208103,4249,208103,-1,2
NH,6024,127365,0,22,589,379,191,180,197,5013,B,391,589,485619,39620,407151,6024,1900,149,33,1054,133389,133389,1087,133389,1,4
NJ,175298,1510306,0,890,20632,163,759,86,197,31190,A+,15541,20632,485619,39620,407151,175298,13594,1947,339,23981,1685604,1685604,24320,1685604,16,0
NM,14773,395981,0,158,2187,379,759,180,197,6271,B,543,2187,485619,39620,407151,14773,1900,149,224,6949,410754,410754,7173,410754,4,26
NV,27683,319873,0,895,5109,239,759,114,197,764,A+,593,5109,434401,39620,407151,27683,1900,149,845,5478,347556,347556,6323,347556,1,0
NY,401706,4271489,0,801,89995,174,759,102,197,71565,A,24979,89995,485619,39620,407151,401706,1900,149,677,61741,4673195,4673195,62418,4673195,5,0
OH,65592,940794,0,954,8842,289,2185,154,197,44663,B,3058,8842,485619,39620,407151,61669,2801,257,1378,21973,1006386,1006386,23351,1006386,22,72
OK,20235,400037,0,499,2032,186,759,180,197,15485,A+,422,2032,423285,22367,400037,20235,1900,149,456,0,420272,420272,456,420272,1,40
OR,12170,284002,0,208,1180,56,759,30,197,3009,A+,234,1180,485619,39620,284002,10881,1900,149,319,3670,296172,296172,3989,296172,2,0
PA,95266,829018,0,652,5109,379,759,96,197,73354,A+,6904,5109,485619,39620,407151,92552,1900,149,577,11384,924284,924284,11961,924284,7,0
PR,9654,255766,0,174,5109,12,759,11,197,0,B,167,5109,258001,3966,253922,2583,71,96,288,0,265420,265420,288,265420,0,0
RI,17312,149343,0,61,2051,4,759,5,197,1685,A+,976,2051,278357,24885,253472,17312,1900,149,0,0,166655,166655,0,166655,0,0
SC,56648,435860,0,1472,3398,379,759,180,197,20957,A,961,3398,492345,69920,422425,56485,950,11,1949,2469,492508,492508,4418,492508,10,0
SD,7499,83109,0,53,738,379,759,180,197,6522,B,109,738,485619,39620,407151,38775,1900,149,45,957,90608,90608,1002,90608,0,0
TN,61960,956055,0,1184,3250,379,759,180,197,35855,A,741,3250,1017498,71982,945516,61443,714,27,954,9947,1018015,1018015,10901,1018015,3,57
TX,258658,2234096,0,10410,5109,379,759,180,197,132638,B,3192,5109,2492754,39620,407151,258658,1900,149,8196,54934,2492754,2492754,63130,2492754,80,0
UT,29484,383574,0,276,1824,84,486,180,207,17303,A+,215,1824,485619,39620,407151,29484,1900,149,629,7077,413058,413058,7706,413058,3,27
VA,70670,733375,389,1045,10355,228,759,101,197,9310,A+,1966,10355,801205,39620,407151,67830,1859,107,888,16822,804434,804045,17710,804045,4,64
VI,181,3908,6,961,5109,379,759,180,197,93,C,6,5109,485619,39620,407151,38775,6,149,14,268,4095,4089,282,4089,0,0
VT,1296,74555,0,17,5109,379,759,180,197,1089,B,56,5109,485619,39620,407151,1296,56,149,13,806,75851,75851,819,75851,0,0
WA,39218,629248,0,326,4662,379,759,57,197,0,B,1424,4662,485619,39620,407151,39218,1424,149,0,0,668466,668466,0,668466,0,0
WI,39877,653352,148,264,3824,74,800,180,197,28318,A+,827,3824,485619,39620,407151,36448,820,7,797,6848,693377,693229,7645,693229,-1,27
WV,4207,202829,0,56,5109,14,759,7,197,2806,B,96,5109,485619,39620,407151,4091,1900,149,133,3080,207036,207036,3213,207036,1,0
WY,1862,38077,0,12,124,379,759,180,197,1372,B,21,124,54917,1592,53324,1506,1900,149,23,0,39939,39939,23,39939,0,1
AK,1385,141991,0,31,5109,379,759,1,197,598,A,17,5109,143376,39620,407151,1385,17,149,62,1383,143376,143376,1445,143376,0,0
AL,51947,450073,0,1093,6745,379,904,180,496,25783,B,1114,6745,485619,39620,407151,51294,1086,28,1439,8365,502020,502020,9804,502020,10,3656
AR,26803,342846,0,402,1780,379,759,84,265,20642,A,313,1780,369649,39620,407151,26803,1900,149,0,4237,369649,369649,4237,369649,0,37
AS,0,816,0,961,5109,379,759,180,197,0,C,0,5109,485619,39620,407151,0,1900,149,0,0,816,816,0,816,0,0
AZ,119930,564060,0,3485,5750,899,759,620,197,14394,A+,2151,5750,683293,39620,407151,119233,2030,121,3038,11741,683990,683990,14779,683990,69,91
CA,312344,4963351,0,7904,5109,2021,759,180,197,0,B,6945,5109,5275695,39620,407151,312344,1900,149,8047,91911,5275695,5275695,99958,5275695,94,0
CO,36191,349670,0,328,5864,379,759,180,197,4728,A,1586,5864,485619,39620,407151,33189,1900,149,666,8055,385861,385861,8721,385861,5,33
CT,47287,511101,0,77,10552,379,759,180,197,8351,B,4348,10552,556230,39620,407151,45129,3476,871,0,-73,558388,558388,-73,558388,0,0
DC,10801,113249,0,92,5109,29,759,17,197,1717,A+,568,5109,485619,39620,407151,38775,1900,149,58,3108,124050,124050,3166,124050,0,0
DE,12743,121372,0,65,5109,13,759,180,197,7002,A+,517,5109,485619,39620,407151,11699,460,57,91,1316,134115,134115,1407,134115,0,0
FL,254511,2220788,2040,7186,18341,379,759,180,197,0,A,4301,18341,3029149,318664,2703554,254511,4301,149,10360,43312,2477339,2475299,53672,2475299,98,425
GA,114401,950472,0,2446,13205,379,2610,180,197,0,A,2996,13205,1064873,103672,961201,114401,1900,149,3190,15335,1064873,1064873,18525,1064873,31,268
GU,312,16667,0,3,5109,379,759,180,197,202,B,5,5109,16858,39620,407151,304,1900,149,2,111,16979,16979,113,16979,0,0
HI,1158,91076,0,961,125,379,759,180,197,847,D,19,125,109096,39620,407151,38775,1900,149,28,1611,92234,92234,1639,92234,0,2
IA,34647,333714,0,178,5109,56,759,25,197,26104,A+,748,5109,485619,39620,407151,34647,1900,149,663,5450,368361,368361,6113,368361,5,0
ID,9928,112421,0,122,449,33,138,180,197,3066,A,101,449,121640,39620,407151,9219,81,20,500,3771,122349,122349,4271,122349,1,17
IL,154094,1791126,0,1398,5109,321,759,139,197,0,A,7369,5109,1944088,39620,407151,152962,7168,201,1195,31150,1945220,1945220,32345,1945220,24,0
IN,51079,507067,0,714,7458,237,1577,72,197,38441,A+,2756,7458,485619,39620,407151,38775,2563,193,779,6805,558146,558146,7584,558146,8,0
KS,18611,199168,0,961,1304,379,405,180,160,905,A,284,1304,485619,39620,407151,38775,1900,149,0,0,217779,217779,0,217779,0,0
KY,19121,418781,0,370,2779,75,1014,180,197,5322,B,622,2779,485619,39620,407151,18307,618,4,451,4761,437902,437902,5212,437902,2,16
LA,76803,847644,0,1182,5109,379,759,121,197,46334,B,3403,5109,485619,39620,407151,38775,3295,108,2167,17032,924447,924447,19199,924447,23,0
MA,111398,834936,0,572,11600,87,759,44,197,94347,A+,8310,11600,1199411,39620,407151,105457,8095,215,288,7430,946334,946334,7718,946334,14,18
MD,72467,556810,0,390,11353,120,759,180,197,5190,A,3310,11353,786786,39620,407151,72467,3179,131,557,7657,629277,629277,8214,629277,7,53
ME,3520,116370,0,16,368,7,759,4,197,2972,A+,112,368,119501,4322,115011,3131,111,1,21,1463,119890,119890,1484,119890,1,2
MI,76370,1197752,0,505,5109,174,759,99,197,53867,A+,6313,5109,1292951,95199,1197752,68948,6067,246,685,26632,1274122,1274122,27317,1274122,28,0
MN,41571,700524,0,241,4366,121,1325,180,197,36012,A,1537,4366,742095,39620,407151,41571,1499,38,804,15466,742095,742095,16270,742095,4,37
MO,27133,447417,0,883,5109,379,759,72,197,0,B,1069,5109,590426,32518,556928,27133,1900,149,1134,18591,474550,474550,19725,474550,18,0
MP,31,10734,0,961,4,379,759,180,197,19,D,2,4,11335,39620,407151,31,2,149,0,0,10765,10765,0,10765,0,0
MS,35419,298924,0,963,3495,202,759,107,197,22167,A,1230,3495,334029,39620,407151,35105,1208,22,797,3234,334343,334343,4031,334343,15,40
MT,1677,111682,0,24,127,379,759,180,197,864,C,29,127,485619,39620,407151,1677,1900,149,84,1097,113359,113359,1181,113359,1,4
NC,83793,1092265,0,1093,5109,379,759,180,197,55318,A,1499,5109,485619,39620,407151,83793,1499,149,2462,22984,1176058,1176058,25446,1176058,20,0
ND,4243,116608,0,31,263,379,759,180,197,3533,D,78,263,224050,39620,407151,4243,74,4,89,1166,120851,120851,1255,120851,0,3
NE,20777,183077,0,95,1419,379,759,180,197,15499,B,286,1419,485619,39620,407151,20777,1900,149,154,2686,203854,203854,2840,203854,2,0
NH,5991,126311,0,20,585,379,190,180,197,4897,B,390,585,485619,39620,407151,5991,1900,149,18,1233,132302,132302,1251,132302,3,4
NJ,174959,1486325,0,872,20632,166,759,87,197,31092,A+,15525,20632,485619,39620,407151,174959,13578,1947,331,37795,1661284,1661284,38126,1661284,46,65
NM,14549,389032,0,151,2161,379,759,180,197,6181,B,539,2161,485619,39620,407151,14549,1900,149,298,7402,403581,403581,7700,403581,6,24
NV,26838,314395,0,918,5109,241,759,122,197,764,A+,592,5109,425027,39620,407151,26838,1900,149,930,4812,341233,341233,5742,341233,13,0
NY,401029,4209748,0,799,89995,177,759,100,197,71477,A,24974,89995,485619,39620,407151,401029,1900,149,730,68473,4610777,4610777,69203,4610777,6,0
OH,64214,918821,0,928,8770,299,2169,155,197,44101,B,3036,8770,485619,39620,407151,60328,2780,256,1358,22124,983035,983035,23482,983035,4,69
OK,19779,400037,0,499,1992,186,759,180,197,15136,A+,421,1992,423285,22367,400037,19779,1900,149,687,8055,419816,419816,8742,419816,5,43
OR,11851,280332,0,208,1180,56,759,30,197,3009,A+,232,1180,485619,39620,280332,10881,1900,149,397,5016,292183,292183,5413,292183,0,0
PA,94689,817634,0,646,5109,379,759,97,197,72910,A+,6897,5109,485619,39620,407151,92001,1900,149,813,12870,912323,912323,13683,912323,17,0
PR,9366,255766,0,174,5109,12,759,7,197,0,B,167,5109,258001,3966,253922,2435,71,96,229,0,265132,265132,229,265132,8,0
RI,17312,149343,0,61,2051,4,759,5,197,1685,A+,976,2051,278357,24885,253472,17312,1900,149,0,0,166655,166655,0,166655,0,0
SC,54699,433391,0,1396,3398,379,759,180,197,20956,A,951,3398,487929,68604,419325,54538,940,11,2280,10575,488090,488090,12855,488090,22,0
SD,7454,82152,0,65,738,379,759,180,197,6470,B,109,738,485619,39620,407151,38775,1900,149,53,1011,89606,89606,1064,89606,2,12
TN,61006,946108,0,1184,3193,379,759,180,197,35435,A,738,3193,1006616,70927,935689,60508,711,27,1460,11079,1007114,1007114,12539,1007114,15,47
TX,250462,2179162,0,10083,5109,379,759,180,197,127880,B,3112,5109,2429624,39620,407151,250462,1900,149,10351,29484,2429624,2429624,39835,2429624,99,0
UT,28855,376497,0,269,1797,84,483,180,207,16897,A+,212,1797,485619,39620,407151,28855,1900,149,632,8746,405352,405352,9378,405352,5,49
VA,69782,716553,365,1020,10291,230,759,97,197,9271,A+,1962,10291,783516,39620,407151,66963,1857,105,851,16759,786700,786335,17610,786335,4,96
VI,167,3640,58,961,5109,379,759,180,197,92,C,6,5109,485619,39620,407151,38775,6,149,14,167,3865,3807,181,3807,0,0
VT,1283,73749,0,18,5109,379,759,180,197,1066,B,56,5109,485619,39620,407151,1283,56,149,6,928,75032,75032,934,75032,0,0
WA,39218,629248,0,326,4662,379,759,57,197,0,B,1424,4662,485619,39620,407151,39218,1424,149,637,7499,668466,668466,8136,668466,15,-3
WI,39080,646504,155,265,3797,75,797,180,197,27909,A+,828,3797,485619,39620,407151,35679,821,7,981,11093,685739,685584,12074,685584,7,31
WV,4074,199749,0,56,5109,14,759,7,197,2763,B,95,5109,485619,39620,407151,3963,1900,149,91,2529,203823,203823,2620,203823,0,0
WY,1839,38077,0,12,123,379,759,180,197,1361,B,21,123,54917,1592,53324,1488,1900,149,49,0,39916,39916,49,39916,0,2
AK,1323,140608,0,30,5109,379,759,0,197,588,A,17,5109,141931,39620,407151,1323,17,149,51,6136,141931,141931,6187,141931,0,0
AL,50508,441708,0,1201,3089,379,888,180,493,25783,B,1104,3089,485619,39620,407151,49892,1077,27,1334,20378,492216,492216,21712,492216,36,50
AR,26803,338609,0,402,1743,379,759,84,260,20642,A,313,1743,364661,39620,407151,26803,1900,149,751,0,365412,365412,751,365412,4,38
AS,0,816,0,961,5109,379,759,180,197,0,C,0,5109,485619,39620,407151,0,1900,149,0,0,816,816,0,816,0,0
AZ,116892,552319,0,3432,5659,876,759,615,197,13853,A+,2082,5659,668528,39620,407151,116209,1961,121,4221,11929,669211,669211,16150,669211,44,133
CA,304297,4871440,0,7896,5109,2005,759,180,197,0,B,6851,5109,5175737,39620,407151,304297,1900,149,7798,89505,5175737,5175737,97303,5175737,140,0
CO,35525,341615,0,318,5831,379,759,180,197,4691,A,1581,5831,485619,39620,407151,32546,1900,149,409,6029,377140,377140,6438,377140,37,11
CT,47287,511174,0,77,10552,379,759,180,197,8351,B,4348,10552,556230,39620,407151,45056,3476,871,78,-59,558461,558461,19,558461,0,0
DC,10743,110141,0,96,5109,26,759,18,197,1703,A+,568,5109,485619,39620,407151,38775,1900,149,64,4897,120884,120884,4961,120884,0,0
DE,12652,120056,0,58,5109,11,759,180,197,6949,A+,517,5109,485619,39620,407151,11608,460,57,121,2382,132708,132708,2503,132708,0,0
FL,244151,2177476,1911,6974,17916,379,759,180,197,0,A,4203,17916,2945253,305374,2633526,244151,4203,149,11433,52796,2423538,2421627,64229,2421627,92,437
GA,111211,935137,0,2443,12937,379,2565,180,197,0,A,2965,12937,1046348,101057,945291,111211,1900,149,4484,22442,1046348,1046348,26926,1046348,35,331
GU,310,16556,0,3,5109,379,759,180,197,202,B,5,5109,16858,39620,407151,302,1900,149,1,333,16866,16866,334,16866,0,0
HI,1130,89465,0,961,123,379,759,180,197,840,D,19,123,107009,39620,407151,38775,1900,149,36,1407,90595,90595,1443,90595,0,1
IA,33984,328264,0,169,5109,54,759,26,197,25891,A+,743,5109,485619,39620,407151,33984,1900,149,744,6845,362248,362248,7589,362248,4,0
ID,9428,108650,0,124,432,29,137,180,197,3022,A,100,432,117390,39620,407151,8740,80,20,459,2999,118078,118078,3458,118078,2,21
IL,152899,1759976,0,1436,5109,306,759,155,197,0,A,7345,5109,1911743,39620,407151,151767,7144,201,1327,31670,1912875,1912875,32997,1912875,16,0
IN,50300,500262,0,667,7458,217,1577,87,197,38120,A+,2748,7458,485619,39620,407151,38775,2555,193,725,7545,550562,550562,8270,550562,9,72
KS,18611,199168,0,961,1304,379,405,180,160,905,A,284,1304,485619,39620,407151,38775,1900,149,993,8304,217779,217779,9297,217779,2,35
KY,18670,414020,0,409,2763,70,1012,180,197,5258,B,620,2763,485619,39620,407151,17890,616,4,425,8252,432690,432690,8677,432690,8,16
LA,74636,830612,0,1117,5109,379,759,122,197,46334,B,3380,5109,485619,39620,407151,38775,3272,108,2642,22466,905248,905248,25108,905248,25,0
MA,111110,827506,0,632,11582,98,759,47,197,94347,A+,8296,11582,1187832,39620,407151,105290,8081,215,213,12642,938616,938616,12855,938616,28,23
MD,71910,549153,0,385,11300,122,759,180,197,5157,A,3303,11300,774693,39620,407151,71910,3172,131,463,8019,621063,621063,8482,621063,15,79
ME,3499,114907,0,15,366,7,759,4,197,2931,A+,111,366,118017,4287,113562,3110,110,1,13,2635,118406,118406,2648,118406,0,1
MI,75685,1171120,0,505,5109,174,759,92,197,52841,A+,6285,5109,1265344,94224,1171120,68295,6039,246,622,22630,1246805,1246805,23252,1246805,14,0
MN,40767,685058,0,227,4329,124,1320,180,197,35442,A,1533,4329,725825,39620,407151,40767,1495,38,604,19781,725825,725825,20385,725825,5,24
MO,25999,428826,0,886,5109,379,759,79,197,0,B,1051,5109,576537,31075,544522,25999,1900,149,0,0,454825,454825,0,454825,0,0
MP,31,10734,0,961,4,379,759,180,197,19,D,2,4,11335,39620,407151,31,2,149,0,0,10765,10765,0,10765,0,0
MS,34622,295690,0,981,3455,205,759,103,197,22167,A,1215,3455,330011,39620,407151,34321,1195,20,1031,4477,330312,330312,5508,330312,11,41
MT,1593,110585,0,21,123,379,759,180,197,855,C,28,123,485619,39620,407151,1593,1900,149,127,3286,112178,112178,3413,112178,3,3
NC,81331,1069281,0,1046,5109,379,759,180,197,55318,A,1479,5109,485619,39620,407151,81331,1479,149,1982,26819,1150612,1150612,28801,1150612,18,0
ND,4154,115442,0,33,260,379,759,180,197,3496,D,78,260,219737,39620,407151,4154,74,4,84,1663,119596,119596,1747,119596,0,3
NE,20623,180391,0,100,1419,379,759,180,197,15206,B,284,1419,485619,39620,407151,20623,1900,149,198,2981,201014,201014,3179,201014,2,14
NH,5973,125078,0,24,581,379,189,180,197,4831,B,387,581,485619,39620,407151,5973,1900,149,21,1402,131051,131051,1423,131051,1,3
NJ,174628,1448530,0,904,20567,162,759,94,197,31014,A+,15479,20567,485619,39620,407151,174628,13532,1947,388,23353,1623158,1623158,23741,1623158,31,62
NM,14251,381630,0,154,2137,379,759,180,197,6118,B,533,2137,485619,39620,407151,14251,1900,149,234,5960,395881,395881,6194,395881,6,36
NV,25908,309583,0,924,5109,248,759,111,197,764,A+,579,5109,416707,39620,407151,25908,1900,149,1004,4709,335491,335491,5713,335491,8,0
NY,400299,4141275,0,826,89995,178,759,92,197,71371,A,24968,89995,485619,39620,407151,400299,1900,149,786,72772,4541574,4541574,73558,4541574,9,0
OH,62856,896697,0,928,8701,289,2161,151,197,43435,B,3032,8701,485619,39620,407151,59000,2776,256,1525,41626,959553,959553,43151,959553,26,131
OK,19092,391982,0,487,1949,217,759,180,197,14648,A+,416,1949,414197,21345,391982,19092,1900,149,596,8724,411074,411074,9320,411074,6,56
OR,11454,275316,0,208,1180,56,759,30,197,3009,A+,232,1180,485619,39620,275316,10881,1900,149,266,4429,286770,286770,4695,286770,2,18
PA,93876,804764,0,653,5109,379,759,103,197,72284,A+,6880,5109,485619,39620,407151,91206,1900,149,1009,17608,898640,898640,18617,898640,32,0
PR,9137,255766,0,140,5109,12,759,10,197,0,B,159,5109,258001,3966,253922,2351,64,95,275,0,264903,264903,275,264903,0,0
RI,17312,149343,0,61,2051,4,759,5,197,1685,A+,976,2051,278357,24885,253472,17312,1900,149,69,1449,166655,166655,1518,166655,2,8
SC,52419,422816,0,1438,3398,379,759,180,197,20956,A,929,3398,475089,65868,409221,52273,922,7,1728,9742,475235,475235,11470,475235,24,308
SD,7401,81141,0,65,726,379,759,180,197,6408,B,107,726,485619,39620,407151,38775,1900,149,65,1167,88542,88542,1232,88542,6,8
TN,59546,935029,0,1184,3146,379,759,180,197,34740,A,723,3146,994114,69283,924831,59085,697,26,1955,19906,994575,994575,21861,994575,13,58
TX,240111,2149678,0,10002,5109,379,759,180,197,122996,B,3013,5109,2389789,39620,407151,240111,1900,149,9765,66812,2389789,2389789,76577,2389789,95,0
UT,28223,367751,0,229,1748,79,477,180,205,16261,A+,207,1748,485619,39620,407151,28223,1900,149,867,6374,395974,395974,7241,395974,2,48
VA,68931,699794,378,1006,10195,234,759,102,197,9189,A+,1958,10195,765889,39620,407151,66095,1853,105,943,14354,769103,768725,15297,768725,21,174
VI,153,3473,53,961,5109,379,759,180,197,87,C,6,5109,485619,39620,407151,38775,6,149,9,103,3679,3626,112,3626,0,0
VT,1277,72821,0,11,5109,379,759,180,197,1066,B,56,5109,485619,39620,407151,1277,56,149,5,1344,74098,74098,1349,74098,0,0
WA,38581,621749,0,326,4665,379,759,60,197,0,B,1409,4665,485619,39620,407151,38581,1409,149,640,14618,660330,660330,15258,660330,15,35
WI,38099,635411,151,274,3766,77,792,180,197,27329,A+,821,3766,485619,39620,407151,34753,814,7,889,11857,673661,673510,12746,673510,5,40
WV,3983,197220,0,56,5109,16,759,7,197,2756,B,95,5109,485619,39620,407151,3872,1900,149,157,3857,201203,201203,4014,201203,0,0
WY,1790,38077,0,12,121,379,759,180,197,1327,B,21,121,54917,1592,53324,1445,1900,149,16,806,39867,39867,822,39867,0,0
AK,1272,134472,0,28,5109,379,759,0,197,571,A,17,5109,135744,39620,407151,1272,17,149,46,2297,135744,135744,2343,135744,0,0
AL,49174,421330,0,1135,3039,379,877,180,490,25783,B,1068,3039,485619,39620,407151,48588,1042,26,2212,0,470504,470504,2212,470504,10,33
AR,26052,338609,0,394,1705,379,759,82,284,19992,A,309,1705,364661,39620,407151,26052,1900,149,1540,9849,364661,364661,11389,364661,8,50
AS,0,816,0,961,5109,379,759,180,197,0,C,0,5109,485619,39620,407151,0,1900,149,0,0,816,816,0,816,0,0
AZ,112671,540390,0,3437,5526,861,759,575,197,13341,A+,2038,5526,652418,39620,407151,112028,1917,121,4057,7934,653061,653061,11991,653061,75,139
CA,296499,4781935,0,7821,5109,1957,759,180,197,0,B,6711,5109,5078434,39620,407151,296499,1900,149,7031,75228,5078434,5078434,82259,5078434,149,0
CO,35116,335586,0,335,5820,379,759,180,197,4669,A,1544,5820,485619,39620,407151,32138,1900,149,452,5177,370702,370702,5629,370702,2,79
CT,47209,511233,0,90,10552,379,759,180,197,8351,B,4348,10552,556230,39620,407151,44997,3476,872,101,12338,558442,558442,12439,558442,5,141
DC,10679,105244,0,92,5109,26,759,14,197,1662,A+,568,5109,485619,39620,407151,38775,1900,149,37,1597,115923,115923,1634,115923,4,0
DE,12531,117674,0,63,5109,12,759,180,197,6901,A+,517,5109,485619,39620,407151,11487,460,57,69,1102,130205,130205,1171,130205,2,0
FL,232718,2124680,1896,961,17479,379,759,180,197,0,A,4111,17479,2855852,291210,2558651,232718,4111,149,8935,28256,2359294,2357398,37191,2357398,120,411
GA,106727,912695,0,2322,12606,379,2519,180,197,0,A,2930,12606,1019422,97500,921922,106727,1900,149,2837,16176,1019422,1019422,19013,1019422,8,106
GU,309,16223,0,3,5109,379,759,180,197,202,B,5,5109,16526,39620,407151,301,1900,149,2,390,16532,16532,392,16532,0,0
HI,1094,88058,0,961,122,379,759,180,197,811,D,19,122,105290,39620,407151,38775,1900,149,23,2033,89152,89152,2056,89152,0,3
IA,33240,321419,0,168,5109,49,759,22,197,26340,A+,739,5109,485619,39620,407151,33240,1900,149,731,7577,354659,354659,8308,354659,4,0
ID,8969,105651,0,120,411,28,133,180,197,2978,A,98,411,113958,39620,407151,8307,78,20,430,2859,114620,114620,3289,114620,4,15
IL,151572,1728306,0,1507,5109,317,759,153,197,0,A,7329,5109,1878756,39620,407151,150450,7119,210,1018,35162,1879878,1879878,36180,1879878,20,0
IN,49575,492717,0,686,7386,226,1556,89,197,37795,A+,2739,7386,485619,39620,407151,38775,2546,193,512,5923,542292,542292,6435,542292,7,21
KS,17618,190864,0,961,1269,379,397,180,160,879,A,282,1269,485619,39620,407151,38775,1900,149,0,0,208482,208482,0,208482,0,0
KY,18245,405768,0,457,2747,105,1007,180,197,4939,B,612,2747,485619,39620,407151,17491,608,4,326,7766,424013,424013,8092,424013,4,10
LA,71994,808146,0,1042,5109,379,759,110,197,46334,B,3355,5109,485619,39620,407151,38775,3247,108,1843,12560,880140,880140,14403,880140,16,0
MA,110897,814864,0,635,11559,103,759,42,197,94347,A+,8268,11559,1171180,39620,407151,105138,8053,215,295,9471,925761,925761,9766,925761,25,42
MD,71447,541134,0,406,11221,139,759,180,197,5132,A,3288,11221,761395,39620,407151,71447,3160,128,586,8887,612581,612581,9473,612581,13,37
ME,3486,112272,0,16,365,7,759,4,197,2901,A+,111,365,115364,4263,110933,3092,110,1,26,2794,115758,115758,2820,115758,1,2
MI,75063,1148490,0,505,5109,174,759,93,197,52841,A+,6271,5109,1241962,93472,1148490,67683,6024,247,512,23038,1223553,1223553,23550,1223553,9,0
MN,40163,665277,0,251,4305,116,1312,180,197,35193,A,1528,4305,705440,39620,407151,40163,1490,38,574,11896,705440,705440,12470,705440,5,33
MO,25999,428826,0,811,5109,379,759,75,197,0,B,1051,5109,563325,30270,532133,25999,1900,149,795,11690,454825,454825,12485,454825,5,0
MP,31,10734,0,961,4,379,759,180,197,19,D,2,4,11335,39620,407151,31,2,149,0,0,10765,10765,0,10765,0,4
MS,33591,291213,0,941,3414,187,759,104,197,22167,A,1204,3414,324522,39620,407151,33309,1184,20,703,7782,324804,324804,8485,324804,16,49
MT,1466,107299,0,24,120,379,759,180,197,796,C,25,120,485619,39620,407151,1466,1900,149,95,2249,108765,108765,2344,108765,2,3
NC,79349,1042462,0,1034,5109,379,759,180,197,55318,A,1461,5109,485619,39620,407151,79349,1461,149,2039,23090,1121811,1121811,25129,1121811,20,0
ND,4070,113779,0,30,257,379,759,180,197,3464,D,78,257,214167,39620,407151,4070,74,4,99,1911,117849,117849,2010,117849,0,5
NE,20425,177410,0,97,1405,379,759,180,197,15031,B,282,1405,485619,39620,407151,20425,1900,149,224,2563,197835,197835,2787,197835,0,7
NH,5952,123676,0,22,578,379,164,180,197,4817,B,386,578,485619,39620,407151,5952,1900,149,20,1097,129628,129628,1117,129628,2,1
NJ,174240,1425177,0,963,20505,170,759,104,197,30938,A+,15448,20505,485619,39620,407151,174240,13501,1947,201,21368,1599417,1599417,21569,1599417,25,79
NM,14017,375670,0,154,2101,379,759,180,197,6051,B,527,2101,485619,39620,407151,14017,1900,149,290,4155,389687,389687,4445,389687,8,45
NV,24904,304874,0,935,5109,237,759,112,197,759,A+,571,5109,408611,39620,407151,24904,1900,149,603,5522,329778,329778,6125,329778,18,0
NY,399513,4068503,0,851,89995,173,759,98,197,71279,A,24959,89995,485619,39620,407151,399513,1900,149,584,64980,4468016,4468016,65564,4468016,15,0
OH,61331,855071,0,890,8570,289,2146,155,197,42111,B,3006,8570,485619,39620,407151,57506,2749,257,1150,0,916402,916402,1150,916402,15,81
OK,18496,383258,0,453,1893,215,759,180,197,14100,A+,410,1893,404600,20489,383258,18496,1900,149,603,6328,401754,401754,6931,401754,3,89
OR,11188,270887,0,192,1162,59,759,25,197,2977,A+,230,1162,485619,39620,270887,10632,1900,149,371,5437,282075,282075,5808,282075,6,7
PA,92867,787156,0,650,5109,379,759,102,197,71507,A+,6848,5109,485619,39620,407151,90202,1900,149,719,12778,880023,880023,13497,880023,36,0
PR,8862,255766,0,147,5109,11,759,7,197,0,B,159,5109,258001,3966,253922,2235,64,95,117,63080,264628,264628,63197,264628,0,0
RI,17243,147894,0,55,2043,4,759,3,197,1684,A+,974,2043,274980,24790,250190,17243,1900,149,39,1828,165137,165137,1867,165137,3,0
SC,50691,413074,0,1433,3090,379,759,180,197,19181,A,905,3090,463622,63683,399939,50548,898,7,1782,8143,463765,463765,9925,463765,21,0
SD,7336,79974,0,61,718,379,759,180,197,6331,B,101,718,485619,39620,407151,38775,1900,149,94,990,87310,87310,1084,87310,3,9
TN,57591,915123,0,1135,3088,379,759,180,197,33609,A,710,3088,972276,67068,905208,57153,684,26,1605,20150,972714,972714,21755,972714,25,65
TX,230346,2082866,0,9689,5109,379,759,180,197,118326,B,2918,5109,2313212,39620,407151,230346,1900,149,9782,44722,2313212,2313212,54504,2313212,105,0
UT,27356,361377,0,207,1700,74,472,180,204,15661,A+,205,1700,485619,39620,407151,27356,1900,149,601,2372,388733,388733,2973,388733,4,22
VA,67988,685440,370,956,10021,215,759,93,197,9065,A+,1937,10021,750631,39620,407151,65191,1832,105,613,14816,753798,753428,15429,753428,32,39
VI,144,3370,96,961,5109,379,759,180,197,81,C,6,5109,485619,39620,407151,38775,6,149,22,97,3610,3514,119,3514,0,0
VT,1272,71477,0,15,5109,379,759,180,197,1054,B,56,5109,485619,39620,407151,1272,56,149,16,977,72749,72749,993,72749,0,0
WA,37941,607131,0,329,4630,379,759,59,197,0,B,1394,4630,485619,39620,407151,37941,1394,149,521,9027,645072,645072,9548,645072,10,48
WI,37210,623554,168,285,3726,76,787,180,197,26792,A+,816,3726,485619,39620,407151,33908,809,7,800,12404,660932,660764,13204,660764,2,43
WV,3826,193363,0,50,5109,15,759,6,197,2718,B,95,5109,485619,39620,407151,3718,1900,149,119,3155,197189,197189,3274,197189,0,0
WY,1774,37271,0,12,121,379,759,180,197,1313,B,21,121,53488,1551,51936,1428,1900,149,34,1193,39045,39045,1227,39045,0,1
AK,1226,132175,0,30,5109,379,759,0,197,563,A,17,5109,133401,39620,407151,1226,17,149,42,1939,133401,133401,1981,133401,0,0
AL,46962,421330,0,1116,3006,379,871,180,486,22082,B,1058,3006,485619,39620,407151,46424,1032,26,1177,5751,468292,468292,6928,468292,25,45
AR,24512,328760,0,358,1655,379,759,89,254,18725,A,301,1655,353272,39620,407151,24512,1900,149,0,2617,353272,353272,2617,353272,9,51
AS,0,816,0,961,5109,379,759,180,197,0,C,0,5109,485619,39620,407151,0,1900,149,0,120,816,816,120,816,0,0
AZ,108614,532456,0,3421,5387,871,759,570,197,12803,A+,1963,5387,640487,39620,407151,108031,1842,121,3520,8753,641070,641070,12273,641070,36,115
CA,289468,4706707,0,7705,5109,1976,759,180,197,0,B,6562,5109,4996175,39620,407151,289468,1900,149,11694,88111,4996175,4996175,99805,4996175,114,0
CO,34664,330409,0,335,5741,379,759,180,197,4669,A,1542,5741,485619,39620,407151,31736,1900,149,407,4026,365073,365073,4433,365073,0,150
CT,47108,498895,0,88,10411,379,759,180,197,8210,B,4343,10411,543636,39620,407151,44741,3471,872,75,8102,546003,546003,8177,546003,5,0
DC,10642,103647,0,86,5109,30,759,17,197,1625,A+,564,5109,485619,39620,407151,38775,1900,149,73,3839,114289,114289,3912,114289,3,0
DE,12462,116572,0,57,5109,11,759,180,197,6851,A+,515,5109,485619,39620,407151,11418,458,57,48,301,129034,129034,349,129034,1,0
FL,223783,2096424,1773,961,17068,379,759,180,197,0,A,3991,17068,2806420,280774,2519880,223783,3991,149,9989,41024,2321980,2320207,51013,2320207,48,335
GA,103890,896519,0,2215,12500,379,2502,180,197,0,A,2922,12500,1000409,94773,905636,103890,1900,149,3420,17537,1000409,1000409,20957,1000409,23,274
GU,307,15833,0,3,5109,379,759,180,197,202,B,5,5109,16232,39620,407151,299,1900,149,4,225,16140,16140,229,16140,0,0
HI,1071,86025,0,961,119,379,759,180,197,797,D,19,119,102674,39620,407151,38775,1900,149,41,1382,87096,87096,1423,87096,0,0
IA,32509,313842,0,165,5109,44,759,23,197,25974,A+,735,5109,485619,39620,407151,32509,1900,149,480,6573,346351,346351,7053,346351,10,0
ID,8539,102792,0,118,396,26,130,180,197,2932,A,94,396,110676,39620,407151,7884,74,20,487,2303,111331,111331,2790,111331,0,9
IL,150554,1693144,0,1385,5109,320,759,153,197,0,A,7309,5109,1842576,39620,407151,149432,7099,210,980,31762,1843698,1843698,32742,1843698,36,0
IN,49063,486794,0,667,7365,217,1551,87,197,37462,A+,2732,7365,485619,39620,407151,38775,2539,193,437,5345,535857,535857,5782,535857,15,32
KS,17618,190864,0,961,1269,379,397,180,160,879,A,282,1269,485619,39620,407151,38775,1900,149,717,5546,208482,208482,6263,208482,2,34
KY,17919,398002,0,453,2737,111,1007,180,197,4912,B,608,2737,485619,39620,407151,17202,604,4,400,5649,415921,415921,6049,415921,6,29
LA,70151,795586,0,1022,5109,379,759,105,197,46334,B,3339,5109,485619,39620,407151,38775,3231,108,1888,16251,865737,865737,18139,865737,20,0
MA,110602,805393,0,662,11517,102,759,49,197,94347,A+,8243,11517,1157023,39620,407151,104961,8028,215,264,8971,915995,915995,9235,915995,30,28
MD,70861,532247,0,398,11184,136,759,180,197,5085,A,3275,11184,746274,39620,407151,70861,3149,126,465,8265,603108,603108,8730,603108,9,73
ME,3460,109478,0,22,363,8,759,5,197,2856,A+,110,363,112543,4226,108154,3065,109,1,20,2012,112938,112938,2032,112938,0,3
MI,74551,1125452,0,505,5109,174,759,93,197,52841,A+,6262,5109,1218053,92601,1125452,67237,6015,247,651,22841,1200003,1200003,23492,1200003,11,0
MN,39589,653381,0,265,4272,122,1302,180,197,34902,A,1523,4272,692970,39620,407151,39589,1485,38,456,7267,692970,692970,7723,692970,9,20
MO,25204,417136,0,694,5109,379,759,74,197,0,B,1046,5109,547352,29458,517004,25204,1900,149,575,6417,442340,442340,6992,442340,4,0
MP,31,10734,0,961,5109,379,759,180,197,19,D,2,5109,10765,39620,407151,31,2,149,0,2547,10765,10765,2547,10765,0,0
MS,32888,283431,0,883,3365,190,759,101,197,22167,A,1188,3365,314459,39620,407151,32620,1168,20,674,0,316319,316319,674,316319,30,50
MT,1371,105050,0,22,117,379,759,180,197,759,C,23,117,485619,39620,407151,1371,1900,149,44,1050,106421,106421,1094,106421,0,0
NC,77310,1019372,0,994,5109,379,759,180,197,55318,A,1441,5109,485619,39620,407151,77310,1441,149,1435,23957,1096682,1096682,25392,1096682,21,0
ND,3971,111868,0,26,252,379,759,180,197,3447,D,78,252,208192,39620,407151,3971,74,4,73,1409,115839,115839,1482,115839,-3,4
NE,20201,174847,0,102,1398,379,759,180,197,14927,B,282,1398,485619,39620,407151,20201,1900,149,155,1820,195048,195048,1975,195048,-1,29
NH,5932,122579,0,24,577,379,164,180,197,4758,B,384,577,485619,39620,407151,5932,1900,149,18,613,128511,128511,631,128511,2,3
NJ,174039,1403809,0,935,20426,175,759,142,197,30844,A+,15423,20426,485619,39620,407151,174039,13476,1947,161,17554,1577848,1577848,17715,1577848,142,180
NM,13727,371515,0,133,2056,379,759,180,197,5986,B,519,2056,485619,39620,407151,13727,1900,149,220,4782,385242,385242,5002,385242,4,23
NV,24301,299352,0,876,5109,233,759,109,197,754,A+,553,5109,396632,39620,407151,24301,1900,149,516,6591,323653,323653,7107,323653,5,0
NY,398929,4003523,0,841,89995,166,759,97,197,71185,A,24944,89995,485619,39620,407151,398929,1900,149,692,56893,4402452,4402452,57585,4402452,20,0
OH,60181,855071,0,890,8489,289,2127,155,197,42111,B,2991,8489,485619,39620,407151,56384,2737,254,1277,17490,915252,915252,18767,915252,21,106
OK,17893,376930,0,458,1804,209,759,180,197,13538,A+,407,1804,397647,19871,376930,17893,1900,149,673,5132,394823,394823,5805,394823,3,63
OR,10817,265450,0,188,1155,57,759,27,197,2877,A+,224,1155,485619,39620,265450,10277,1900,149,212,4149,276267,276267,4361,276267,4,14
PA,92148,774378,0,649,5109,379,759,104,197,70953,A+,6812,5109,485619,39620,407151,89515,1900,149,849,15575,866526,866526,16424,866526,25,0
PR,8745,192686,0,127,5109,9,759,10,197,0,B,159,5109,194324,2627,191601,2171,64,95,31,0,201431,201431,31,201431,2,0
RI,17204,146066,0,56,2043,5,759,5,197,1683,A+,971,2043,271710,24698,247012,17204,1900,149,0,0,163270,163270,0,163270,2,7
SC,48909,404931,0,1404,3090,379,759,180,197,19181,A,884,3090,453701,61473,392228,48770,876,8,1557,6992,453840,453840,8549,453840,38,0
SD,7242,78984,0,54,709,379,759,180,197,6280,B,98,709,485619,39620,407151,38775,1900,149,79,782,86226,86226,861,86226,0,10
TN,55986,894973,0,1160,3023,379,759,180,197,32736,A,685,3023,950540,65002,885538,55567,660,25,2472,27288,950959,950959,29760,950959,20,73
TX,220564,2038144,0,9610,5109,379,759,180,197,113284,B,2813,5109,2258708,39620,407151,220564,1900,149,9979,27442,2258708,2258708,37421,2258708,98,0
UT,26755,359005,0,236,1678,76,465,180,203,15178,A+,201,1678,485619,39620,407151,26755,1900,149,722,2189,385760,385760,2911,385760,7,25
VA,67375,670624,377,971,9982,230,759,98,197,9011,A+,1905,9982,735207,39620,407151,64583,1799,106,635,9247,738376,737999,9882,737999,24,167
VI,122,3273,58,961,5109,379,759,180,197,80,C,6,5109,485619,39620,407151,38775,6,149,6,90,3453,3395,96,3395,0,0
VT,1256,70500,0,14,5109,379,759,180,197,1049,B,56,5109,485619,39620,407151,1256,56,149,2,641,71756,71756,643,71756,0,0
WA,37420,598104,0,318,4582,379,759,52,197,0,B,1384,4582,485619,39620,407151,37420,1384,149,435,5833,635524,635524,6268,635524,14,38
WI,36410,611150,152,276,3683,74,787,180,197,26305,A+,814,3683,485619,39620,407151,33154,807,7,645,10138,647712,647560,10783,647560,2,44
WV,3707,190208,0,48,5109,13,759,7,197,2648,B,95,5109,485619,39620,407151,3602,1900,149,246,3822,193915,193915,4068,193915,0,0
WY,1740,36078,0,13,120,379,759,180,197,1291,B,21,120,51691,1499,50191,1404,1900,149,29,0,37818,37818,29,37818,1,1
AK,1184,130236,0,25,5109,379,759,1,197,560,A,17,5109,131420,39620,407151,1184,17,149,46,7621,131420,131420,7667,131420,1,0
AL,45785,415579,0,1078,2961,379,858,180,479,22082,B,1033,2961,485619,39620,407151,45263,1007,26,907,5362,461364,461364,6269,461364,26,47
AR,24512,326143,0,369,1604,379,759,81,247,17834,A,292,1604,350396,39620,407151,24512,1900,149,259,5428,350655,350655,5687,350655,0,29
AS,0,696,0,961,5109,379,759,180,197,0,C,0,5109,485619,39620,407151,0,1900,149,0,0,696,696,0,696,0,0
AZ,105094,523703,0,3356,5272,869,759,544,197,12260,A+,1927,5272,628275,39620,407151,104572,1807,120,3653,7303,628797,628797,10956,628797,117,84
CA,277774,4618596,0,7499,5109,1984,759,180,197,0,B,6448,5109,4896370,39620,407151,277774,1900,149,6090,96927,4896370,4896370,103017,4896370,111,0
CO,34257,326383,0,327,5591,379,759,180,197,4636,A,1542,5591,485619,39620,407151,31368,1900,149,192,4793,360640,360640,4985,360640,21,26
CT,47033,490793,0,83,10411,379,759,180,197,8210,B,4338,10411,535465,39620,407151,44672,3466,872,57,7256,537826,537826,7313,537826,0,0
DC,10569,99808,0,90,5109,25,759,20,197,1574,A+,561,5109,485619,39620,407151,38775,1900,149,54,2673,110377,110377,2727,110377,0,0
DE,12414,116271,0,56,5109,15,759,180,197,6815,A+,514,5109,485619,39620,407151,11370,457,57,121,1385,128685,128685,1506,128685,2,0
FL,213794,2055400,1604,961,16733,379,759,180,197,0,A,3943,16733,2735238,268024,2461715,213794,3943,149,7347,27907,2270798,2269194,35254,2269194,63,381
GA,100470,878982,0,2096,12226,379,2471,180,197,0,A,2899,12226,979452,91665,887787,100470,1900,149,3406,17093,979452,979452,20499,979452,21,307
GU,303,15608,0,3,5109,379,759,180,197,184,B,5,5109,15903,39620,407151,295,1900,149,2,360,15911,15911,362,15911,0,0
HI,1030,84643,0,961,119,379,759,180,197,781,D,19,119,100888,39620,407151,38775,1900,149,7,608,85673,85673,615,85673,0,1
IA,32029,307269,0,165,5109,44,759,20,197,25594,A+,725,5109,485619,39620,407151,32029,1900,149,372,3464,339298,339298,3836,339298,2,0
ID,8052,100489,0,105,387,25,130,180,197,2907,A,94,387,107925,39620,407151,7436,74,20,319,1757,108541,108541,2076,108541,1,18
IL,149574,1661382,0,1385,5109,320,759,153,197,0,A,7273,5109,1809834,39620,407151,148452,7063,210,587,26407,1810956,1810956,26994,1810956,37,0
IN,48626,481449,0,655,7333,213,1540,76,197,36999,A+,2717,7333,485619,39620,407151,38775,2524,193,295,3188,530075,530075,3483,530075,19,48
KS,16901,185318,0,961,1235,379,384,180,158,859,A,280,1235,485619,39620,407151,38775,1900,149,0,0,202219,202219,0,202219,0,0
KY,17519,392353,0,421,2708,110,1003,180,197,4841,B,602,2708,485619,39620,407151,16864,598,4,367,9163,409872,409872,9530,409872,9,9
LA,68263,779335,0,1025,5109,379,759,109,197,43026,B,3319,5109,485619,39620,407151,38775,3211,108,1936,32017,847598,847598,33953,847598,23,0
MA,110338,796422,0,621,11489,104,759,50,197,93157,A+,8213,11489,1144367,39620,407151,104799,7998,215,201,7142,906760,906760,7343,906760,15,20
MD,70396,523982,0,404,11111,145,759,180,197,5036,A,3266,11111,734342,39620,407151,70396,3140,126,492,6525,594378,594378,7017,594378,20,15
ME,3440,107466,0,22,360,9,759,4,197,2816,A+,110,360,110516,4205,106150,3050,109,1,17,1339,110906,110906,1356,110906,1,1
MI,73900,1102611,0,505,5109,174,759,99,197,52841,A+,6251,5109,1194318,91707,1102611,66627,6005,246,631,16517,1176511,1176511,17148,1176511,30,0
MN,39133,646114,0,267,4252,121,1295,180,197,34377,A,1514,4252,685247,39620,407151,39133,1477,37,564,4990,685247,685247,5554,685247,3,33
MO,24629,410719,0,676,5109,379,759,67,197,0,B,1042,5109,539395,28652,509876,24629,1900,149,773,7830,435348,435348,8603,435348,14,0
MP,31,8187,0,961,5109,379,759,180,197,19,D,2,5109,8217,39620,407151,31,2,149,0,0,8218,8218,0,8218,0,0
MS,32214,283431,0,885,3315,173,759,95,197,22167,A,1158,3315,314459,39620,407151,31966,1139,19,957,0,315645,315645,957,315645,44,35
MT,1327,104000,0,22,117,379,759,180,197,716,C,23,117,485619,39620,407151,1327,1900,149,78,2323,105327,105327,2401,105327,0,5
NC,75875,995415,0,989,5109,379,759,180,197,55318,A,1420,5109,485619,39620,407151,75875,1420,149,1346,18098,1071290,1071290,19444,1071290,22,0
ND,3898,110459,0,24,248,379,759,180,197,3413,D,81,248,204526,39620,407151,3898,72,9,49,726,114357,114357,775,114357,3,3
NE,20046,173027,0,109,1369,379,759,180,197,14759,B,283,1369,485619,39620,407151,20046,1900,149,117,1216,193073,193073,1333,193073,-1,0
NH,5914,121966,0,25,574,379,163,180,197,4706,B,382,574,485619,39620,407151,5914,1900,149,17,2628,127880,127880,2645,127880,1,4
NJ,173878,1386255,0,903,20246,169,759,142,197,30774,A+,15281,20246,485619,39620,407151,173878,13425,1856,267,10657,1560133,1560133,10924,1560133,52,9
NM,13507,366733,0,129,2033,379,759,180,197,5902,B,515,2033,485619,39620,407151,13507,1900,149,251,4935,380240,380240,5186,380240,2,27
NV,23785,292761,0,849,5109,236,759,112,197,743,A+,548,5109,383856,39620,407151,23785,1900,149,876,4189,316546,316546,5065,316546,11,0
NY,398237,3946630,0,836,89995,160,759,103,197,71091,A,24924,89995,485619,39620,407151,398237,1900,149,588,56148,4344867,4344867,56736,4344867,11,0
OH,58904,837581,0,849,8383,289,2101,140,197,41438,B,2970,8383,485619,39620,407151,55150,2718,252,948,14125,896485,896485,15073,896485,43,134
OK,17220,371798,0,426,1741,182,759,180,197,13005,A+,404,1741,391881,19241,371798,17220,1900,149,858,23009,389018,389018,23867,389018,5,52
OR,10605,261301,0,191,1141,55,759,22,197,2877,A+,220,1141,485619,39620,261301,10086,1900,149,210,3975,271906,271906,4185,271906,5,16
PA,91299,758803,0,637,5109,379,759,101,197,70437,A+,6787,5109,485619,39620,407151,88691,1900,149,995,15783,850102,850102,16778,850102,33,0
PR,8714,192686,0,122,5109,19,759,7,197,0,C,157,5109,194324,2627,191601,2147,62,95,129,0,201400,201400,129,201400,2,0
RI,17204,146066,0,55,2036,4,759,4,197,1677,A+,969,2036,271710,24698,247012,17204,1900,149,41,1515,163270,163270,1556,163270,9,17
SC,47352,397939,0,1324,3090,379,759,180,197,19181,A,846,3090,445153,59596,385557,47214,838,8,972,4462,445291,445291,5434,445291,19,208
SD,7163,78202,0,64,699,379,759,180,197,6190,B,98,699,485619,39620,407151,38775,1900,149,58,1004,85365,85365,1062,85365,1,7
TN,53514,867685,0,1112,2950,379,759,180,197,31827,B,665,2950,920801,62185,858616,53116,640,25,1359,15222,921199,921199,16581,921199,12,53
TX,210585,2010702,0,9286,5109,379,759,180,197,108485,B,2715,5109,2221287,39620,407151,210585,1900,149,10028,47530,2221287,2221287,57558,2221287,60,0
UT,26033,356816,0,248,1653,84,455,180,200,14764,A+,194,1653,485619,39620,407151,26033,1900,149,564,6443,382849,382849,7007,382849,4,49
VA,66740,661377,313,902,9815,221,759,105,197,8913,A+,1881,9815,725327,39620,407151,63950,1775,106,638,12366,728430,728117,13004,728117,28,223
VI,116,3183,55,961,5109,379,759,180,197,79,C,6,5109,485619,39620,407151,38775,6,149,4,65,3354,3299,69,3299,0,0
VT,1254,69859,0,13,5109,379,759,180,197,1039,B,56,5109,485619,39620,407151,1254,56,149,3,757,71113,71113,760,71113,0,0
WA,36985,592271,0,222,4544,379,759,37,197,0,B,1370,4544,485619,39620,407151,36985,1370,149,1087,15463,629256,629256,16550,629256,11,62
WI,35765,601012,164,254,3639,69,777,180,197,25758,A+,812,3639,485619,39620,407151,32556,805,7,535,12099,636941,636777,12634,636777,9,37
WV,3461,186386,0,41,5109,13,759,6,197,2535,B,95,5109,485619,39620,407151,3354,1900,149,19,847,189847,189847,866,189847,0,0
WY,1711,36078,0,10,119,379,759,180,197,1274,B,20,119,51691,1499,50191,1378,1900,149,77,2385,37789,37789,2462,37789,0,0
AK,1138,122615,0,19,5109,379,759,3,197,548,A,16,5109,123753,39620,407151,1138,16,149,0,0,123753,123753,0,123753,0,0
AL,44878,410217,0,1025,2914,379,843,180,473,22082,B,1007,2914,485619,39620,407151,44375,984,23,925,4284,455095,455095,5209,455095,0,5
AR,24253,320715,0,337,1575,379,759,81,245,17834,A,292,1575,344529,39620,407151,24253,1900,149,1044,5031,344968,344968,6075,344968,6,39
AS,0,696,0,961,5109,379,759,180,197,0,C,0,5109,485619,39620,407151,0,1900,149,0,0,696,696,0,696,0,0
AZ,101441,516400,0,3212,5188,839,759,533,197,11836,A+,1810,5188,617343,39620,407151,100943,1695,115,3352,10127,617841,617841,13479,617841,1,27
CA,271684,4521669,0,7278,5109,1937,759,180,197,0,B,6337,5109,4793353,39620,407151,271684,1900,149,5699,107516,4793353,4793353,113215,4793353,6,0
CO,34065,321590,0,286,5565,379,759,180,197,4603,A,1521,5565,485619,39620,407151,31168,1900,149,199,4739,355655,355655,4938,355655,0,15
CT,46976,483537,0,69,10411,379,759,180,197,8210,B,4338,10411,528130,39620,407151,44593,3466,872,259,5686,530513,530513,5945,530513,3,0
DC,10515,97135,0,88,5109,23,759,16,197,1553,A+,561,5109,485619,39620,407151,38775,1900,149,33,1624,107650,107650,1657,107650,2,0
DE,12293,114886,0,54,5109,15,759,180,197,6778,A+,512,5109,485619,39620,407151,11249,455,57,165,3073,127179,127179,3238,127179,0,0
FL,206447,2027493,1516,961,16352,379,759,180,197,0,A,3880,16352,2706077,262521,2438200,206447,3880,149,6336,27405,2235456,2233940,33741,2233940,48,151
GA,97064,861889,0,1962,11919,379,2441,180,197,0,A,2878,11919,958953,89063,869890,97064,1900,149,1548,8220,958953,958953,9768,958953,18,144
GU,301,15248,0,2,5109,379,759,180,197,179,B,5,5109,15541,39620,407151,293,1900,149,13,582,15549,15549,595,15549,0,0
HI,1023,84035,0,961,118,379,759,180,197,777,D,19,118,100110,39620,407151,38775,1900,149,24,709,85058,85058,733,85058,0,0
IA,31657,303805,0,151,5109,41,759,15,197,25121,A+,723,5109,485619,39620,407151,31657,1900,149,304,2686,335462,335462,2990,335462,2,0
ID,7733,98732,0,85,369,22,124,180,197,2886,A,93,369,105876,39620,407151,7144,73,20,363,1836,106465,106465,2199,106465,0,10
IL,148987,1634975,0,1395,5109,321,759,151,197,0,A,7236,5109,1782840,39620,407151,147865,7026,210,614,20520,1783962,1783962,21134,1783962,6,0
IN,48331,478261,0,613,7285,229,1526,88,197,36788,A+,2698,7285,485619,39620,407151,38775,2505,193,323,4547,526592,526592,4870,526592,5,31
KS,16901,185318,0,961,1235,379,384,180,158,859,A,280,1235,485619,39620,407151,38775,1900,149,982,9676,202219,202219,10658,202219,3,16
KY,17152,383190,0,433,2699,109,1000,180,197,4785,B,593,2699,485619,39620,407151,16525,589,4,776,3919,400342,400342,4695,400342,8,14
LA,66327,747318,0,964,5109,379,759,109,197,43026,B,3296,5109,485619,39620,407151,38775,3188,108,1101,10090,813645,813645,11191,813645,8,0
MA,110137,789280,0,603,11469,99,759,51,197,93157,A+,8198,11469,1134568,39620,407151,104659,7983,215,163,7569,899417,899417,7732,899417,15,6
MD,69904,517457,0,403,11096,142,759,180,197,5029,A,3246,11096,724463,39620,407151,69904,3121,125,272,7127,587361,587361,7399,587361,3,25
ME,3423,106127,0,21,359,9,759,4,197,2787,A+,109,359,109161,4183,104817,3034,108,1,8,1610,109550,109550,1618,109550,0,0
MI,73269,1086094,0,505,5109,174,759,92,197,52841,A+,6221,5109,1177247,91153,1086094,66173,5975,246,328,12216,1159363,1159363,12544,1159363,3,0
MN,38569,641124,0,258,4219,125,1290,180,197,33907,A,1511,4219,679693,39620,407151,38569,1474,37,433,5245,679693,679693,5678,679693,3,49
MO,23856,402889,0,740,5109,379,759,73,197,0,B,1028,5109,528835,28348,499619,23856,1900,149,420,6816,426745,426745,7236,426745,0,0
MP,31,8187,0,961,5109,379,759,180,197,19,D,2,5109,8217,39620,407151,31,2,149,0,0,8218,8218,0,8218,0,0
MS,31257,283431,0,825,3280,165,759,98,197,22167,A,1114,3280,314459,39620,407151,31028,1096,18,357,4190,314688,314688,4547,314688,3,12
MT,1249,101677,0,20,112,379,759,180,197,678,C,23,112,485619,39620,407151,1249,1900,149,37,2783,102926,102926,2820,102926,0,0
NC,74529,977317,0,982,5109,379,759,180,197,55318,A,1398,5109,485619,39620,407151,74529,1398,149,1546,13462,1051846,1051846,15008,1051846,2,0
ND,3849,109733,0,22,245,379,759,180,197,3350,D,78,245,202533,39620,407151,3849,69,9,33,421,113582,113582,454,113582,0,3
NE,19929,171811,0,101,1369,379,759,180,197,14641,B,284,1369,485619,39620,407151,19929,1900,149,102,1710,191740,191740,1812,191740,0,1
NH,5897,119338,0,25,570,379,163,180,197,4684,B,381,570,485619,39620,407151,5897,1900,149,40,1446,125235,125235,1486,125235,5,1
NJ,173611,1375598,0,861,20237,187,759,152,197,30729,A+,15229,20237,485619,39620,407151,173611,13373,1856,209,14360,1549209,1549209,14569,1549209,18,0
NM,13256,361798,0,119,2006,379,759,180,197,5860,B,513,2006,485619,39620,407151,13256,1900,149,193,2573,375054,375054,2766,375054,0,18
NV,22909,288572,0,748,5109,201,759,114,197,742,A+,537,5109,376887,39620,407151,22909,1900,149,491,3293,311481,311481,3784,311481,3,0
NY,397649,3890482,0,817,89995,170,759,103,197,71040,A,24913,89995,485619,39620,407151,397649,1900,149,518,53810,4288131,4288131,54328,4288131,9,0
OH,57956,823456,0,837,8249,267,2077,140,197,40813,B,2927,8249,485619,39620,407151,54232,2677,250,805,11845,881412,881412,12650,881412,16,77
OK,16362,348789,0,391,1689,165,759,180,197,12432,A+,399,1689,366289,16721,348789,16362,1900,149,434,0,365151,365151,434,365151,1,4
OR,10395,257326,0,183,1125,61,759,26,197,2846,A+,215,1125,485619,39620,257326,9902,1900,149,165,3355,267721,267721,3520,267721,0,56
PA,90304,743020,0,598,5109,379,759,107,197,70437,A+,6754,5109,485619,39620,407151,87705,1900,149,450,8174,833324,833324,8624,833324,1,0
PR,8585,192686,0,115,5109,18,759,11,197,0,C,155,5109,194324,2627,191601,2071,60,95,669,0,201271,201271,669,201271,0,0
RI,17163,144551,0,61,2019,9,759,7,197,1657,A+,960,2019,268294,24624,243670,17163,1900,149,55,1504,161714,161714,1559,161714,0,0
SC,46380,393477,0,1260,2882,379,759,180,197,16994,A,827,2882,439724,58296,381428,46247,819,8,1533,7515,439857,439857,9048,439857,7,0
SD,7105,77198,0,59,692,379,759,180,197,6063,B,97,692,485619,39620,407151,38775,1900,149,42,258,84303,84303,300,84303,0,1
TN,52155,852463,0,940,2897,379,759,180,197,31020,B,653,2897,904237,60554,843683,51774,628,25,724,7728,904618,904618,8452,904618,7,26
TX,200557,1963172,0,8698,5109,379,759,180,197,103782,B,2655,5109,2163729,39620,407151,200557,1900,149,5318,24954,2163729,2163729,30272,2163729,18,0
UT,25469,350373,0,244,1604,83,438,180,194,14448,A+,190,1604,485619,39620,407151,25469,1900,149,517,4017,375842,375842,4534,375842,6,22
VA,66102,649011,218,783,9592,194,759,86,197,8809,A+,1853,9592,712350,39620,407151,63339,1747,106,354,5404,715331,715113,5758,715113,0,16
VI,112,3118,1,961,5109,379,759,180,197,79,C,6,5109,485619,39620,407151,38775,6,149,1,58,3231,3230,59,3230,0,0
VT,1251,69102,0,24,5109,379,759,180,197,1022,B,56,5109,485619,39620,407151,1251,56,149,2,327,70353,70353,329,70353,0,0
WA,35898,576808,0,248,4482,379,759,39,197,0,B,1359,4482,485619,39620,407151,35898,1359,149,651,4779,612706,612706,5430,612706,5,9
WI,35230,588913,172,254,3602,66,772,180,197,25242,A+,803,3602,485619,39620,407151,32061,796,7,490,4802,624315,624143,5292,624143,0,16
WV,3442,185539,0,41,5109,13,759,6,197,2518,B,95,5109,485619,39620,407151,3336,1900,149,180,3980,188981,188981,4160,188981,1,0
WY,1634,33693,0,9,119,379,759,180,197,1172,B,20,119,47932,1342,46589,1312,1900,149,0,0,35327,35327,0,35327,0,0
AK,1138,122615,0,19,5109,379,759,3,197,548,A,16,5109,123753,39620,407151,1138,16,149,27,994,123753,123753,1021,123753,0,0
AL,43953,405933,0,919,2909,379,843,180,473,22082,B,1007,2909,485619,39620,407151,43450,984,23,1091,6707,449886,449886,7798,449886,0,3
AR,23209,315684,0,285,1536,379,759,70,240,16726,A,286,1536,338893,39620,407151,23209,1900,149,0,0,338893,338893,0,338893,0,0
AS,0,696,0,961,5109,379,759,180,197,0,C,0,5109,485619,39620,407151,0,1900,149,0,0,696,696,0,696,0,0
AZ,98089,506273,0,3182,5161,821,759,531,197,11361,A+,1809,5161,603884,39620,407151,97611,1694,115,3536,11318,604362,604362,14854,604362,4,93
CA,265985,4414153,0,7149,5109,1907,759,180,197,0,B,6331,5109,4680138,39620,407151,265985,1900,149,8597,118510,4680138,4680138,127107,4680138,18,0
CO,33866,316851,0,283,5550,379,759,180,197,4568,A,1521,5550,485619,39620,407151,30970,1900,149,247,4716,350717,350717,4963,350717,0,13
CT,46717,477851,0,95,10411,379,759,180,197,8210,B,4335,10411,522385,39620,407151,44534,3463,872,0,24542,524568,524568,24542,524568,0,0
DC,10482,95511,0,87,5109,26,759,18,197,1542,A+,559,5109,485619,39620,407151,38775,1900,149,35,1404,105993,105993,1439,105993,2,0
DE,12128,111813,0,53,5109,15,759,180,197,6740,A+,512,5109,485619,39620,407151,11084,455,57,132,3116,123941,123941,3248,123941,0,0
FL,200111,2000088,1508,961,16201,379,759,180,197,0,A,3832,16201,2662423,254652,2402605,200111,3832,149,10059,43643,2201707,2200199,53702,2200199,29,161
GA,95516,853669,0,1805,11775,379,2429,180,197,0,A,2860,11775,949185,87822,861363,95516,1900,149,2197,20629,949185,949185,22826,949185,3,32
GU,288,14666,0,3,5109,379,759,180,197,179,B,5,5109,13925,39620,407151,280,1900,149,0,0,14954,14954,0,14954,0,0
HI,999,83326,0,961,118,379,759,180,197,756,D,19,118,99282,39620,407151,38775,1900,149,24,825,84325,84325,849,84325,0,0
IA,31353,301119,0,141,5109,43,759,16,197,24739,A+,721,5109,485619,39620,407151,31353,1900,149,312,3149,332472,332472,3461,332472,0,0
ID,7370,96896,0,71,359,19,122,180,197,2858,A,93,359,103675,39620,407151,6779,73,20,376,2823,104266,104266,3199,104266,0,4
IL,148373,1614455,0,1326,5109,304,759,165,197,0,A,7230,5109,1761706,39620,407151,147251,7020,210,639,26596,1762828,1762828,27235,1762828,6,0
IN,48008,473714,0,632,7254,218,1526,87,197,36475,A+,2693,7254,485619,39620,407151,38775,2500,193,576,8858,521722,521722,9434,521722,6,38
KS,15919,175642,0,961,1219,379,377,180,156,842,A,277,1219,485619,39620,407151,38775,1900,149,0,0,191561,191561,0,191561,0,0
KY,16376,379271,0,455,2685,99,996,180,197,4747,B,585,2685,485619,39620,407151,15781,581,4,0,0,395647,395647,0,395647,0,0
LA,65226,737228,0,926,5109,379,759,105,197,43026,B,3288,5109,485619,39620,407151,38775,3180,108,1937,16375,802454,802454,18312,802454,10,0
MA,109974,781711,0,636,11463,100,759,46,197,93157,A+,8183,11463,1124217,39620,407151,104502,7968,215,136,5782,891685,891685,5918,891685,11,2
MD,69632,510330,0,409,11071,144,759,180,197,5029,A,3243,11071,713526,39620,407151,69632,3118,125,291,6329,579962,579962,6620,579962,7,37
ME,3415,104517,0,25,359,9,759,3,197,2772,A+,109,359,107545,4176,103208,3028,108,1,18,1969,107932,107932,1987,107932,2,1
MI,72941,1073878,0,548,5109,193,759,92,197,52841,A+,6218,5109,1164666,90788,1073878,65876,5972,246,360,16305,1146819,1146819,16665,1146819,0,0
MN,38136,635879,0,253,4170,132,1287,180,197,33408,A,1508,4170,674015,39620,407151,38136,1471,37,512,28331,674015,674015,28843,674015,5,31
MO,23436,396073,0,739,5109,379,759,72,197,0,B,1028,5109,424214,23527,399926,23436,1900,149,221,7027,419509,419509,7248,419509,1,0
MP,31,8187,0,961,5109,379,759,180,197,19,D,2,5109,8217,39620,407151,31,2,149,0,0,8218,8218,0,8218,0,0
MS,30900,279241,0,872,3268,175,759,88,197,19388,A,1111,3268,309699,39620,407151,30671,1093,18,226,0,310141,310141,226,310141,4,0
MT,1212,98894,0,20,112,379,759,180,197,678,C,23,112,485619,39620,407151,1212,1900,149,45,1111,100106,100106,1156,100106,0,0
NC,72983,963855,0,949,5109,379,759,180,197,45538,A,1396,5109,485619,39620,407151,72983,1396,149,1329,17213,1036838,1036838,18542,1036838,1,0
ND,3816,109312,0,22,242,379,759,180,197,3324,D,78,242,201303,39620,407151,3816,69,9,37,1163,113128,113128,1200,113128,0,1
NE,19827,170101,0,109,1368,379,759,180,197,14340,B,284,1368,485619,39620,407151,19827,1900,149,167,2173,189928,189928,2340,189928,0,3
NH,5857,117892,0,25,569,379,163,180,197,4597,B,376,569,485619,39620,407151,5857,1900,149,0,0,123749,123749,0,123749,0,0
NJ,173402,1361238,0,917,20237,210,759,151,197,30660,A+,15211,20237,485619,39620,407151,173402,13355,1856,369,25723,1534640,1534640,26092,1534640,22,4
NM,13063,359225,0,121,1988,379,759,180,197,5845,B,513,1988,485619,39620,407151,13063,1900,149,287,8627,372288,372288,8914,372288,2,18
NV,22418,285279,0,760,5109,226,759,99,197,727,A+,534,5109,371890,39620,407151,22418,1900,149,843,5625,307697,307697,6468,307697,4,0
NY,397131,3836672,0,832,89995,178,759,116,197,70968,A,24904,89995,485619,39620,407151,397131,1900,149,533,62882,4233803,4233803,63415,4233803,8,0
OH,57151,811611,0,693,8172,236,2058,119,197,40460,B,2911,8172,485619,39620,407151,53458,2661,250,968,19424,868762,868762,20392,868762,4,61
OK,15928,348789,0,391,1685,165,759,180,197,12246,A+,398,1685,366289,16721,348789,15928,1900,149,283,0,364717,364717,283,364717,0,9
OR,10230,253971,0,173,1069,52,759,25,197,2759,A+,215,1069,485619,39620,253971,8877,1900,149,300,8875,264201,264201,9175,264201,2,0
PA,89854,734846,0,592,5109,379,759,106,197,70086,A+,6753,5109,485619,39620,407151,87267,1900,149,479,9398,824700,824700,9877,824700,4,0
PR,7916,192686,0,118,5109,9,759,5,197,0,C,155,5109,194324,2627,191601,1846,60,95,129,0,200602,200602,129,200602,0,0
RI,17108,143047,0,61,2019,9,759,7,197,1657,A+,960,2019,265484,24523,240961,17108,1900,149,24,1374,160155,160155,1398,160155,0,0
SC,44847,385962,0,1251,2882,379,759,180,197,16994,A,820,2882,430679,56567,374112,44717,813,7,1461,8655,430809,430809,10116,430809,7,0
SD,7063,76940,0,59,691,379,759,180,197,6063,B,97,691,485619,39620,407151,38775,1900,149,35,138,84003,84003,173,84003,0,2
TN,51431,844735,0,949,2871,379,759,180,197,30254,B,646,2871,895796,59768,836028,51061,621,25,1291,16271,896166,896166,17562,896166,9,11
TX,195239,1938218,0,8181,5109,379,759,180,197,100843,B,2637,5109,2133457,39620,407151,195239,1900,149,3449,58199,2133457,2133457,61648,2133457,29,0
UT,24952,346356,0,237,1582,84,438,180,195,14147,A+,184,1582,485619,39620,407151,24952,1900,149,410,4182,371308,371308,4592,371308,3,17
VA,65748,643607,246,792,9576,202,759,95,197,8784,A+,1853,9576,706588,39620,407151,62981,1746,107,639,9487,709601,709355,10126,709355,4,27
VI,111,3060,2,961,5109,379,759,180,197,76,C,6,5109,485619,39620,407151,38775,6,149,0,0,3173,3171,0,3171,0,0
VT,1249,68775,0,15,5109,379,759,180,197,1007,B,56,5109,485619,39620,407151,1249,56,149,11,616,70024,70024,627,70024,0,0
WA,35247,572029,0,305,4473,379,759,56,197,0,B,1354,4473,485619,39620,407151,35247,1354,149,469,6832,607276,607276,7301,607276,2,10
WI,34740,584111,129,244,3586,65,771,180,197,24899,A+,803,3586,485619,39620,407151,31577,796,7,533,4474,618980,618851,5007,618851,0,12
WV,3262,181559,0,27,5109,12,759,5,197,2421,B,94,5109,485619,39620,407151,3156,1900,149,121,3271,184821,184821,3392,184821,0,0
WY,1634,33693,0,8,119,379,759,180,197,1172,B,20,119,47932,1342,46589,1312,1900,149,28,0,35327,35327,28,35327,0,0
AK,1111,121621,0,23,5109,379,759,3,197,544,A,16,5109,122732,39620,407151,1111,16,149,48,2476,122732,122732,2524,122732,1,0
AL,42862,399226,0,818,2906,379,843,180,473,22082,B,1007,2906,485619,39620,407151,42359,984,23,997,10460,442088,442088,11457,442088,1,23
AR,23209,315684,0,285,1536,379,759,70,240,16726,A,286,1536,338893,39620,407151,23209,1900,149,587,7069,338893,338893,7656,338893,5,19
AS,0,696,0,961,5109,379,759,180,197,0,C,0,5109,485619,39620,407151,0,1900,149,0,0,696,696,0,696,0,0
AZ,94553,494955,0,3113,5068,796,759,413,197,10903,A+,1805,5068,589040,39620,407151,94085,1690,115,2695,8432,589508,589508,11127,589508,17,50
CA,257388,4295643,0,7092,5109,1888,759,180,197,0,B,6313,5109,4553031,39620,407151,257388,1900,149,9153,95702,4553031,4553031,104855,4553031,50,0
CO,33619,312135,0,270,5537,379,759,180,197,4557,A,1521,5537,485619,39620,407151,30722,1900,149,267,5197,345754,345754,5464,345754,0,10
CT,46717,453309,0,95,10411,379,759,180,197,8210,B,4335,10411,497693,39620,407151,44384,3463,872,0,-60,500026,500026,-60,500026,0,0
DC,10447,94107,0,95,5109,28,759,21,197,1523,A+,557,5109,485619,39620,407151,38775,1900,149,12,1733,104554,104554,1745,104554,2,0
DE,11996,108697,0,54,5109,13,759,180,197,6711,A+,512,5109,485619,39620,407151,10952,455,57,73,2277,120693,120693,2350,120693,0,0
FL,190052,1956445,1672,961,16040,379,759,180,197,0,A,3803,16040,2595006,242571,2347444,190052,3803,149,11458,53679,2148169,2146497,65137,2146497,18,245
GA,93319,833040,0,1726,11743,379,2425,180,197,0,A,2857,11743,926359,85349,841010,93319,1900,149,2826,22316,926359,926359,25142,926359,1,90
GU,288,14666,0,3,5109,379,759,180,197,179,B,5,5109,13925,39620,407151,280,1900,149,2,403,14954,14954,405,14954,0,0
HI,975,82501,0,961,118,379,759,180,197,754,D,19,118,98278,39620,407151,38775,1900,149,29,1829,83476,83476,1858,83476,1,2
IA,31041,297970,0,134,5109,40,759,16,197,24604,A+,721,5109,485619,39620,407151,31041,1900,149,612,6938,329011,329011,7550,329011,1,0
ID,6994,94073,0,67,355,23,121,180,197,2831,A,93,355,100474,39620,407151,6401,73,20,401,1957,101067,101067,2358,101067,1,5
IL,147734,1587859,0,1346,5109,336,759,182,197,0,A,7224,5109,1734471,39620,407151,146612,7014,210,862,32974,1735593,1735593,33836,1735593,9,0
IN,47432,464856,0,632,7216,218,1516,87,197,36076,A+,2687,7216,485619,39620,407151,38775,2494,193,517,7618,512288,512288,8135,512288,6,41
KS,15919,175642,0,961,1219,379,377,180,156,842,A,277,1219,485619,39620,407151,38775,1900,149,0,0,191561,191561,0,191561,0,0
KY,16376,379271,0,455,2685,99,996,180,197,4747,B,585,2685,485619,39620,407151,15781,581,4,0,0,395647,395647,0,395647,0,0
LA,63289,720853,0,852,5109,379,759,93,197,43026,B,3278,5109,485619,39620,407151,38775,3170,108,0,0,784142,784142,0,784142,0,0
MA,109838,775929,0,640,11461,107,759,51,197,93157,A+,8172,11461,1116271,39620,407151,104391,7958,214,210,7777,885767,885767,7987,885767,23,25
MD,69341,504001,0,410,11034,143,759,180,197,5025,A,3236,11034,704450,39620,407151,69341,3111,125,380,9128,573342,573342,9508,573342,13,61
ME,3397,102548,0,27,358,9,759,3,197,2751,A+,107,358,105560,4151,101249,3012,106,1,24,2472,105945,105945,2496,105945,2,0
MI,72581,1057573,0,548,5109,193,759,92,197,52841,A+,6218,5109,1147836,90263,1057573,65533,5972,246,406,21483,1130154,1130154,21889,1130154,3,0
MN,37624,607548,0,270,4139,132,1277,180,197,32347,A,1503,4139,645172,39620,407151,37624,1466,37,0,0,645172,645172,0,645172,0,0
MO,23215,389046,0,740,5109,379,759,73,197,0,B,1027,5109,424214,23527,399926,23215,1900,149,385,6917,412261,412261,7302,412261,1,0
MP,31,8187,0,961,5109,379,759,180,197,19,D,2,5109,8217,39620,407151,31,2,149,0,0,8218,8218,0,8218,0,0
MS,30674,279241,0,872,3268,175,759,88,197,19388,A,1107,3268,309699,39620,407151,30458,1089,18,1904,8972,309915,309915,10876,309915,15,60
MT,1167,97783,0,20,112,379,759,180,197,678,C,23,112,485619,39620,407151,1167,1900,149,39,1408,98950,98950,1447,98950,0,3
NC,71654,946642,0,945,5109,379,759,180,197,45538,A,1395,5109,485619,39620,407151,71654,1395,149,1413,17590,1018296,1018296,19003,1018296,3,0
ND,3779,108149,0,22,241,379,759,180,197,3288,D,78,241,197490,39620,407151,3779,69,9,57,1297,111928,111928,1354,111928,0,4
NE,19660,167928,0,111,1365,379,759,180,197,14200,B,284,1365,485619,39620,407151,19660,1900,149,208,3246,187588,187588,3454,187588,2,12
NH,5857,117892,0,25,569,379,163,180,197,4597,B,376,569,485619,39620,407151,5857,1900,149,35,1527,123749,123749,1562,123749,1,2
NJ,173033,1335515,0,983,20233,205,759,164,197,30565,A+,15189,20233,485619,39620,407151,173033,13333,1856,291,22756,1508548,1508548,23047,1508548,25,19
NM,12776,350598,0,130,1970,379,759,180,197,5802,B,511,1970,485619,39620,407151,12776,1900,149,256,6481,363374,363374,6737,363374,8,25
NV,21575,279654,0,749,5109,205,759,97,197,727,A+,530,5109,363432,39620,407151,21575,1900,149,857,6687,301229,301229,7544,301229,2,0
NY,396598,3773790,0,844,89995,190,759,119,197,70877,A,24896,89995,485619,39620,407151,396598,1900,149,726,61677,4170388,4170388,62403,4170388,11,0
OH,56183,792187,0,691,8111,226,2052,111,197,39903,B,2907,8111,485619,39620,407151,52488,2657,250,926,19287,848370,848370,20213,848370,4,27
OK,15645,348789,0,391,1676,165,759,180,197,11965,A+,398,1676,366289,16721,348789,15645,1900,149,580,0,364434,364434,580,364434,0,15
OR,9930,245096,0,173,1069,52,759,25,197,2759,A+,213,1069,485619,39620,245096,8877,1900,149,294,0,255026,255026,294,255026,4,0
PA,89375,725448,0,589,5109,379,759,102,197,69712,A+,6749,5109,485619,39620,407151,86813,1900,149,634,10045,814823,814823,10679,814823,3,0
PR,7787,192686,0,100,5109,8,759,4,197,0,C,155,5109,194324,2627,191601,1817,60,95,104,0,200473,200473,104,200473,1,0
RI,17084,141673,0,61,2019,9,759,7,197,1657,A+,960,2019,262612,24477,238135,17084,1900,149,27,952,158757,158757,979,158757,0,0
SC,43386,377307,0,1190,2882,379,759,180,197,16994,A,813,2882,420567,54851,365716,43260,806,7,1854,9807,420693,420693,11661,420693,20,0
SD,7028,76802,0,54,689,379,759,180,197,6062,B,97,689,485619,39620,407151,38775,1900,149,50,787,83830,83830,837,83830,0,2
TN,50140,828464,0,949,2860,379,759,180,197,30043,B,637,2860,878230,58202,820028,49768,612,25,1428,14687,878604,878604,16115,878604,4,35
TX,191790,1880019,0,7890,5109,379,759,180,197,97430,B,2608,5109,2071809,39620,407151,191790,1900,149,8258,49645,2071809,2071809,57903,2071809,33,0
UT,24542,342174,0,255,1565,88,436,180,194,13807,A+,181,1565,485619,39620,407151,24542,1900,149,676,9404,366716,366716,10080,366716,0,36
VA,65109,634120,280,808,9549,207,759,99,197,8741,A+,1849,9549,696520,39620,407151,62400,1745,104,716,10153,699509,699229,10869,699229,4,20
VI,111,3060,2,961,5109,379,759,180,197,76,C,6,5109,485619,39620,407151,38775,6,149,13,97,3173,3171,110,3171,0,0
VT,1238,68159,0,16,5109,379,759,180,197,999,B,56,5109,485619,39620,407151,1238,56,149,2,1000,69397,69397,1002,69397,0,0
WA,34778,565197,0,315,4463,379,759,58,197,0,B,1352,4463,485619,39620,407151,34778,1352,149,627,14359,599975,599975,14986,599975,10,21
WI,34207,579637,129,235,3574,67,771,180,197,24491,A+,803,3574,485619,39620,407151,31055,796,7,776,6084,613973,613844,6860,613844,0,19
WV,3141,178288,0,25,5109,11,759,4,197,2402,B,94,5109,485619,39620,407151,3036,1900,149,15,712,181429,181429,727,181429,1,0
WY,1606,33693,0,8,119,379,759,180,197,1169,B,20,119,47932,1342,46589,1289,1900,149,24,0,35299,35299,24,35299,0,0
AK,1063,119145,0,25,5109,379,759,3,197,539,A,15,5109,120208,39620,407151,1063,15,149,46,4253,120208,120208,4299,120208,1,0
AL,41865,388766,0,838,2883,379,838,180,474,22082,B,1006,2883,485619,39620,407151,41362,983,23,1754,9149,430631,430631,10903,430631,21,48
AR,22622,308615,0,285,1517,379,759,70,236,16164,A,281,1517,485619,39620,407151,22622,1900,149,547,6703,331237,331237,7250,331237,2,40
AS,0,696,0,961,5109,379,759,180,197,0,C,0,5109,485619,39620,407151,0,1900,149,0,0,696,696,0,696,0,0
AZ,91858,486523,0,3013,5018,741,759,489,197,10478,A+,1788,5018,577919,39620,407151,91396,1673,115,4433,13109,578381,578381,17542,578381,31,102
CA,248235,4199941,0,7024,5109,1871,759,180,197,0,B,6263,5109,4448176,39620,407151,248235,1900,149,5688,103770,4448176,4448176,109458,4448176,100,0
CO,33352,306938,0,270,5527,379,759,180,197,4541,A,1521,5527,485619,39620,407151,30453,1900,149,323,6712,340290,340290,7035,340290,1,14
CT,46717,453369,0,95,10411,379,759,180,197,8210,B,4335,10411,497693,39620,407151,44324,3463,872,71,-99,500086,500086,-28,500086,9,0
DC,10435,92374,0,110,5109,38,759,24,197,1497,A+,555,5109,485619,39620,407151,38775,1900,149,45,1701,102809,102809,1746,102809,1,0
DE,11923,106420,0,57,5109,13,759,180,197,6692,A+,512,5109,485619,39620,407151,10879,455,57,192,3233,118343,118343,3425,118343,2,0
FL,178594,1902766,1717,961,15795,379,759,180,197,0,A,3785,15795,2513115,228506,2279841,178594,3785,149,9488,39689,2083077,2081360,49177,2081360,67,341
GA,90493,810724,0,1671,11653,379,2413,180,197,0,A,2856,11653,901217,82421,818796,90493,1900,149,2784,15194,901217,901217,17978,901217,7,153
GU,286,14263,0,2,5109,379,759,180,197,179,B,5,5109,13925,39620,407151,278,1900,149,6,610,14549,14549,616,14549,0,0
HI,946,80672,0,961,116,379,759,180,197,746,D,18,116,95866,39620,407151,38775,1900,149,20,1308,81618,81618,1328,81618,0,0
IA,30429,291032,0,146,5109,40,759,20,197,24338,A+,720,5109,485619,39620,407151,30429,1900,149,220,3703,321461,321461,3923,321461,2,0
ID,6593,92116,0,64,350,23,121,180,197,2801,A,92,350,98119,39620,407151,6003,72,20,223,3365,98709,98709,3588,98709,0,10
IL,146872,1554885,0,1349,5109,334,759,164,197,0,A,7215,5109,1700635,39620,407151,145750,7005,210,937,33450,1701757,1701757,34387,1701757,27,0
IN,46915,457238,0,633,7175,217,1506,81,197,35756,A+,2681,7175,485619,39620,407151,38775,2488,193,528,6790,504153,504153,7318,504153,19,36
KS,15919,175642,0,961,1219,379,377,180,156,842,A,277,1219,485619,39620,407151,38775,1900,149,929,7459,191561,191561,8388,191561,5,24
KY,16376,379271,0,455,2685,99,996,180,197,4747,B,585,2685,485619,39620,407151,15781,581,4,297,9556,395647,395647,9853,395647,4,23
LA,63289,720853,0,852,5109,379,759,93,197,43026,B,3278,5109,485619,39620,407151,38775,3170,108,1728,15040,784142,784142,16768,784142,23,0
MA,109628,768152,0,656,11436,106,759,55,197,93157,A+,8149,11436,1105013,39620,407151,104228,7935,214,290,11232,877780,877780,11522,877780,17,44
MD,68961,494873,0,422,10973,143,759,180,197,5023,A,3223,10973,691495,39620,407151,68961,3099,124,538,10121,563834,563834,10659,563834,11,34
ME,3373,100076,0,27,358,9,759,3,197,2731,A+,105,358,103061,4074,98844,2985,104,1,45,2587,103449,103449,2632,103449,0,4
MI,72175,1036090,0,548,5109,193,759,92,197,51099,A+,6215,5109,1125738,89648,1036090,65135,5969,246,497,22631,1108265,1108265,23128,1108265,3,0
MN,37624,607548,0,270,4139,132,1277,180,197,32347,A,1503,4139,645172,39620,407151,37624,1466,37,414,14331,645172,645172,14745,645172,8,27
MO,22830,382129,0,716,5109,379,759,78,197,0,B,1026,5109,424214,23527,399926,22830,1900,149,547,7094,404959,404959,7641,404959,4,0
MP,31,8187,0,961,5109,379,759,180,197,19,D,2,5109,8217,39620,407151,31,2,149,1,0,8218,8218,1,8218,0,0
MS,28770,270269,0,863,3208,167,759,94,197,19388,A,1092,3208,298842,39620,407151,28573,1074,18,0,0,299039,299039,0,299039,0,0
MT,1128,96375,0,17,109,379,759,180,197,678,C,23,109,485619,39620,407151,1128,1900,149,45,2309,97503,97503,2354,97503,1,3
NC,70241,929052,0,951,5109,379,759,180,197,45538,A,1392,5109,485619,39620,407151,70241,1392,149,2099,26074,999293,999293,28173,999293,1,0
ND,3722,106852,0,20,237,379,759,180,197,3266,D,78,237,193054,39620,407151,3722,69,9,65,2314,110574,110574,2379,110574,0,3
NE,19452,164682,0,121,1353,379,759,180,197,14022,B,282,1353,485619,39620,407151,19452,1900,149,142,1330,184134,184134,1472,184134,6,10
NH,5822,116365,0,31,567,379,162,180,197,4508,B,375,567,485619,39620,407151,5822,1900,149,20,1860,122187,122187,1880,122187,2,2
NJ,172742,1312759,0,1028,20214,216,759,167,197,30464,A+,15164,20214,485619,39620,407151,172742,13308,1856,386,21202,1485501,1485501,21588,1485501,57,73
NM,12520,344117,0,127,1945,379,759,180,197,5627,B,503,1945,485619,39620,407151,12520,1900,149,244,6333,356637,356637,6577,356637,3,17
NV,20718,272967,0,704,5109,219,759,87,197,727,A+,528,5109,353255,39620,407151,20718,1900,149,985,7972,293685,293685,8957,293685,3,0
NY,395872,3712113,0,857,89995,188,759,125,197,70794,A,24885,89995,485619,39620,407151,395872,1900,149,918,65474,4107985,4107985,66392,4107985,8,0
OH,55257,772900,0,740,8084,233,2044,100,197,39423,B,2903,8084,485619,39620,407151,51581,2653,250,1091,33760,828157,828157,34851,828157,0,46
OK,15065,348789,0,391,1661,165,759,180,197,11519,A+,398,1661,366289,16721,348789,15065,1900,149,526,10278,363854,363854,10804,363854,3,46
OR,9636,245096,0,173,1069,52,759,25,197,2759,A+,209,1069,485619,39620,245096,8877,1900,149,342,3336,254732,254732,3678,254732,0,0
PA,88741,715403,0,598,5109,379,759,105,197,69217,A+,6746,5109,485619,39620,407151,86205,1900,149,667,13204,804144,804144,13871,804144,34,0
PR,7683,192686,0,104,5109,11,759,6,197,0,C,154,5109,194324,2627,191601,1791,60,94,75,0,200369,200369,75,200369,1,0
RI,17057,140721,0,61,2019,9,759,7,197,1657,A+,960,2019,260333,24425,235908,17057,1900,149,22,673,157778,157778,695,157778,1,8
SC,41532,367500,0,1148,2882,379,759,180,197,16994,A,793,2882,408913,52487,356426,41413,787,6,1831,5800,409032,409032,7631,409032,9,28
SD,6978,76015,0,58,687,379,759,180,197,6049,B,97,687,485619,39620,407151,38775,1900,149,85,967,82993,82993,1052,82993,0,4
TN,48712,813777,0,949,2825,379,759,180,197,29591,B,633,2825,862121,56644,805477,48344,608,25,1822,22213,862489,862489,24035,862489,13,50
TX,183532,1830374,0,7652,5109,379,759,180,197,93572,B,2575,5109,2013906,39620,407151,183532,1900,149,7555,30548,2013906,2013906,38103,2013906,50,0
UT,23866,332770,0,232,1529,85,434,180,193,13408,A+,181,1529,485619,39620,407151,23866,1900,149,596,9654,356636,356636,10250,356636,5,24
VA,64393,623967,283,818,9529,207,759,95,197,8711,A+,1845,9529,685657,39620,407151,61690,1741,104,658,13446,688643,688360,14104,688360,29,145
VI,98,2963,103,961,5109,379,759,180,197,75,C,6,5109,485619,39620,407151,38775,6,149,6,39,3164,3061,45,3061,0,0
VT,1236,67159,0,16,5109,379,759,180,197,967,B,56,5109,485619,39620,407151,1236,56,149,9,1045,68395,68395,1054,68395,0,0
WA,34151,550838,0,334,4442,379,759,62,197,0,B,1342,4442,485619,39620,407151,34151,1342,149,716,12309,584989,584989,13025,584989,3,40
WI,33431,573553,134,244,3555,75,768,180,197,24043,A+,803,3555,485619,39620,407151,30317,796,7,622,9607,607118,606984,10229,606984,3,36
WV,3126,177576,0,25,5109,11,759,4,197,2396,B,93,5109,485619,39620,407151,3021,1900,149,73,2288,180702,180702,2361,180702,0,0
WY,1582,33693,0,8,119,379,759,180,197,1154,B,20,119,47932,1342,46589,1267,1900,149,32,0,35275,35275,32,35275,0,0
AK,1017,114892,0,18,5109,379,759,1,197,535,A,14,5109,115909,39620,407151,1017,14,149,39,1470,115909,115909,1509,115909,0,0
AL,40111,379617,0,843,2835,379,826,180,468,22082,B,985,2835,485619,39620,407151,39604,961,24,1149,4626,419728,419728,5775,419728,13,32
AR,22075,301912,0,272,1477,379,759,72,231,15698,A,279,1477,485619,39620,407151,22075,1900,149,878,8251,323987,323987,9129,323987,2,29
AS,0,696,0,961,5109,379,759,180,197,0,C,0,5109,485619,39620,407151,0,1900,149,0,0,696,696,0,696,0,0
AZ,87425,473414,0,2938,4916,723,759,488,197,10137,A+,1757,4916,560384,39620,407151,86970,1642,115,3333,7910,560839,560839,11243,560839,37,79
CA,242547,4096171,0,6812,5109,1934,759,180,197,0,B,6163,5109,4338718,39620,407151,242547,1900,149,6408,78134,4338718,4338718,84542,4338718,73,0
CO,33029,300226,0,262,5513,379,759,180,197,4524,A,1520,5513,485619,39620,407151,30133,1900,149,314,5438,333255,333255,5752,333255,0,24
CT,46646,453468,0,101,10411,379,759,180,197,8210,B,4326,10411,497693,39620,407151,44225,3459,867,74,10231,500114,500114,10305,500114,2,143
DC,10390,90673,0,120,5109,33,759,28,197,1465,A+,554,5109,485619,39620,407151,38775,1900,149,25,1003,101063,101063,1028,101063,1,0
DE,11731,103187,0,67,5109,16,759,180,197,6678,A+,510,5109,485619,39620,407151,10687,453,57,221,3313,114918,114918,3534,114918,1,0
FL,169106,1863077,1683,961,15454,379,759,180,197,0,A,3718,15454,2449162,216375,2228207,169106,3718,149,10109,41720,2033866,2032183,51829,2032183,68,329
GA,87709,795530,0,1649,11500,379,2389,180,197,0,A,2849,11500,883239,79970,803269,87709,1900,149,3472,24729,883239,883239,28201,883239,22,225
GU,280,13653,0,1,5109,379,759,180,197,179,B,5,5109,13925,39620,407151,272,1900,149,13,136,13933,13933,149,13933,0,0
HI,926,79364,0,961,116,379,759,180,197,741,D,18,116,94160,39620,407151,38775,1900,149,9,1223,80290,80290,1232,80290,0,3
IA,30209,287329,0,145,5109,36,759,18,197,23993,A+,718,5109,485619,39620,407151,30209,1900,149,758,6990,317538,317538,7748,317538,1,0
ID,6370,88751,0,69,340,17,118,180,197,4393,A,92,340,94537,39620,407151,5786,72,20,253,3828,95121,95121,4081,95121,0,10
IL,145935,1521435,0,1651,5109,349,759,195,197,0,A,7188,5109,1666317,39620,407151,144882,6987,201,869,29393,1667370,1667370,30262,1667370,36,0
IN,46387,450448,0,644,7139,221,1493,89,197,35405,A+,2662,7139,485619,39620,407151,38775,2469,193,435,6684,496835,496835,7119,496835,12,44
KS,14990,168183,0,961,1195,379,367,180,152,834,A,272,1195,485619,39620,407151,38775,1900,149,0,0,183173,183173,0,183173,0,43
KY,16079,369715,0,430,2662,73,994,180,197,4726,B,581,2662,485619,39620,407151,15508,577,4,237,8467,385794,385794,8704,385794,9,27
LA,61561,705813,0,840,5109,379,759,91,197,43026,B,3255,5109,485619,39620,407151,38775,3147,108,1383,13903,767374,767374,15286,767374,17,0
MA,109338,756920,0,681,11392,113,759,52,197,93157,A+,8132,11392,1090482,39620,407151,104016,7918,214,195,7628,866258,866258,7823,866258,51,40
MD,68423,484752,0,441,10939,149,759,180,197,5013,A,3212,10939,675929,39620,407151,68423,3086,126,505,10066,553175,553175,10571,553175,7,37
ME,3328,97489,0,30,354,9,759,3,197,2698,A+,105,354,100440,4026,96272,2951,104,1,34,3542,100817,100817,3576,100817,0,3
MI,71678,1013459,0,548,5109,193,759,103,197,51099,A+,6212,5109,1102412,88953,1013459,64675,5966,246,589,22689,1085137,1085137,23278,1085137,14,0
MN,37210,593217,0,274,4112,123,1266,180,197,32163,A,1495,4112,630427,39620,407151,37210,1458,37,494,12826,630427,630427,13320,630427,13,31
MO,22283,375035,0,716,5109,379,759,77,197,0,B,1022,5109,424214,23527,399926,22283,1900,149,356,7222,397318,397318,7578,397318,5,0
MP,30,8187,0,961,5109,379,759,180,197,19,D,2,5109,8217,39620,407151,30,2,149,0,0,8217,8217,0,8217,0,0
MS,28770,270269,0,863,3208,167,759,94,197,19388,A,1092,3208,298842,39620,407151,28573,1074,18,870,4417,299039,299039,5287,299039,10,31
MT,1083,94066,0,14,106,379,759,180,197,672,C,22,106,485619,39620,407151,1083,1900,149,67,1752,95149,95149,1819,95149,0,1
NC,68142,902978,0,912,5109,379,759,180,197,45538,A,1391,5109,485619,39620,407151,68142,1391,149,1629,27253,971120,971120,28882,971120,18,0
ND,3657,104538,0,19,234,379,759,180,197,3235,D,78,234,188414,39620,407151,3657,69,9,42,927,108195,108195,969,108195,0,0
NE,19310,163352,0,117,1343,379,759,180,197,13807,B,276,1343,485619,39620,407151,19310,1900,149,133,1921,182662,182662,2054,182662,2,13
NH,5802,114505,0,32,565,379,162,180,197,4491,B,373,565,485619,39620,407151,5802,1900,149,20,1118,120307,120307,1138,120307,2,0
NJ,172356,1291557,0,1027,20141,216,759,170,197,30383,A+,15107,20141,485619,39620,407151,172356,13251,1856,428,20548,1463913,1463913,20976,1463913,29,87
NM,12276,337784,0,127,1928,379,759,180,197,5514,B,500,1928,485619,39620,407151,12276,1900,149,129,5750,350060,350060,5879,350060,3,26
NV,19733,264995,0,662,5109,196,759,78,197,727,A+,525,5109,341163,39620,407151,19733,1900,149,632,0,284728,284728,632,284728,14,0
NY,394954,3646639,0,878,89995,209,759,129,197,70698,A,24877,89995,485619,39620,407151,394954,1900,149,875,69070,4041593,4041593,69945,4041593,11,0
OH,54166,739140,0,724,8038,244,2035,116,197,38987,B,2903,8038,485619,39620,407151,50523,2653,250,1301,0,793306,793306,1301,793306,27,127
OK,14539,338511,0,368,1615,163,759,180,197,11048,A+,395,1615,355200,15918,338511,14539,1900,149,427,6310,353050,353050,6737,353050,6,62
OR,9294,241760,0,173,1069,52,759,25,197,2759,A+,209,1069,485619,39620,241760,8877,1900,149,363,7331,251054,251054,7694,251054,1,14
PA,88074,702199,0,631,5109,379,759,106,197,68697,A+,6712,5109,485619,39620,407151,85573,1900,149,832,12637,790273,790273,13469,790273,63,0
PR,7608,192686,0,97,5109,8,759,3,197,0,C,153,5109,194324,2627,191601,1767,59,94,71,0,200294,200294,71,200294,0,0
RI,17035,140048,0,67,2011,11,759,10,197,1644,A+,959,2011,258440,24383,234057,17035,1900,149,59,985,157083,157083,1044,157083,3,4
SC,39701,361700,0,1125,2854,379,759,180,197,15471,A,784,2854,401287,50746,350541,39587,777,7,1782,9747,401401,401401,11529,401401,18,0
SD,6893,75048,0,64,683,379,759,180,197,5982,B,97,683,485619,39620,407151,38775,1900,149,67,931,81941,81941,998,81941,4,9
TN,46890,791564,0,949,2775,379,759,180,197,28938,B,620,2775,838084,54471,783613,46520,594,26,1575,18993,838454,838454,20568,838454,11,60
TX,175977,1799826,0,7382,5109,379,759,180,197,90720,B,2525,5109,1975803,39620,407151,175977,1900,149,7915,45940,1975803,1975803,53855,1975803,44,0
UT,23270,323116,0,229,1505,81,430,180,190,13076,A+,176,1505,485619,39620,407151,23270,1900,149,554,2474,346386,346386,3028,346386,3,29
VA,63735,610521,343,888,9384,206,759,95,197,8496,A+,1816,9384,671560,39620,407151,61039,1712,104,532,15091,674599,674256,15623,674256,30,361
VI,92,2924,39,961,5109,379,759,180,197,75,C,6,5109,485619,39620,407151,38775,6,149,2,48,3055,3016,50,3016,0,0
VT,1227,66114,0,21,5109,379,759,180,197,960,B,56,5109,485619,39620,407151,1227,56,149,17,1032,67341,67341,1049,67341,0,0
WA,33435,538529,0,311,4402,379,759,57,197,0,B,1339,4402,485619,39620,407151,33435,1339,149,611,14078,571964,571964,14689,571964,7,41
WI,32809,563946,143,236,3519,74,763,180,197,23527,A+,800,3519,485619,39620,407151,29738,793,7,584,12339,596898,596755,12923,596755,7,37
WV,3053,175288,0,23,5109,10,759,5,197,2380,B,93,5109,485619,39620,407151,2949,1900,149,121,4868,178341,178341,4989,178341,0,0
WY,1550,33693,0,9,119,379,759,180,197,1139,B,20,119,47932,1342,46589,1233,1900,149,36,1508,35243,35243,1544,35243,0,2
AK,978,113422,0,20,5109,379,759,2,197,528,A,14,5109,114400,39620,407151,978,14,149,38,2177,114400,114400,2215,114400,0,0
AL,38962,374991,0,809,2803,379,814,180,464,18866,B,972,2803,485619,39620,407151,38442,947,25,917,6384,413953,413953,7301,413953,22,34
AR,21197,293661,0,275,1448,379,759,72,224,15163,A,277,1448,485619,39620,407151,21197,1900,149,420,3235,314858,314858,3655,314858,7,35
AS,0,696,0,961,5109,379,759,180,197,0,C,0,5109,485619,39620,407151,0,1900,149,0,0,696,696,0,696,0,0
AZ,84092,465504,0,2876,4837,675,759,466,197,9715,A+,1720,4837,549149,39620,407151,83645,1607,113,4877,12363,549596,549596,17240,549596,88,101
CA,236139,4018037,0,6612,5109,1859,759,180,197,0,B,6090,5109,4254176,39620,407151,236139,1900,149,7407,79630,4254176,4254176,87037,4254176,110,0
CO,32715,294788,0,237,5489,379,759,180,197,4502,A,1520,5489,485619,39620,407151,29844,1900,149,204,3442,327503,327503,3646,327503,12,47
CT,46572,443237,0,100,10268,379,759,180,197,8053,B,4324,10268,487323,39620,407151,44086,3457,867,58,11393,489809,489809,11451,489809,2,0
DC,10365,89670,0,119,5109,33,759,26,197,1451,A+,553,5109,485619,39620,407151,38775,1900,149,38,2702,100035,100035,2740,100035,2,0
DE,11510,99874,0,68,5109,13,759,180,197,6676,A+,509,5109,485619,39620,407151,10466,451,58,36,467,111384,111384,503,111384,0,0
FL,158997,1821357,2094,961,15125,379,759,180,197,0,A,3650,15125,2380131,203480,2172217,158997,3650,149,6563,28796,1982448,1980354,35359,1980354,46,246
GA,84237,770801,0,1570,11275,379,2357,180,197,0,A,2827,11275,855038,76664,778374,84237,1900,149,2946,18214,855038,855038,21160,855038,22,224
GU,267,13517,0,0,5109,379,759,180,197,179,B,5,5109,13411,259,13152,259,1900,149,8,461,13784,13784,469,13784,0,0
HI,917,78141,0,961,113,379,759,180,197,736,D,18,113,92225,39620,407151,38775,1900,149,17,1298,79058,79058,1315,79058,0,2
IA,29451,280339,0,149,5109,37,759,21,197,23607,A+,717,5109,485619,39620,407151,29451,1900,149,444,5158,309790,309790,5602,309790,2,0
ID,6117,84923,0,75,330,18,116,180,197,4233,A,92,330,90476,39620,407151,5553,72,20,365,1372,91040,91040,1737,91040,1,8
IL,145066,1492042,0,1511,5109,384,759,189,197,0,A,7152,5109,1636055,39620,407151,144013,6951,201,828,32262,1637108,1637108,33090,1637108,28,0
IN,45952,443764,0,668,7095,232,1483,103,197,35025,A+,2650,7095,485619,39620,407151,38775,2456,194,358,5162,489716,489716,5520,489716,10,30
KS,14990,168183,0,961,1152,379,367,180,152,834,A,272,1152,485619,39620,407151,38775,1900,149,547,5901,183173,183173,6448,183173,2,0
KY,15842,361248,0,427,2635,73,1007,180,197,4052,B,572,2635,485619,39620,407151,15286,568,4,218,5938,377090,377090,6156,377090,7,14
LA,60178,691910,0,799,5109,379,759,84,197,43026,B,3238,5109,485619,39620,407151,38775,3130,108,2083,21494,752088,752088,23577,752088,17,0
MA,109143,749292,0,760,11352,123,759,65,197,93157,A+,8081,11352,1079648,39620,407151,103858,7902,179,261,10033,858435,858435,10294,858435,27,15
MD,67918,474686,0,461,10902,154,759,180,197,5001,A,3205,10902,662266,39620,407151,67918,3077,128,359,6390,542604,542604,6749,542604,15,58
ME,3294,93947,0,29,351,8,759,3,197,2671,A,105,351,96869,3962,92770,2922,104,1,41,2248,97241,97241,2289,97241,0,3
MI,71089,990770,0,471,5109,179,759,103,197,51099,A+,6198,5109,1078989,88219,990770,64132,5951,247,361,16441,1061859,1061859,16802,1061859,5,0
MN,36716,580391,0,260,4081,125,1258,180,197,31947,A,1482,4081,617107,39620,407151,36716,1445,37,413,11378,617107,617107,11791,617107,6,27
MO,21927,367813,0,592,5109,379,759,75,197,0,B,1017,5109,424214,23527,399926,21927,1900,149,376,16357,389740,389740,16733,389740,2,0
MP,30,8187,0,961,5109,379,759,180,197,19,D,2,5109,8217,39620,407151,30,2,149,0,0,8217,8217,0,8217,0,0
MS,27900,265852,0,786,3177,160,759,85,197,19388,A,1082,3177,293562,39620,407151,27710,1064,18,653,5553,293752,293752,6206,293752,9,21
MT,1016,92314,0,14,105,379,759,180,197,658,C,22,105,485619,39620,407151,1016,1900,149,49,2420,93330,93330,2469,93330,0,4
NC,66513,875725,0,901,5109,379,759,180,197,45538,A,1373,5109,485619,39620,407151,66513,1373,149,1843,30362,942238,942238,32205,942238,30,0
ND,3615,103611,0,20,234,379,759,180,197,3210,D,78,234,184792,39620,407151,3615,69,9,39,1065,107226,107226,1104,107226,0,3
NE,19177,161431,0,120,1330,379,759,180,197,13737,B,274,1330,485619,39620,407151,19177,1900,149,135,2316,180608,180608,2451,180608,5,0
NH,5782,113387,0,37,565,379,162,180,197,4463,B,371,565,485619,39620,407151,5782,1900,149,22,849,119169,119169,871,119169,4,0
NJ,171928,1271009,0,1080,20054,217,759,178,197,30300,A+,15078,20054,485619,39620,407151,171928,13224,1854,261,20302,1442937,1442937,20563,1442937,43,207
NM,12147,332034,0,127,1902,379,759,180,197,5393,B,497,1902,485619,39620,407151,12147,1900,149,165,6296,344181,344181,6461,344181,4,26
NV,19101,264995,0,630,5109,142,759,74,197,714,A+,511,5109,331318,39620,407151,19101,1900,149,645,5883,284096,284096,6528,284096,4,0
NY,394079,3577569,0,879,89995,226,759,139,197,70590,A,24866,89995,485619,39620,407151,394079,1900,149,625,56085,3971648,3971648,56710,3971648,11,0
OH,52865,739140,0,724,7911,244,2008,116,197,0,B,2876,7911,485619,39620,407151,49263,2626,250,1076,3000,792005,792005,4076,792005,13,72
OK,14112,332201,0,374,1553,159,759,180,197,10605,A+,389,1553,348350,15387,332201,14112,1900,149,355,4361,346313,346313,4716,346313,2,33
OR,8931,234429,0,192,1055,62,759,24,197,2722,A+,208,1055,485619,39620,234429,8525,1900,149,275,5451,243360,243360,5726,243360,1,17
PA,87242,689562,0,632,5109,379,759,111,197,68048,A+,6649,5109,485619,39620,407151,84751,1900,149,636,11981,776804,776804,12617,776804,0,0
PR,7537,192686,0,121,5109,7,759,3,197,0,C,153,5109,194324,2627,191601,1729,59,94,72,0,200223,200223,72,200223,0,0
RI,16976,139063,0,69,2007,11,759,11,197,1638,A+,956,2007,255735,24284,231451,16976,1900,149,65,1891,156039,156039,1956,156039,6,6
SC,37919,351953,0,1160,2854,379,759,180,197,15471,A,766,2854,389762,48441,341321,37809,759,7,1520,7780,389872,389872,9300,389872,27,0
SD,6826,74117,0,65,674,379,759,180,197,5933,B,93,674,485619,39620,407151,38775,1900,149,62,793,80943,80943,855,80943,2,8
TN,45315,772571,0,955,2715,379,759,180,197,28283,B,609,2715,817522,52617,764905,44951,583,26,1806,22953,817886,817886,24759,817886,5,50
TX,168062,1753886,0,6904,5109,379,759,180,197,87556,B,2481,5109,1921948,39620,407151,168062,1900,149,8076,44590,1921948,1921948,52666,1921948,57,0
UT,22716,320642,0,261,1476,84,423,180,187,12707,A+,173,1476,485619,39620,407151,22716,1900,149,499,2106,343358,343358,2605,343358,1,32
VA,63203,595430,357,892,9023,205,759,95,197,8131,A+,1786,9023,655958,39620,407151,60528,1681,105,416,13183,658990,658633,13599,658633,23,41
VI,90,2876,6,961,5109,379,759,180,197,73,C,6,5109,485619,39620,407151,38775,6,149,6,57,2972,2966,63,2966,0,0
VT,1210,65082,0,17,5109,379,759,180,197,961,B,56,5109,485619,39620,407151,1210,56,149,2,526,66292,66292,528,66292,0,0
WA,32824,524451,0,288,4361,379,759,50,197,0,B,1332,4361,485619,39620,407151,32824,1332,149,571,8484,557275,557275,9055,557275,12,38
WI,32225,551607,147,237,3482,77,757,180,197,23089,A+,793,3482,485619,39620,407151,29199,786,7,563,12068,583979,583832,12631,583832,9,36
WV,2932,170420,0,23,5109,5,759,3,197,2284,B,93,5109,485619,39620,407151,2831,1900,149,27,1561,173352,173352,1588,173352,0,0
WY,1514,32185,0,9,117,379,759,180,197,1119,B,20,117,45310,1313,43996,1203,1900,149,27,0,33699,33699,27,33699,0,0
AK,940,111245,0,18,5109,379,759,1,197,526,A,14,5109,112185,39620,407151,940,14,149,36,3440,112185,112185,3476,112185,0,0
AL,38045,368607,0,775,2769,379,806,180,458,18866,B,950,2769,485619,39620,407151,37536,926,24,870,12489,406652,406652,13359,406652,21,44
AR,20777,290426,0,290,1413,379,759,67,220,14531,A,270,1413,485619,39620,407151,20777,1900,149,520,8147,311203,311203,8667,311203,5,33
AS,0,696,0,961,5109,379,759,180,197,0,C,0,5109,485619,39620,407151,0,1900,149,0,0,696,696,0,696,0,0
AZ,79215,453141,0,2793,4736,683,759,455,197,9411,A+,1632,4736,531922,39620,407151,78781,1529,103,4682,16251,532356,532356,20933,532356,44,102
CA,228732,3938407,0,6466,5109,1751,759,180,197,0,B,5980,5109,4167139,39620,407151,228732,1900,149,9480,95967,4167139,4167139,105447,4167139,44,0
CO,32511,291346,0,271,5442,379,759,180,197,4479,A,1508,5442,485619,39620,407151,29651,1900,149,204,4088,323857,323857,4292,323857,26,41
CT,46514,431844,0,98,10268,379,759,180,197,8053,B,4322,10268,475862,39620,407151,44018,3453,869,152,11384,478358,478358,11536,478358,2,0
DC,10327,86968,0,126,5109,33,759,22,197,1270,A+,551,5109,485619,39620,407151,38775,1900,149,35,1900,97295,97295,1935,97295,0,0
DE,11474,99407,0,64,5109,13,759,180,197,6667,A+,509,5109,485619,39620,407151,10430,451,58,98,852,110881,110881,950,110881,2,0
FL,152434,1792561,1904,961,14879,379,759,180,197,0,A,3604,14879,2337165,195894,2136944,152434,3604,149,6093,26159,1946899,1944995,32252,1944995,58,228
GA,81291,752587,0,1459,11051,379,2323,180,197,0,A,2805,11051,833878,74214,759664,81291,1900,149,1874,8887,833878,833878,10761,833878,21,227
GU,259,13056,0,0,5109,379,759,180,197,179,B,5,5109,13041,249,12792,251,1900,149,4,397,13315,13315,401,13315,0,0
HI,900,76843,0,961,111,379,759,180,197,722,D,18,111,90577,39620,407151,38775,1900,149,1,587,77743,77743,588,77743,0,0
IA,29007,275181,0,133,5109,34,759,20,197,23212,A+,715,5109,485619,39620,407151,29007,1900,149,225,3118,304188,304188,3343,304188,7,0
ID,5752,83551,0,60,322,18,114,180,197,4073,A,91,322,88763,39620,407151,5212,71,20,433,2525,89303,89303,2958,89303,0,10
IL,144238,1459780,0,1560,5109,401,759,185,197,0,A,7124,5109,1602965,39620,407151,143185,6923,201,724,30345,1604018,1604018,31069,1604018,21,0
IN,45594,438602,0,695,7065,272,1477,97,197,34646,A+,2640,7065,485619,39620,407151,38775,2448,192,366,7311,484196,484196,7677,484196,16,41
KS,14443,162282,0,961,1152,379,360,180,152,794,A,270,1152,485619,39620,407151,38775,1900,149,0,0,176725,176725,0,176725,0,0
KY,15624,355310,0,408,2621,75,1019,180,197,3990,B,565,2621,485619,39620,407151,15090,561,4,277,9216,370934,370934,9493,370934,5,19
LA,58095,670416,0,781,5109,379,759,83,197,42225,B,3221,5109,485619,39620,407151,38775,3113,108,1014,22860,728511,728511,23874,728511,22,0
MA,108882,739259,0,733,11337,120,759,63,197,93157,A+,8054,11337,1066060,39620,407151,103701,7874,180,114,5740,848141,848141,5854,848141,-41,-8
MD,67559,468296,0,452,10844,152,759,180,197,4982,A,3190,10844,652701,39620,407151,67559,3062,128,305,6237,535855,535855,6542,535855,15,22
ME,3253,91699,0,29,348,9,759,4,197,2646,A,105,348,94592,3924,90532,2893,104,1,34,1395,94952,94952,1429,94952,0,1
MI,70728,974329,0,471,5109,179,759,98,197,51099,A+,6193,5109,1062116,87787,974329,63870,5947,246,505,15177,1045057,1045057,15682,1045057,32,0
MN,36303,569013,0,270,4054,136,1258,180,197,31601,A,1476,4054,605316,39620,407151,36303,1441,35,442,11919,605316,605316,12361,605316,6,23
MO,21551,351456,0,599,5109,379,759,66,197,0,B,1015,5109,424214,23527,399926,21551,1900,149,508,5093,373007,373007,5601,373007,17,0
MP,30,8187,0,961,5109,379,759,180,197,19,D,2,5109,8217,39620,407151,30,2,149,0,0,8217,8217,0,8217,0,0
MS,27247,260299,0,779,3156,167,759,91,197,19388,A,1073,3156,287546,39620,407151,27067,1056,17,680,3344,287546,287546,4024,287546,14,41
MT,967,89894,0,12,101,379,759,180,197,642,C,22,101,485619,39620,407151,967,1900,149,48,2070,90861,90861,2118,90861,0,1
NC,64670,845363,0,908,5109,379,759,180,197,45538,A,1343,5109,485619,39620,407151,64670,1343,149,1186,22542,910033,910033,23728,910033,18,0
ND,3576,102546,0,25,231,379,759,180,197,3195,D,78,231,182283,39620,407151,3576,69,9,37,394,106122,106122,431,106122,1,4
NE,19042,159115,0,121,1330,379,759,180,197,13547,B,269,1330,485619,39620,407151,19042,1900,149,143,2742,178157,178157,2885,178157,2,14
NH,5760,112538,0,34,565,379,162,180,197,4435,B,367,565,485619,39620,407151,5760,1900,149,0,0,118298,118298,0,118298,0,0
NJ,171667,1250707,0,992,19847,211,759,174,197,30213,A+,15035,19847,485619,39620,407151,171667,13181,1854,395,17995,1422374,1422374,18390,1422374,43,0
NM,11982,325738,0,119,1876,379,759,180,197,5296,B,493,1876,485619,39620,407151,11982,1900,149,173,6499,337720,337720,6672,337720,1,11
NV,18456,259112,0,593,5109,134,759,65,197,689,A+,507,5109,322944,39620,407151,18456,1900,149,562,3989,277568,277568,4551,277568,3,0
NY,393454,3521484,0,891,89995,217,759,137,197,70487,A,24855,89995,485619,39620,407151,393454,1900,149,524,51501,3914938,3914938,52025,3914938,13,0
OH,51789,736140,0,722,7839,242,1994,115,197,0,B,2863,7839,485619,39620,407151,48222,2615,248,743,12804,787929,787929,13547,787929,45,93
OK,13757,327840,0,315,1520,111,759,180,197,10085,A+,387,1520,343623,15029,327840,13757,1900,149,585,14819,341597,341597,15404,341597,2,31
OR,8656,228978,0,149,1038,42,759,25,197,2722,A+,207,1038,485619,39620,228978,8265,1900,149,171,2330,237634,237634,2501,237634,3,13
PA,86606,677581,0,634,5109,379,759,110,197,67552,A+,6649,5109,485619,39620,407151,84130,1900,149,618,10680,764187,764187,11298,764187,35,0
PR,7465,192686,0,102,5109,9,759,2,197,0,C,153,5109,194324,2627,191601,1693,59,94,215,0,200151,200151,215,200151,0,0
RI,16911,137172,0,74,2001,13,759,13,197,1631,A+,950,2001,251636,24143,227493,16911,1900,149,40,974,154083,154083,1014,154083,4,6
SC,36399,344173,0,1021,2854,379,759,180,197,15471,A,739,2854,380470,46401,334069,36297,735,4,1755,9512,380572,380572,11267,380572,19,232
SD,6764,73324,0,62,666,379,759,180,197,5872,B,91,666,485619,39620,407151,38775,1900,149,48,583,80088,80088,631,80088,0,9
TN,43509,749618,0,886,2665,379,759,180,197,27599,B,604,2665,792779,50413,742366,43161,578,26,1212,14709,793127,793127,15921,793127,12,66
TX,159986,1709296,0,6533,5109,379,759,180,197,84818,B,2424,5109,1869282,39620,407151,159986,1900,149,6975,43118,1869282,1869282,50093,1869282,21,0
UT,22217,318536,0,250,1444,83,406,180,178,12398,A+,172,1444,485619,39620,407151,22217,1900,149,553,6295,340753,340753,6848,340753,4,27
VA,62787,582247,355,902,8982,230,759,98,197,8080,A+,1763,8982,642371,39620,407151,60124,1658,105,598,8064,645389,645034,8662,645034,23,159
VI,84,2819,4,961,5109,379,759,180,197,73,C,6,5109,485619,39620,407151,38775,6,149,3,73,2907,2903,76,2903,0,0
VT,1208,64556,0,16,5109,379,759,180,197,953,B,56,5109,485619,39620,407151,1208,56,149,0,771,65764,65764,771,65764,0,0
WA,32253,515967,0,282,4323,379,759,50,197,0,B,1320,4323,485619,39620,407151,32253,1320,149,501,13276,548220,548220,13777,548220,10,48
WI,31662,539539,169,242,3446,79,750,180,197,22587,A+,784,3446,485619,39620,407151,28659,777,7,629,12180,571370,571201,12809,571201,0,39
WV,2905,168859,0,27,5109,10,759,3,197,2272,B,93,5109,485619,39620,407151,2804,1900,149,35,2074,171764,171764,2109,171764,0,0
WY,1487,32185,0,6,117,379,759,180,197,1097,B,20,117,45310,1313,43996,1184,1900,149,37,1779,33672,33672,1816,33672,0,5
AK,904,107805,0,16,5109,379,759,1,197,525,A,14,5109,108709,39620,407151,904,14,149,21,388,108709,108709,409,108709,0,0
AL,37175,356118,0,726,2725,379,801,180,457,18866,B,929,2725,485619,39620,407151,36682,905,24,1734,5279,393293,393293,7013,393293,10,22
AR,20257,282279,0,300,1380,379,759,63,211,14066,A,265,1380,485619,39620,407151,20257,1900,149,947,10367,302536,302536,11314,302536,6,7
AS,0,696,0,961,5109,379,759,180,197,0,C,0,5109,485619,39620,407151,0,1900,149,0,0,696,696,0,696,0,0
AZ,74533,436890,0,2721,4634,679,759,465,197,9179,A+,1588,4634,511009,39620,407151,74119,1488,100,625,902,511423,511423,1527,511423,0,17
CA,219252,3842440,0,6179,5109,1686,759,180,197,0,B,5936,5109,4061692,39620,407151,219252,1900,149,8009,97731,4061692,4061692,105740,4061692,31,0
CO,32307,287258,0,234,5401,379,759,180,197,4459,A,1482,5401,485619,39620,407151,29476,1900,149,285,5569,319565,319565,5854,319565,0,2
CT,46362,420460,0,99,10268,379,759,180,197,8053,B,4320,10268,464414,39620,407151,43954,3451,869,59,21403,466822,466822,21462,466822,4,0
DC,10292,85068,0,121,5109,34,759,23,197,1200,A+,551,5109,485619,39620,407151,38775,1900,149,44,2184,95360,95360,2228,95360,1,0
DE,11376,98555,0,72,5109,15,759,180,197,6665,A+,507,5109,485619,39620,407151,10306,449,58,150,3435,109931,109931,3585,109931,0,0
FL,146341,1766402,1744,961,14651,379,759,180,197,0,A,3546,14651,2299430,189183,2106109,146341,3546,149,5266,25580,1914487,1912743,30846,1912743,28,111
GA,79417,743700,0,1359,10824,379,2289,180,197,0,A,2784,10824,823117,73044,750073,79417,1900,149,2207,13972,823117,823117,16179,823117,6,113
GU,255,12659,0,0,5109,379,759,180,197,179,B,5,5109,12841,245,12596,247,1900,149,7,529,12914,12914,536,12914,0,0
HI,899,76256,0,961,111,379,759,180,197,719,D,18,111,89866,39620,407151,38775,1900,149,27,1650,77155,77155,1677,77155,0,1
IA,28782,272063,0,119,5109,35,759,18,197,17851,A+,708,5109,485619,39620,407151,28782,1900,149,293,4637,300845,300845,4930,300845,3,0
ID,5319,81026,0,50,312,17,111,180,197,3898,A,91,312,85816,39620,407151,4790,71,20,0,0,86345,86345,0,86345,0,0
IL,143514,1429435,0,1501,5109,372,759,187,197,0,A,7103,5109,1571896,39620,407151,142461,6902,201,738,26180,1572949,1572949,26918,1572949,14,0
IN,45228,431291,0,626,7024,265,1469,85,197,34348,A+,2624,7024,485619,39620,407151,38775,2432,192,298,5686,476519,476519,5984,476519,5,21
KS,14443,162282,0,961,1152,379,360,180,152,794,A,270,1152,485619,39620,407151,38775,1900,149,905,7961,176725,176725,8866,176725,6,24
KY,15347,346094,0,381,2602,69,999,180,197,3939,B,560,2602,485619,39620,407151,14835,557,3,115,2835,361441,361441,2950,361441,2,12
LA,57081,647556,0,737,5109,379,759,79,197,42225,B,3199,5109,485619,39620,407151,38775,3091,108,845,7681,704637,704637,8526,704637,0,0
MA,108768,733519,0,762,11345,138,759,79,197,93157,A+,8095,11345,1057932,39620,407151,103628,7895,200,101,6392,842287,842287,6493,842287,35,26
MD,67254,462059,0,447,10822,160,759,180,197,4979,A,3175,10822,644026,39620,407151,67254,3048,127,477,9363,529313,529313,9840,529313,7,29
ME,3219,90304,0,31,347,8,759,4,197,2623,A,105,347,93142,3884,89123,2863,104,1,28,0,93523,93523,28,93523,1,1
MI,70223,959152,0,557,5109,193,759,106,197,51099,A+,6161,5109,1046545,87393,959152,63497,5915,246,277,12419,1029375,1029375,12696,1029375,3,0
MN,35861,557094,0,278,4031,140,1249,180,197,31225,A,1470,4031,592955,39620,407151,35861,1435,35,312,7226,592955,592955,7538,592955,10,21
MO,21043,346363,0,599,5109,379,759,180,197,0,B,998,5109,424214,23527,399926,21043,1900,149,468,5765,367406,367406,6233,367406,1,0
MP,30,8187,0,961,5109,379,759,180,197,19,D,2,5109,8217,39620,407151,30,2,149,0,0,8217,8217,0,8217,0,0
MS,26567,256955,0,719,3115,158,759,93,197,19388,A,1059,3115,283355,39620,407151,26400,1042,17,675,2659,283522,283522,3334,283522,20,13
MT,919,87824,0,13,100,379,759,180,197,609,C,22,100,485619,39620,407151,919,1900,149,56,6213,88743,88743,6269,88743,0,3
NC,63484,822821,0,843,5109,379,759,180,197,45538,A,1325,5109,485619,39620,407151,63484,1325,149,1342,13058,886305,886305,14400,886305,3,0
ND,3539,102152,0,25,227,379,759,180,197,3163,D,77,227,180558,39620,407151,3539,68,9,44,1722,105691,105691,1766,105691,0,1
NE,18899,156373,0,117,1316,379,759,180,197,13322,B,267,1316,485619,39620,407151,18899,1900,149,124,2350,175272,175272,2474,175272,0,1
NH,5760,112538,0,34,565,379,162,180,197,4435,B,367,565,485619,39620,407151,5760,1900,149,43,2146,118298,118298,2189,118298,0,3
NJ,171272,1232712,0,978,19847,225,759,185,197,30163,A+,14992,19847,485619,39620,407151,171272,13138,1854,90,16061,1403984,1403984,16151,1403984,17,6
NM,11809,319239,0,114,1865,379,759,180,197,5264,B,492,1865,485619,39620,407151,11809,1900,149,190,7899,331048,331048,8089,331048,1,14
NV,17894,255123,0,555,5109,124,759,65,197,689,A+,504,5109,314388,39620,407151,17894,1900,149,734,4703,273017,273017,5437,273017,4,0
NY,392930,3469983,0,853,89995,216,759,136,197,70435,A,24842,89995,485619,39620,407151,392930,1900,149,391,46037,3862913,3862913,46428,3862913,7,0
OH,51046,723336,0,669,7746,245,1961,115,197,0,B,2818,7746,485619,39620,407151,47524,2575,243,737,16880,774382,774382,17617,774382,11,65
OK,13172,313021,0,329,1489,134,759,180,197,9587,A+,385,1489,327683,13941,313021,13172,1900,149,228,0,326193,326193,228,326193,0,33
OR,8485,226648,0,151,1025,44,759,25,197,2700,A+,204,1025,485619,39620,226648,8121,1900,149,144,7119,235133,235133,7263,235133,2,3
PA,85988,666901,0,635,5109,379,759,111,197,67070,A+,6614,5109,485619,39620,407151,83529,1900,149,492,9415,752889,752889,9907,752889,35,0
PR,7250,192686,0,104,5109,8,759,1,197,0,C,153,5109,194324,2627,191601,1638,59,94,61,79406,199936,199936,79467,199936,0,0
RI,16871,136198,0,73,1995,15,759,14,197,1627,A+,946,1995,249696,24084,225612,16871,1900,149,36,1320,153069,153069,1356,153069,19,11
SC,34644,334661,0,1032,2622,379,759,180,197,13456,A,720,2622,369207,44241,324966,34546,717,3,1324,8179,369305,369305,9503,369305,4,0
SD,6716,72741,0,70,657,379,759,180,197,5818,B,91,657,485619,39620,407151,38775,1900,149,35,529,79457,79457,564,79457,0,5
TN,42297,734909,0,839,2599,379,759,180,197,26962,B,592,2599,776858,48873,727985,41949,568,24,2125,26528,777206,777206,28653,777206,8,35
TX,153011,1666178,0,5913,5109,379,759,180,197,81335,B,2403,5109,1819189,39620,407151,153011,1900,149,4283,39687,1819189,1819189,43970,1819189,10,0
UT,21664,312241,0,254,1417,80,394,180,170,12205,A+,168,1417,485619,39620,407151,21664,1900,149,564,4892,333905,333905,5456,333905,1,21
VA,62189,574183,261,796,8823,225,759,101,197,8023,A+,1740,8823,633705,39620,407151,59522,1635,105,453,7591,636633,636372,8044,636372,8,0
VI,81,2746,31,961,5109,379,759,180,197,71,C,6,5109,485619,39620,407151,38775,6,149,0,0,2858,2827,0,2827,0,0
VT,1208,63785,0,13,5109,379,759,180,197,949,B,56,5109,485619,39620,407151,1208,56,149,6,1122,64993,64993,1128,64993,0,0
WA,31752,502691,0,270,4275,379,759,52,197,0,B,1310,4275,485619,39620,407151,31752,1310,149,348,8293,534443,534443,8641,534443,0,35
WI,31033,527359,158,237,3407,90,747,180,197,22217,A+,784,3407,485619,39620,407151,28058,777,7,326,5612,558550,558392,5938,558392,7,14
WV,2870,166785,0,28,5109,5,759,3,197,2196,B,93,5109,485619,39620,407151,2771,1900,149,53,3094,169655,169655,3147,169655,0,0
WY,1450,30406,0,7,112,379,759,180,197,1070,B,20,112,42402,1229,41172,1151,1900,149,33,0,31856,31856,33,31856,0,0
AK,883,107417,0,12,5109,379,759,1,197,521,A,14,5109,108300,39620,407151,883,14,149,29,2690,108300,108300,2719,108300,0,0
AL,35441,350839,0,650,2703,379,790,180,454,18866,B,919,2703,485619,39620,407151,34964,898,21,358,1896,386280,386280,2254,386280,0,6
AR,19310,271912,0,278,1373,379,759,63,210,13270,A,259,1373,485619,39620,407151,19310,1900,149,570,6687,291222,291222,7257,291222,10,36
AS,0,696,0,961,5109,379,759,180,197,0,C,0,5109,485619,39620,407151,0,1900,149,0,0,696,696,0,696,0,0
AZ,73908,435988,0,2691,4617,666,759,475,197,8926,A+,1588,4617,509485,39620,407151,73497,1488,100,3857,11292,509896,509896,15149,509896,9,22
CA,211243,3744709,0,5956,5109,1602,759,180,197,0,B,5905,5109,3955952,39620,407151,211243,1900,149,4810,88832,3955952,3955952,93642,3955952,33,0
CO,32022,281689,0,235,5399,379,759,180,197,4442,A,1482,5399,485619,39620,407151,29194,1900,149,226,5902,313711,313711,6128,313711,0,7
CT,46303,399057,0,103,10268,379,759,180,197,8053,B,4316,10268,442998,39620,407151,43941,3448,868,97,6233,445360,445360,6330,445360,5,0
DC,10248,82884,0,126,5109,34,759,27,197,1199,A+,550,5109,485619,39620,407151,38775,1900,149,32,3829,93132,93132,3861,93132,2,0
DE,11226,95120,0,78,5109,14,759,180,197,6665,A+,507,5109,485619,39620,407151,10162,449,58,135,1949,106346,106346,2084,106346,0,0
FL,141075,1740822,1726,961,14540,379,759,180,197,0,A,3518,14540,2256314,182100,2070179,141075,3518,149,8530,43842,1883623,1881897,52372,1881897,29,108
GA,77210,729728,0,1236,10711,379,2268,180,197,0,A,2778,10711,806938,70881,736057,77210,1900,149,2225,14900,806938,806938,17125,806938,2,22
GU,248,12130,0,1,5109,379,759,180,197,179,B,5,5109,11523,239,11284,240,1900,149,0,227,12378,12378,227,12378,0,0
HI,872,74606,0,961,110,379,759,180,197,714,D,18,110,87882,39620,407151,38775,1900,149,6,1171,75478,75478,1177,75478,1,1
IA,28489,267426,0,118,5109,36,759,18,197,17620,A+,705,5109,485619,39620,407151,28489,1900,149,477,5686,295915,295915,6163,295915,1,0
ID,5319,81026,0,48,312,18,111,180,197,3898,A,91,312,85816,39620,407151,4790,71,20,171,2118,86345,86345,2289,86345,1,3
IL,142776,1403255,0,1464,5109,373,759,193,197,0,A,7089,5109,1544978,39620,407151,141723,6888,201,646,23143,1546031,1546031,23789,1546031,15,0
IN,44930,425605,0,617,7003,266,1468,86,197,33935,A+,2619,7003,485619,39620,407151,38775,2427,192,355,7163,470535,470535,7518,470535,3,21
KS,13538,154321,0,961,1128,379,356,180,152,779,A,264,1128,485619,39620,407151,38775,1900,149,0,0,167859,167859,0,167859,0,0
KY,15232,343259,0,386,2590,68,996,180,197,3730,B,558,2590,485619,39620,407151,14732,555,3,373,7364,358491,358491,7737,358491,5,1
LA,56236,639875,0,715,5109,379,759,76,197,39792,B,3199,5109,485619,39620,407151,38775,3086,113,1467,16638,696111,696111,18105,696111,9,0
MA,108667,727127,0,748,11319,134,759,81,197,93157,A+,8060,11319,1048942,39620,407151,103539,7860,200,224,9228,835794,835794,9452,835794,19,9
MD,66777,452696,0,446,10793,158,759,180,197,4976,A,3168,10793,631490,39620,407151,66777,3042,126,327,5330,519473,519473,5657,519473,11,42
ME,3191,90304,0,31,346,10,759,4,197,2577,A,104,346,93142,3884,89123,2838,103,1,37,1526,93495,93495,1563,93495,0,1
MI,69946,946733,0,557,5109,193,759,106,197,51099,A+,6158,5109,1033820,87087,946733,63261,5912,246,267,15591,1016679,1016679,15858,1016679,5,0
MN,35549,549868,0,288,4010,143,1241,180,197,30809,A,1460,4010,585417,39620,407151,35549,1425,35,516,15994,585417,585417,16510,585417,8,24
MO,20575,340598,0,412,5109,379,759,180,197,0,B,997,5109,424214,23527,399926,20575,1900,149,314,5569,361173,361173,5883,361173,1,0
MP,30,8187,0,961,5109,379,759,180,197,19,D,2,5109,8217,39620,407151,30,2,149,0,0,8217,8217,0,8217,0,0
MS,25892,254296,0,676,3102,149,759,88,197,17242,A,1039,3102,280020,39620,407151,25724,1022,17,361,2506,280188,280188,2867,280188,4,24
MT,863,81611,0,11,97,379,759,180,197,604,C,22,97,485619,39620,407151,863,1900,149,11,1216,82474,82474,1227,82474,0,2
NC,62142,809763,0,890,5109,379,759,180,197,36921,A,1322,5109,485619,39620,407151,62142,1322,149,1605,15169,871905,871905,16774,871905,10,0
ND,3495,100430,0,24,226,379,759,180,197,3139,D,77,226,177229,39620,407151,3495,68,9,37,1369,103925,103925,1406,103925,0,1
NE,18775,154023,0,123,1315,379,759,180,197,13053,B,267,1315,485619,39620,407151,18775,1900,149,251,3949,172798,172798,4200,172798,1,3
NH,5717,110392,0,35,562,379,162,180,197,4401,B,367,562,485619,39620,407151,5717,1900,149,46,1295,116109,116109,1341,116109,2,1
NJ,171182,1216651,0,1014,19841,223,759,187,197,30092,A+,14975,19841,485619,39620,407151,171182,13121,1854,309,20274,1387833,1387833,20583,1387833,27,18
NM,11619,311340,0,122,1851,379,759,180,197,5251,B,491,1851,485619,39620,407151,11619,1900,149,211,2110,322959,322959,2321,322959,2,23
NV,17160,250420,0,511,5109,122,759,59,197,684,A+,500,5109,307131,39620,407151,17160,1900,149,821,3733,267580,267580,4554,267580,0,0
NY,392539,3423946,0,869,89995,229,759,167,197,70010,A,24835,89995,485619,39620,407151,392539,1900,149,616,61290,3816485,3816485,61906,3816485,5,0
OH,50309,706456,0,661,7681,182,1946,101,197,0,B,2807,7681,485619,39620,407151,46790,2564,243,854,11072,756765,756765,11926,756765,3,57
OK,12944,313021,0,329,1456,134,759,180,197,9397,A+,385,1456,327683,13941,313021,12944,1900,149,302,0,325965,325965,302,325965,1,16
OR,8341,219529,0,149,1022,53,759,35,197,2649,A+,202,1022,485619,39620,223317,7521,1900,149,247,0,227870,227870,247,227870,0,0
PA,85496,657486,0,648,5109,379,759,121,197,66686,A+,6579,5109,485619,39620,407151,81956,1900,149,1126,22775,742982,742982,23901,742982,0,0
PR,7189,113280,0,99,5109,8,759,5,197,0,C,153,5109,114723,2326,112331,1624,59,94,123,0,120469,120469,123,120469,1,0
RI,16835,134878,0,91,1984,16,759,15,197,1600,A+,927,1984,245990,23998,221992,16835,1900,149,22,578,151713,151713,600,151713,0,0
SC,33320,326482,0,954,2622,379,759,180,197,13456,A,716,2622,359703,42618,317085,33221,712,4,1381,7257,359802,359802,8638,359802,5,0
SD,6681,72212,0,75,652,379,759,180,197,5752,B,91,652,485619,39620,407151,38775,1900,149,55,738,78893,78893,793,78893,0,7
TN,40172,708381,0,800,2564,379,759,180,197,26159,B,584,2564,748229,46468,701761,39848,560,24,0,0,748553,748553,0,748553,0,0
TX,148728,1626491,0,5497,5109,379,759,180,197,79974,B,2393,5109,1775219,39620,407151,148728,1900,149,5357,47036,1775219,1775219,52393,1775219,27,0
UT,21100,307349,0,289,1396,83,389,180,167,11931,A+,167,1396,485619,39620,407151,21100,1900,149,472,5175,328449,328449,5647,328449,0,31
VA,61736,566592,295,818,8823,235,759,107,197,8005,A+,1732,8823,625663,39620,407151,59071,1628,104,489,9913,628623,628328,10402,628328,8,36
VI,81,2746,31,961,5109,379,759,180,197,71,C,6,5109,485619,39620,407151,38775,6,149,0,0,2858,2827,0,2827,0,0
VT,1202,62663,0,15,5109,379,759,180,197,946,B,56,5109,485619,39620,407151,1202,56,149,2,1140,63865,63865,1142,63865,0,0
WA,31404,494398,0,304,4240,379,759,58,197,0,B,1310,4240,485619,39620,407151,31404,1310,149,549,10825,525802,525802,11374,525802,6,46
WI,30707,521747,146,239,3393,89,746,180,197,21953,A+,777,3393,485619,39620,407151,27743,777,149,480,6024,552600,552454,6504,552454,0,11
WV,2817,163691,0,32,5109,10,759,4,197,2062,B,93,5109,485619,39620,407151,2723,1900,149,56,1797,166508,166508,1853,166508,0,0
WY,1417,30406,0,5,112,379,759,180,197,1057,B,20,112,42402,1229,41172,1121,1900,149,25,0,31823,31823,25,31823,0,1
AK,854,104727,0,11,5109,379,759,1,197,521,A,14,5109,105581,39620,407151,854,14,149,18,3771,105581,105581,3789,105581,0,0
AL,35083,348943,0,655,2697,379,789,180,453,18866,B,919,2697,485619,39620,407151,34605,898,21,900,4803,384026,384026,5703,384026,12,44
AR,18740,265225,0,284,1337,379,759,63,206,12784,A,249,1337,485619,39620,407151,18740,1900,149,678,5907,283965,283965,6585,283965,9,37
AS,0,696,0,961,5109,379,759,180,197,0,C,0,5109,485619,39620,407151,0,1900,149,0,0,696,696,0,696,0,0
AZ,70051,424696,0,2577,4595,657,759,433,197,8659,A+,1579,4595,494337,39620,407151,69641,1479,100,3503,11421,494747,494747,14924,494747,44,81
CA,206433,3655877,0,5790,5109,1562,759,180,197,0,B,5872,5109,3862310,39620,407151,206433,1900,149,5972,85024,3862310,3862310,90996,3862310,60,0
CO,31796,275787,0,226,5392,379,759,180,197,4430,A,1482,5392,485619,39620,407151,28972,1900,149,317,4689,307583,307583,5006,307583,7,6
CT,46206,392824,0,106,10268,379,759,180,197,8053,B,4311,10268,436644,39620,407151,43820,3443,868,147,9059,439030,439030,9206,439030,4,0
DC,10216,79055,0,136,5109,43,759,26,197,1194,A+,548,5109,485619,39620,407151,38775,1900,149,31,1117,89271,89271,1148,89271,2,0
DE,11091,93171,0,83,5109,15,759,180,197,6665,A+,507,5109,485619,39620,407151,10047,449,58,74,2088,104262,104262,2162,104262,0,0
FL,132545,1696980,1731,961,14432,379,759,180,197,0,A,3489,14432,2186400,171768,2010839,132545,3489,149,9585,51055,1831256,1829525,60640,1829525,25,151
GA,74985,714828,0,1178,10689,379,2261,180,197,0,A,2776,10689,789813,68568,721245,74985,1900,149,1990,16795,789813,789813,18785,789813,6,84
GU,248,11903,0,1,5109,379,759,180,197,179,B,5,5109,11523,239,11284,240,1900,149,0,259,12151,12151,259,12151,0,0
HI,866,73435,0,961,109,379,759,180,197,705,D,17,109,86464,39620,407151,38775,1900,149,16,1280,74301,74301,1296,74301,0,0
IA,28012,261740,0,131,5109,40,759,22,197,17467,A+,704,5109,485619,39620,407151,28012,1900,149,326,5783,289752,289752,6109,289752,0,0
ID,5148,78908,0,42,309,19,108,180,197,3827,A,90,309,83537,39620,407151,4629,70,20,283,1403,84056,84056,1686,84056,0,6
IL,142130,1380112,0,1516,5109,400,759,225,197,0,A,7074,5109,1521189,39620,407151,141077,6873,201,786,29451,1522242,1522242,30237,1522242,26,0
IN,44575,418442,0,595,6982,257,1461,82,197,33725,A+,2616,6982,485619,39620,407151,38775,2424,192,435,8692,463017,463017,9127,463017,21,38
KS,13538,154321,0,961,1128,379,356,180,152,779,A,264,1128,485619,39620,407151,38775,1900,149,0,0,167859,167859,0,167859,0,0
KY,14859,335895,0,387,2589,74,996,180,197,3730,B,553,2589,485619,39620,407151,14401,550,3,0,0,350754,350754,0,350754,0,0
LA,54769,623237,0,700,5109,379,759,73,197,39792,B,3190,5109,485619,39620,407151,38775,3077,113,0,0,678006,678006,0,678006,0,0
MA,108443,717899,0,769,11310,143,759,90,197,93157,A+,8041,11310,1036832,39620,407151,103376,7841,200,373,11884,826342,826342,12257,826342,28,19
MD,66450,447366,0,478,10751,181,759,180,197,4935,A,3157,10751,623927,39620,407151,66450,3030,127,335,7084,513816,513816,7419,513816,15,26
ME,3154,88778,0,24,345,7,759,5,197,2566,A,104,345,91587,3848,87604,2809,103,1,52,2026,91932,91932,2078,91932,1,2
MI,69679,931142,0,557,5109,193,759,106,197,51099,A+,6153,5109,1017855,86713,931142,63009,5907,246,350,18765,1000821,1000821,19115,1000821,19,0
MN,35033,533874,0,300,3986,155,1233,180,197,30401,A,1452,3986,568907,39620,407151,35033,1417,35,417,11212,568907,568907,11629,568907,6,20
MO,20261,335029,0,680,5109,379,759,66,197,0,B,996,5109,424214,23527,399926,20261,1900,149,347,6325,355290,355290,6672,355290,6,0
MP,30,8187,0,961,5109,379,759,180,197,19,D,2,5109,8217,39620,407151,30,2,149,0,0,8217,8217,0,8217,0,0
MS,25531,251790,0,731,3078,169,759,90,197,17242,A,1035,3078,277158,39620,407151,25368,1018,17,465,4962,277321,277321,5427,277321,13,34
MT,852,80395,0,9,95,379,759,180,197,604,C,22,95,485619,39620,407151,852,1900,149,23,1063,81247,81247,1086,81247,0,0
NC,60537,794594,0,888,5109,379,759,180,197,36921,A,1312,5109,485619,39620,407151,60537,1312,149,1719,16687,855131,855131,18406,855131,9,0
ND,3458,99061,0,23,225,379,759,180,197,3119,D,77,225,173999,39620,407151,3458,68,9,37,1596,102519,102519,1633,102519,0,3
NE,18524,150074,0,125,1312,379,759,180,197,12698,B,266,1312,485619,39620,407151,18524,1900,149,178,3418,168598,168598,3596,168598,6,18
NH,5671,109097,0,32,561,379,161,180,197,4381,B,365,561,485619,39620,407151,5671,1900,149,0,0,114768,114768,0,114768,0,0
NJ,170873,1196377,0,1103,19823,236,759,200,197,29967,A+,14948,19823,485619,39620,407151,170873,13094,1854,289,20289,1367250,1367250,20578,1367250,34,71
NM,11408,309230,0,128,1828,379,759,180,197,5149,B,489,1828,485619,39620,407151,11408,1900,149,216,5752,320638,320638,5968,320638,4,17
NV,16339,246687,0,503,5109,117,759,66,197,684,A+,500,5109,301815,39620,407151,16339,1900,149,1099,3265,263026,263026,4364,263026,2,0
NY,391923,3362656,0,908,89995,230,759,167,197,70010,A,24830,89995,485619,39620,407151,391923,1900,149,703,72559,3754579,3754579,73262,3754579,16,0
OH,49455,695384,0,561,7624,190,1916,106,197,0,B,2804,7624,485619,39620,407151,45969,2561,243,817,22470,744839,744839,23287,744839,16,54
OK,12642,313021,0,329,1440,134,759,180,197,9155,A+,384,1440,327683,13941,313021,12642,1900,149,299,14587,325663,325663,14886,325663,7,47
OR,8094,219529,0,149,1022,53,759,35,197,2649,A+,202,1022,485619,39620,407151,7521,1900,149,276,10479,227623,227623,10755,227623,0,0
PA,84370,634711,0,651,5109,379,759,126,197,65808,A+,6579,5109,485619,39620,407151,81956,1900,149,0,0,719081,719081,0,719081,0,0
PR,7066,113280,0,105,5109,10,759,5,197,0,C,152,5109,114723,2326,112331,1602,58,94,144,0,120346,120346,144,120346,1,0
RI,16813,134300,0,91,1984,16,759,15,197,1600,A+,927,1984,244518,23961,220557,16813,1900,149,36,1198,151113,151113,1234,151113,0,0
SC,31939,319225,0,908,2622,379,759,180,197,13456,A,711,2622,351075,40970,310105,31850,707,4,1604,14889,351164,351164,16493,351164,17,0
SD,6626,71474,0,73,645,379,759,180,197,5717,B,91,645,485619,39620,407151,38775,1900,149,91,994,78100,78100,1085,78100,3,6
TN,40172,708381,0,705,2564,379,759,180,197,26159,B,584,2564,748229,46468,701761,39848,560,24,728,5793,748553,748553,6521,748553,7,66
TX,143371,1579455,0,5523,5109,379,759,180,197,78248,B,2366,5109,1722826,39620,407151,143371,1900,149,5747,19745,1722826,1722826,25492,1722826,42,0
UT,20628,302174,0,287,1365,77,388,180,166,11658,A+,167,1365,485619,39620,407151,20628,1900,149,578,4656,322802,322802,5234,322802,1,44
VA,61247,556679,284,819,8787,234,759,103,197,7968,A+,1724,8787,615290,39620,407151,58611,1620,104,677,10786,618210,617926,11463,617926,24,65
VI,81,2746,31,961,5109,379,759,180,197,71,C,6,5109,485619,39620,407151,38775,6,149,0,41,2858,2827,41,2827,0,0
VT,1200,61523,0,14,5109,379,759,180,197,946,B,56,5109,485619,39620,407151,1200,56,149,2,1132,62723,62723,1134,62723,0,0
WA,30855,483573,0,305,4194,379,759,50,197,0,B,1304,4194,485619,39620,407151,30855,1304,149,488,8145,514428,514428,8633,514428,4,88
WI,30227,515723,140,249,3382,93,746,180,197,21606,A+,777,3382,485619,39620,407151,27286,777,149,559,8555,546090,545950,9114,545950,11,31
WV,2761,161894,0,33,5109,10,759,4,197,2042,B,93,5109,485619,39620,407151,2699,1900,149,49,2649,164655,164655,2698,164655,1,0
WY,1392,30406,0,5,111,379,759,180,197,1054,B,20,111,42402,1229,41172,1097,1900,149,24,0,31798,31798,24,31798,0,-1
AK,836,100956,0,12,5109,379,759,2,197,519,A,14,5109,101792,39620,407151,836,14,149,20,2320,101792,101792,2340,101792,2,0
AL,34183,344140,0,668,2653,379,772,180,450,18866,B,907,2653,485619,39620,407151,33717,887,20,977,7888,378323,378323,8865,378323,11,41
AR,18062,259318,0,284,1300,379,759,61,203,12127,A,240,1300,485619,39620,407151,18740,1900,149,0,0,277380,277380,0,277380,0,55
AS,0,696,0,961,5109,379,759,180,197,0,C,0,5109,485619,39620,407151,0,1900,149,0,0,696,696,0,696,0,0
AZ,66548,413275,0,2110,4514,581,759,312,197,8389,A+,1535,4514,479330,39620,407151,66055,1435,100,3518,12109,479823,479823,15627,479823,45,108
CA,200461,3570853,0,5639,5109,1570,759,180,197,0,B,5812,5109,3771314,39620,407151,200461,1900,149,4890,72079,3771314,3771314,76969,3771314,79,0
CO,31479,271098,0,247,5386,379,759,180,197,4412,A,1475,5386,485619,39620,407151,28674,1900,149,324,6188,302577,302577,6512,302577,18,11
CT,46059,383765,0,127,10268,379,759,180,197,8053,B,4307,10268,427567,39620,407151,43802,3440,867,65,12639,429824,429824,12704,429824,9,0
DC,10185,77938,0,147,5109,48,759,29,197,1186,A+,546,5109,485619,39620,407151,38775,1900,149,26,1366,88123,88123,1392,88123,3,0
DE,11017,91083,0,78,5109,379,759,180,197,6661,A,507,5109,485619,39620,407151,9972,449,58,37,1071,102100,102100,1108,102100,0,0
FL,122960,1645925,1752,961,14281,379,759,180,197,0,A,3464,14281,2107048,159793,1943604,122960,3464,149,8942,39299,1770637,1768885,48241,1768885,41,213
GA,72995,698033,0,1184,10605,379,2244,180,197,0,A,2770,10605,771028,66510,704518,72995,1900,149,1900,11204,771028,771028,13104,771028,25,148
GU,248,11644,0,1,5109,379,759,180,197,179,B,5,5109,11523,239,11284,240,1900,149,3,471,11892,11892,474,11892,0,0
HI,850,72155,0,961,109,379,759,180,197,696,D,17,109,84910,39620,407151,38775,1900,149,15,1055,73005,73005,1070,73005,0,4
IA,27686,255957,0,141,5109,42,759,24,197,17313,A+,704,5109,485619,39620,407151,27686,1900,149,489,6100,283643,283643,6589,283643,9,0
ID,4865,77505,0,48,303,20,106,180,197,3712,A,90,303,81871,39620,407151,4366,70,20,220,1611,82370,82370,1831,82370,0,3
IL,141344,1350661,0,1516,5109,400,759,225,197,0,A,7048,5109,1490952,39620,407151,140291,6847,201,910,29568,1492005,1492005,30478,1492005,34,0
IN,44140,409750,0,692,6944,281,1458,94,197,33396,A+,2595,6944,485619,39620,407151,38775,2403,192,485,9153,453890,453890,9638,453890,9,32
KS,13538,154321,0,961,1128,379,356,180,152,779,A,264,1128,485619,39620,407151,38775,1900,149,568,5586,167859,167859,6154,167859,3,46
KY,14859,335895,0,387,2589,74,996,180,197,3730,B,553,2589,485619,39620,407151,14401,550,3,242,7630,350754,350754,7872,350754,7,5
LA,54769,623237,0,700,5109,379,759,73,197,39792,B,3190,5109,485619,39620,407151,38775,3077,113,1354,15987,678006,678006,17341,678006,26,0
MA,108070,706015,0,791,11291,156,759,99,197,93157,A+,8013,11291,1020867,39620,407151,103071,7815,198,233,8396,814085,814085,8629,814085,50,39
MD,66115,440282,0,487,10725,190,759,180,197,4903,A,3142,10725,613513,39620,407151,66115,3015,127,338,7100,506397,506397,7438,506397,13,42
ME,3102,86752,0,28,343,9,759,6,197,2542,A,103,343,89510,3787,85592,2758,102,1,32,2224,89854,89854,2256,89854,0,0
MI,69329,912377,0,557,5109,193,759,106,197,49290,A+,6134,5109,998490,86113,912377,62695,5888,246,340,18527,981706,981706,18867,981706,1,0
MN,34616,522662,0,335,3966,157,1221,180,197,30008,A,1446,3966,557278,39620,407151,34616,1411,35,493,14089,557278,557278,14582,557278,5,23
MO,19914,328704,0,600,5109,379,759,66,197,0,B,990,5109,424214,23527,399926,19914,1900,149,493,6477,348618,348618,6970,348618,8,0
MP,30,8187,0,961,5109,379,759,180,197,19,D,2,5109,8217,39620,407151,30,2,149,0,0,8217,8217,0,8217,0,0
MS,25066,246828,0,769,3044,153,759,90,197,17242,A,1022,3044,271734,39620,407151,24906,1005,17,550,5347,271894,271894,5897,271894,6,46
MT,829,79332,0,14,95,379,759,180,197,589,C,22,95,485619,39620,407151,829,1900,149,26,1803,80161,80161,1829,80161,1,2
NC,58818,777907,0,892,5109,379,759,180,197,36921,A,1303,5109,485619,39620,407151,58818,1303,149,1635,23812,836725,836725,25447,836725,19,0
ND,3421,97465,0,23,222,379,759,180,197,3090,D,77,222,169838,39620,407151,3421,68,9,28,1414,100886,100886,1442,100886,1,0
NE,18346,146656,0,126,1294,379,759,180,197,12314,B,260,1294,485619,39620,407151,18346,1900,149,125,1707,165002,165002,1832,165002,3,26
NH,5671,109097,0,32,561,379,161,180,197,4381,B,365,561,485619,39620,407151,5671,1900,149,73,3129,114768,114768,3202,114768,18,3
NJ,170584,1176088,0,1118,19752,234,759,206,197,29855,A+,14914,19752,485619,39620,407151,170584,13060,1854,388,25374,1346672,1346672,25762,1346672,42,84
NM,11192,303478,0,135,1811,379,759,180,197,5047,B,485,1811,485619,39620,407151,11192,1900,149,202,6363,314670,314670,6565,314670,5,18
NV,15240,243422,0,471,5109,118,759,59,197,684,A+,498,5109,297635,39620,407151,15240,1900,149,381,2731,258662,258662,3112,258662,3,0
NY,391220,3290097,0,951,89995,244,759,167,197,70010,A,24814,89995,485619,39620,407151,391220,1900,149,805,60918,3681317,3681317,61723,3681317,14,0
OH,48638,672914,0,624,7570,205,1904,116,197,0,B,2788,7570,485619,39620,407151,45172,2545,243,987,20935,721552,721552,21922,721552,16,68
OK,12343,298434,0,308,1393,126,759,180,197,8817,A+,377,1393,312454,13338,298434,12343,1900,149,395,5417,310777,310777,5812,310777,2,57
OR,7818,209050,0,149,1022,53,759,35,197,2649,A+,202,1022,485619,39620,407151,7521,1900,149,250,0,216868,216868,250,216868,5,10
PA,84370,634711,0,661,5109,379,759,131,197,65808,A+,6579,5109,485619,39620,407151,81956,1900,149,600,13680,719081,719081,14280,719081,22,0
PR,6922,113280,0,89,5109,9,759,7,197,0,C,151,5109,114723,2326,112331,1583,57,94,45,0,120202,120202,45,120202,0,0
RI,16777,133102,0,91,1984,16,759,15,197,1600,A+,927,1984,241245,23877,217368,16777,1900,149,69,1314,149879,149879,1383,149879,7,3
SC,30335,304336,0,906,2622,379,759,180,197,13456,A,694,2622,334198,37673,296525,30263,692,2,1313,0,334671,334671,1313,334671,1,245
SD,6535,70480,0,79,639,379,759,180,197,5652,B,88,639,485619,39620,407151,38775,1900,149,56,1105,77015,77015,1161,77015,1,7
TN,39444,702588,0,741,2498,379,759,180,197,25753,B,577,2498,741737,45734,696003,39149,552,25,1410,13073,742032,742032,14483,742032,10,67
TX,137624,1559710,0,5102,5109,379,759,180,197,76282,B,2324,5109,1697334,39620,407151,137624,1900,149,5707,32287,1697334,1697334,37994,1697334,28,0
UT,20050,297518,0,238,1321,80,375,180,161,11097,A+,166,1321,485619,39620,407151,20050,1900,149,676,4838,317568,317568,5514,317568,2,31
VA,60570,545893,295,854,8722,219,759,99,197,7868,A+,1700,8722,603870,39620,407151,57977,1596,104,624,12873,606758,606463,13497,606463,25,50
VI,81,2705,12,961,5109,379,759,180,197,67,C,6,5109,485619,39620,407151,38775,6,149,1,51,2798,2786,52,2786,0,0
VT,1198,60391,0,14,5109,379,759,180,197,941,B,56,5109,485619,39620,407151,1198,56,149,7,873,61589,61589,880,61589,0,0
WA,30367,475428,0,272,4106,379,759,49,197,0,B,1300,4106,485619,39620,407151,30367,1300,149,498,9799,505795,505795,10297,505795,7,13
WI,29668,507168,142,262,3351,95,741,180,197,21174,A+,766,3351,485619,39620,407151,26747,766,149,563,8607,536978,536836,9170,536836,0,25
WV,2712,159245,0,33,5109,10,759,4,197,1907,B,92,5109,485619,39620,407151,2622,1900,149,51,3202,161957,161957,3253,161957,0,0
WY,1368,30406,0,5,112,379,759,180,197,1033,B,20,112,42402,1229,41172,1079,1900,149,42,1537,31774,31774,1579,31774,0,1
AK,816,98636,0,14,5109,379,759,2,197,513,A,12,5109,99452,39620,407151,816,12,149,24,3332,99452,99452,3356,99452,0,0
AL,33206,336252,0,694,2612,379,761,180,447,18866,B,896,2612,485619,39620,407151,32753,880,16,1142,9557,369458,369458,10699,369458,5,45
AR,18062,259318,0,284,1245,379,759,61,194,12127,A,240,1245,485619,39620,407151,18062,1900,149,687,4827,277380,277380,5514,277380,0,31
AS,0,696,0,961,5109,379,759,180,197,0,C,0,5109,485619,39620,407151,0,1900,149,0,522,696,696,522,696,0,0
AZ,63030,401166,0,2453,4406,611,759,415,197,8139,A+,1490,4406,463800,39620,407151,62634,1393,97,3056,11952,464196,464196,15008,464196,27,93
CA,195571,3498774,0,5522,5109,1523,759,180,197,0,B,5733,5109,3694345,39620,407151,195571,1900,149,5349,96097,3694345,3694345,101446,3694345,101,0
CO,31155,264910,0,247,5375,379,759,180,197,4392,A,1457,5375,485619,39620,407151,28374,1900,149,262,4969,296065,296065,5231,296065,2,9
CT,45994,371126,0,122,10268,379,759,180,197,8053,B,4298,10268,414889,39620,407151,43763,3434,864,81,7769,417120,417120,7850,417120,11,169
DC,10159,76572,0,157,5109,53,759,34,197,1182,A+,543,5109,485619,39620,407151,38775,1900,149,31,2527,86731,86731,2558,86731,2,0
DE,10980,90012,0,93,5109,379,759,180,197,6646,A,507,5109,485619,39620,407151,9925,449,58,91,2700,100992,100992,2791,100992,2,0
FL,114018,1606626,1675,961,14068,379,759,180,197,0,A,3423,14068,2037374,148081,1885749,114018,3423,149,5004,47298,1722319,1720644,52302,1720644,46,203
GA,71095,686829,0,1135,10457,379,2222,180,197,0,A,2745,10457,757924,64822,693102,71095,1900,149,1714,12976,757924,757924,14690,757924,47,144
GU,245,11173,0,0,5109,0,759,0,197,174,A,5,5109,11101,223,10878,237,1900,149,14,366,11418,11418,380,11418,0,0
HI,835,71100,0,961,105,379,759,180,197,686,D,17,105,83301,39620,407151,38775,1900,149,16,1380,71935,71935,1396,71935,0,1
IA,27197,249857,0,137,5109,42,759,26,197,17017,A+,695,5109,485619,39620,407151,27197,1900,149,492,6603,277054,277054,7095,277054,3,0
ID,4645,75894,0,45,300,14,106,180,197,3610,A,90,300,80060,39620,407151,4166,70,20,243,2461,80539,80539,2704,80539,1,2
IL,140434,1321093,0,1626,5109,399,759,216,197,0,A,7014,5109,1460527,39620,407151,139434,6810,204,894,30792,1461527,1461527,31686,1461527,40,0
IN,43655,400597,0,723,6912,276,1452,91,197,33036,A+,2586,6912,485619,39620,407151,38775,2394,192,515,11854,444252,444252,12369,444252,8,29
KS,12970,148735,0,961,1082,379,348,180,150,747,A,261,1082,485619,39620,407151,38775,1900,149,0,0,161705,161705,0,161705,0,0
KY,14617,328265,0,377,2584,79,994,180,197,3719,B,546,2584,485619,39620,407151,14182,542,4,254,6926,342882,342882,7180,342882,8,10
LA,53415,607250,0,653,5109,379,759,77,197,39792,B,3164,5109,485619,39620,407151,38775,3051,113,938,11222,660665,660665,12160,660665,12,0
MA,107837,697619,0,822,11252,174,759,101,197,93157,A+,7963,11252,1009203,39620,407151,102922,7776,187,226,10158,805456,805456,10384,805456,25,33
MD,65777,433182,0,511,10683,209,759,180,197,4874,A,3129,10683,603597,39620,407151,65777,3001,128,440,8062,498959,498959,8502,498959,21,35
ME,3070,84528,0,25,343,10,759,7,197,2512,A,103,343,87259,3743,83385,2731,102,1,53,2355,87598,87598,2408,87598,0,4
MI,68989,893850,0,557,5109,193,759,115,197,49290,A+,6133,5109,979418,85568,893850,62306,5886,247,434,17600,962839,962839,18034,962839,19,0
MN,34123,508573,0,336,3943,162,1218,180,197,29854,A,1441,3943,542696,39620,407151,34123,1406,35,360,12693,542696,542696,13053,542696,9,46
MO,19421,322227,0,546,5109,379,759,66,197,0,B,982,5109,327024,21737,360303,19421,1900,149,553,14071,341648,341648,14624,341648,7,0
MP,30,8187,0,961,5109,379,759,180,197,19,D,2,5109,8217,39620,407151,30,2,149,0,0,8217,8217,0,8217,0,0
MS,24516,241481,0,755,2998,157,759,94,197,17242,A,1016,2998,265839,39620,407151,24358,999,17,1092,3244,265997,265997,4336,265997,5,52
MT,803,77529,0,15,93,379,759,180,197,572,C,21,93,485619,39620,407151,803,1900,149,37,3229,78332,78332,3266,78332,0,0
NC,57183,754095,0,891,5109,379,759,180,197,36921,A,1284,5109,485619,39620,407151,57183,1284,149,1009,18984,811278,811278,19993,811278,18,0
ND,3393,96051,0,25,222,379,759,180,197,3064,D,76,222,165430,39620,407151,3393,67,9,31,724,99444,99444,755,99444,2,3
NE,18221,144949,0,131,1268,379,759,180,197,12099,B,257,1268,485619,39620,407151,18221,1900,149,129,1740,163170,163170,1869,163170,1,11
NH,5598,105968,0,49,558,379,160,180,197,4358,B,347,558,485619,39620,407151,5598,1900,149,27,1486,111566,111566,1513,111566,4,0
NJ,170196,1150714,0,1182,19668,252,759,210,197,29740,A+,14872,19668,485619,39620,407151,170196,13018,1854,304,20961,1320910,1320910,21265,1320910,1877,70
NM,10990,297115,0,149,1793,379,759,180,197,4984,B,480,1793,485619,39620,407151,10990,1900,149,152,5870,308105,308105,6022,308105,4,17
NV,14859,240691,0,467,5109,98,759,57,197,682,A+,495,5109,293854,39620,407151,14859,1900,149,497,2666,255550,255550,3163,255550,1,0
NY,390415,3229179,0,996,89995,270,759,167,197,70010,A,24800,89995,485619,39620,407151,390415,1900,149,749,66893,3619594,3619594,67642,3619594,18,0
OH,47651,651979,0,624,7502,206,1897,121,197,0,B,2772,7502,485619,39620,407151,44221,2530,242,892,18051,699630,699630,18943,699630,17,55
OK,11948,293017,0,277,1336,87,759,180,197,8507,A+,375,1336,306716,13108,293017,11948,1900,149,438,6249,304965,304965,6687,304965,3,17
OR,7568,209050,0,189,1012,60,759,29,197,2649,A+,197,1012,485619,39620,407151,7294,1900,149,124,2486,216618,216618,2610,216618,2,6
PA,83770,621031,0,704,5109,379,759,142,197,65340,A+,6557,5109,485619,39620,407151,81374,1900,149,579,12814,704801,704801,13393,704801,39,0
PR,6877,113280,0,85,5109,12,759,4,197,0,C,151,5109,114723,2326,112331,1579,57,94,57,0,120157,120157,57,120157,2,0
RI,16708,131788,0,103,1981,18,759,17,197,1588,A+,920,1981,238787,23788,214999,16708,1900,149,45,1406,148496,148496,1451,148496,8,14
SC,29022,304336,0,881,2377,379,759,180,197,12317,A,693,2377,334198,37673,296525,28962,691,2,1125,14025,333358,333358,15150,333358,10,0
SD,6479,69375,0,79,632,379,759,180,197,5592,B,87,632,485619,39620,407151,38775,1900,149,60,717,75854,75854,777,75854,3,3
TN,38034,689515,0,741,2431,379,759,180,197,25280,B,567,2431,727268,44202,683066,37753,540,27,799,8446,727549,727549,9245,727549,11,45
TX,131917,1527423,0,4739,5109,379,759,180,197,74496,B,2296,5109,1659340,39620,407151,131917,1900,149,5996,23086,1659340,1659340,29082,1659340,47,0
UT,19374,292680,0,230,1290,79,365,180,160,10642,A+,164,1290,485619,39620,407151,19374,1900,149,590,6726,312054,312054,7316,312054,1,34
VA,59946,533020,303,854,8672,237,759,104,197,7818,A+,1675,8672,590404,39620,407151,57384,1572,103,432,15963,593269,592966,16395,592966,14,21
VI,80,2654,21,961,5109,379,759,180,197,64,C,6,5109,485619,39620,407151,38775,6,149,2,61,2755,2734,63,2734,0,0
VT,1191,59518,0,15,5109,379,759,180,197,938,B,56,5109,485619,39620,407151,1191,56,149,7,842,60709,60709,849,60709,0,0
WA,29869,465629,0,304,4093,379,759,56,197,0,B,1293,4093,485619,39620,407151,29869,1293,149,483,7956,495498,495498,8439,495498,9,26
WI,29105,498561,134,249,3326,93,734,180,197,20557,A+,766,3326,485619,39620,407151,26227,766,149,464,10758,527800,527666,11222,527666,9,27
WV,2661,156043,0,24,5109,5,759,2,197,1858,B,92,5109,485619,39620,407151,2574,1900,149,32,1624,158704,158704,1656,158704,0,0
WY,1326,28869,0,7,111,379,759,180,197,996,B,20,111,40154,1164,38989,1052,1900,149,47,0,30195,30195,47,30195,0,2
AK,792,95304,0,16,5109,379,759,2,197,507,A,12,5109,96096,39620,407151,792,12,149,14,3135,96096,96096,3149,96096,0,0
AL,32064,326695,0,683,2567,379,749,180,441,18866,B,891,2567,485619,39620,407151,31624,879,12,967,3754,358759,358759,4721,358759,27,46
AR,17375,254491,0,267,1214,379,759,58,189,11568,B,240,1214,485619,39620,407151,17375,1900,149,697,6677,271866,271866,7374,271866,3,26
AS,0,174,0,961,5109,379,759,180,197,0,C,0,5109,485619,39620,407151,0,1900,149,0,0,174,174,0,174,0,0
AZ,59974,389214,0,2270,4313,581,759,407,197,7936,A+,1463,4313,448800,39620,407151,59586,1366,97,1795,6875,449188,449188,8670,449188,79,58
CA,190222,3402677,0,5399,5109,1487,759,180,197,0,B,5632,5109,3592899,39620,407151,190222,1900,149,7149,88821,3592899,3592899,95970,3592899,52,0
CO,30893,259941,0,238,5366,379,759,180,197,4370,A,1455,5366,485619,39620,407151,28138,1900,149,188,2770,290834,290834,2958,290834,17,23
CT,45913,363357,0,124,10099,379,759,180,197,7842,B,4287,10099,406967,39620,407151,43610,3423,864,14,6459,409270,409270,6473,409270,10,0
DC,10128,74045,0,167,5109,58,759,36,197,1182,A+,541,5109,485619,39620,407151,38775,1900,149,34,837,84173,84173,871,84173,4,0
DE,10889,87312,0,85,5109,379,759,180,197,6598,A,505,5109,485619,39620,407151,9834,447,58,42,623,98201,98201,665,98201,1,0
FL,109014,1559328,1535,961,13865,379,759,180,197,0,A,3377,13865,1978757,142315,1833006,109014,3377,149,5511,22079,1669877,1668342,27590,1668342,44,251
GA,69381,673853,0,1124,10313,379,2206,180,197,0,A,2698,10313,743234,63170,680064,69381,1900,149,1703,10270,743234,743234,11973,743234,10,190
GU,231,10807,0,0,5109,0,759,0,197,174,A,5,5109,10711,218,10493,223,1900,149,6,381,11038,11038,387,11038,0,0
HI,819,69720,0,961,104,379,759,180,197,673,D,17,104,81648,39620,407151,38775,1900,149,3,1196,70539,70539,1199,70539,0,5
IA,26705,243254,0,140,5109,43,759,25,197,16858,A+,692,5109,485619,39620,407151,26705,1900,149,332,4924,269959,269959,5256,269959,4,0
ID,4402,73433,0,34,298,14,105,180,197,3484,A,89,298,77376,39620,407151,3943,69,20,148,1523,77835,77835,1671,77835,0,5
IL,139540,1290301,0,1614,5109,389,759,219,197,0,A,6974,5109,1428841,39620,407151,138540,6770,204,715,28616,1429841,1429841,29331,1429841,63,0
IN,43140,388743,0,701,6883,263,1446,89,197,32152,A+,2578,6883,485619,39620,407151,38775,2386,192,269,5238,431883,431883,5507,431883,9,30
KS,12970,148735,0,961,1082,379,348,180,150,747,A,261,1082,485619,39620,407151,38775,1900,149,505,6187,161705,161705,6692,161705,2,26
KY,14363,321339,0,335,2574,79,992,180,197,3706,B,538,2574,485619,39620,407151,13937,534,4,222,4186,335702,335702,4408,335702,1,18
LA,52477,596028,0,631,5109,379,759,77,197,39792,B,3152,5109,485619,39620,407151,38775,3039,113,882,11684,648505,648505,12566,648505,18,0
MA,107611,687461,0,939,11219,181,759,98,197,91404,A+,7938,11219,995705,39620,407151,102762,7752,186,172,7258,795072,795072,7430,795072,48,62
MD,65337,425120,0,544,10648,213,759,180,197,4810,A,3108,10648,591962,39620,407151,65337,2978,130,330,6592,490457,490457,6922,490457,16,37
ME,3017,82173,0,26,339,12,759,6,197,2490,A,103,339,84853,3690,81042,2680,102,1,23,3460,85190,85190,3483,85190,1,0
MI,68555,876250,0,557,5109,209,759,124,197,49290,A+,6114,5109,961368,85118,876250,61953,5868,246,358,15779,944805,944805,16137,944805,5,0
MN,33763,495880,0,340,3897,160,1203,180,197,29707,A,1432,3897,529643,39620,407151,33763,1397,35,294,9304,529643,529643,9598,529643,7,37
MO,18868,308156,0,546,5109,379,759,66,197,0,B,975,5109,327024,21737,360303,18868,1900,149,725,8925,327024,327024,9650,327024,14,0
MP,30,8187,0,961,5109,379,759,180,197,19,D,2,5109,8217,39620,407151,30,2,149,0,0,8217,8217,0,8217,0,0
MS,23424,238237,0,767,2946,157,759,91,197,17242,A,1011,2946,261505,39620,407151,23268,994,17,526,7275,261661,261661,7801,261661,22,31
MT,766,74300,0,17,93,379,759,180,197,571,C,21,93,485619,39620,407151,766,1900,149,23,1120,75066,75066,1143,75066,0,2
NC,56174,735111,0,906,5109,379,759,180,197,36921,A,1266,5109,485619,39620,407151,56174,1266,149,1721,15736,791285,791285,17457,791285,15,0
ND,3362,95327,0,27,219,379,759,180,197,3044,D,74,219,162468,39620,407151,3362,66,8,42,1094,98689,98689,1136,98689,1,1
NE,18092,143209,0,125,1257,379,759,180,197,12099,B,256,1257,485619,39620,407151,18092,1900,149,135,2524,161301,161301,2659,161301,7,23
NH,5571,104482,0,51,558,379,160,180,197,4316,B,343,558,485619,39620,407151,5571,1900,149,13,1164,110053,110053,1177,110053,4,0
NJ,169892,1129753,0,1196,19598,275,759,214,197,29627,A+,12995,19598,485619,39620,407151,169892,12995,149,158,16036,1299645,1299645,16194,1299645,46,86
NM,10838,291245,0,141,1776,379,759,180,197,4874,B,476,1776,485619,39620,407151,10838,1900,149,144,3863,302083,302083,4007,302083,7,22
NV,14362,238025,0,439,5109,96,759,53,197,666,A+,494,5109,289920,39620,407151,14362,1900,149,365,3496,252387,252387,3861,252387,2,0
NY,389666,3162286,0,1071,89995,290,759,228,197,69710,A,24782,89995,485619,39620,407151,389666,1900,149,581,50563,3551952,3551952,51144,3551952,16,0
OH,46759,633928,0,592,7447,202,1886,119,197,0,B,2755,7447,485619,39620,407151,43363,2516,239,632,9618,680687,680687,10250,680687,20,68
OK,11510,286768,0,268,1319,90,759,180,197,8144,A+,372,1319,299930,12498,286768,11510,1900,149,482,2739,298278,298278,3221,298278,1,31
OR,7444,206564,0,185,1006,59,759,29,197,2604,A+,195,1006,485619,39620,407151,7185,1900,149,170,3126,214008,214008,3296,214008,3,23
PA,83191,608217,0,707,5109,379,759,136,197,64502,A+,6518,5109,485619,39620,407151,80810,1900,149,495,11810,691408,691408,12305,691408,54,0
PR,6820,113280,0,80,5109,9,759,2,197,0,C,149,5109,114723,2326,112331,1577,57,92,135,0,120100,120100,135,120100,0,0
RI,16663,130382,0,104,1967,20,759,16,197,1573,A+,912,1967,235946,23693,212253,16663,1900,149,51,1486,147045,147045,1537,147045,6,9
SC,27897,290311,0,832,2377,379,759,180,197,12317,A,683,2377,326631,36320,290311,27842,683,0,1284,7673,318208,318208,8957,318208,10,0
SD,6419,68658,0,81,629,379,759,180,197,5554,B,84,629,485619,39620,407151,38775,1900,149,66,1025,75077,75077,1091,75077,1,5
TN,37235,681069,0,696,2386,379,759,180,197,24693,B,556,2386,718038,43217,674821,36969,535,21,932,11953,718304,718304,12885,718304,14,50
TX,125921,1504337,0,4389,5109,379,759,180,197,72898,B,2249,5109,1630258,39620,407151,125921,1900,149,5551,27417,1630258,1630258,32968,1630258,29,0
UT,18784,285954,0,245,1256,77,355,180,154,10334,A+,163,1256,485619,39620,407151,18784,1900,149,484,1978,304738,304738,2462,304738,0,30
VA,59514,517057,319,886,8651,235,759,107,197,7765,A+,1661,8651,574013,39620,407151,56956,1559,102,520,7674,576890,576571,8194,576571,16,79
VI,78,2593,35,961,5109,379,759,180,197,64,C,6,5109,485619,39620,407151,38775,6,149,2,49,2706,2671,51,2671,0,0
VT,1184,58676,0,13,5109,379,759,180,197,930,B,56,5109,485619,39620,407151,1184,56,149,20,512,59860,59860,532,59860,0,0
WA,29386,457673,0,234,4067,379,759,44,197,0,B,1284,4067,485619,39620,407151,29386,1284,149,516,9339,487059,487059,9855,487059,8,5
WI,28641,487803,160,239,3299,89,723,180,197,20121,A+,757,3299,485619,39620,407151,25763,757,149,466,9638,516604,516444,10104,516444,7,31
WV,2629,154419,0,24,5109,5,759,2,197,1855,B,92,5109,485619,39620,407151,2541,1900,149,47,2673,157048,157048,2720,157048,0,0
WY,1279,28869,0,7,109,379,759,180,197,966,B,20,109,40154,1164,38989,1016,1900,149,25,1384,30148,30148,1409,30148,0,0
AK,778,92169,0,14,5109,379,759,1,197,502,A,12,5109,92947,39620,407151,778,12,149,17,2106,92947,92947,2123,92947,0,0
AL,31097,322941,0,681,2521,379,737,180,430,15974,B,864,2521,485619,39620,407151,30670,854,10,643,4285,354038,354038,4928,354038,23,50
AR,16678,247814,0,248,1188,379,759,57,186,11220,A,237,1188,485619,39620,407151,16678,1900,149,595,7558,264492,264492,8153,264492,10,24
AS,0,174,0,961,5109,379,759,180,197,0,C,0,5109,485619,39620,407151,0,1900,149,0,0,174,174,0,174,0,0
AZ,58179,382339,0,2136,4255,614,759,386,197,7746,A+,1384,4255,440138,39620,407151,57799,1291,93,3593,7135,440518,440518,10728,440518,42,0
CA,183073,3313856,0,5065,5109,1421,759,180,197,0,B,5580,5109,3496929,39620,407151,183073,1900,149,5019,80224,3496929,3496929,85243,3496929,65,0
CO,30705,257171,0,249,5343,379,759,180,197,4342,A,1438,5343,485619,39620,407151,27959,1900,149,166,4938,287876,287876,5104,287876,9,16
CT,45899,356898,0,138,10099,379,759,180,197,7842,B,4277,10099,400391,39620,407151,43493,3414,863,117,-1601,402797,402797,-1484,402797,14,0
DC,10094,73208,0,171,5109,61,759,40,197,1182,A+,537,5109,485619,39620,407151,38775,1900,149,36,1262,83302,83302,1298,83302,2,0
DE,10847,86689,0,91,5109,379,759,180,197,6554,A,504,5109,485619,39620,407151,9792,446,58,27,786,97536,97536,813,97536,0,0
FL,103503,1537249,1425,961,13614,379,759,180,197,0,A,3333,13614,1944730,135955,1805379,103503,3333,149,3286,19979,1642177,1640752,23265,1640752,67,207
GA,67678,663583,0,1056,10123,379,2174,180,197,0,A,2688,10123,731261,61843,669418,67678,1900,149,1750,21485,731261,731261,23235,731261,40,170
GU,225,10426,0,0,5109,0,759,0,197,174,A,5,5109,10445,217,10228,217,1900,149,1,246,10651,10651,247,10651,0,0
HI,816,68524,0,961,99,379,759,180,197,669,D,17,99,80394,39620,407151,38775,1900,149,2,627,69340,69340,629,69340,0,2
IA,26373,238330,0,163,5109,47,759,26,197,16579,A+,688,5109,485619,39620,407151,26373,1900,149,322,5749,264703,264703,6071,264703,2,0
ID,4254,71910,0,39,293,14,102,180,197,3405,A,89,293,75730,39620,407151,3820,69,20,248,2948,76164,76164,3196,76164,0,10
IL,138825,1261685,0,1648,5109,424,759,236,197,0,A,6911,5109,1399510,39620,407151,137825,6707,204,601,19906,1400510,1400510,20507,1400510,36,0
IN,42871,383505,0,736,6853,297,1447,110,197,32152,A+,2569,6853,485619,39620,407151,38775,2377,192,238,7222,426376,426376,7460,426376,16,34
KS,12465,142548,0,961,1056,379,342,180,149,722,A,259,1056,485619,39620,407151,38775,1900,149,0,0,155013,155013,0,155013,0,0
KY,14141,317153,0,376,2556,70,988,180,197,3591,B,537,2556,485619,39620,407151,13736,533,4,302,8960,331294,331294,9262,331294,11,24
LA,51595,584344,0,646,5109,379,759,83,197,39792,B,3134,5109,485619,39620,407151,38775,3021,113,1356,16519,635939,635939,17875,635939,17,0
MA,107439,680203,0,953,11157,181,759,112,197,91404,A+,7890,11157,985711,39620,407151,102651,7710,180,229,7350,787642,787642,7579,787642,16,63
MD,65007,418528,0,561,10611,212,759,180,197,4797,A,3092,10611,583091,39620,407151,65007,2963,129,404,8406,483535,483535,8810,483535,18,39
ME,2994,78713,0,24,339,12,759,6,197,2443,B,102,339,81707,3645,77942,2655,101,1,23,680,81707,81707,703,81707,0,3
MI,68197,860471,0,557,5109,209,759,99,197,49290,A+,6109,5109,945209,84738,860471,61630,5864,245,240,10411,928668,928668,10651,928668,12,0
MN,33469,486576,0,339,3860,158,1191,180,197,29399,A,1425,3860,520045,39620,407151,33469,1393,32,242,6666,520045,520045,6908,520045,9,30
MO,18143,299231,0,595,5109,379,759,66,197,0,B,961,5109,382610,21737,360303,18143,1900,149,0,0,317374,317374,0,317374,0,0
MP,30,8187,0,961,5109,379,759,180,197,19,D,2,5109,8217,39620,407151,30,2,149,0,48,8217,8217,48,8217,0,0
MS,22898,230962,0,664,2915,151,759,88,197,17242,A,989,2915,253098,39620,407151,22745,972,17,611,0,253860,253860,611,253860,11,34
MT,743,73180,0,15,91,379,759,180,197,566,C,21,91,485619,39620,407151,743,1900,149,3,2615,73923,73923,2618,73923,0,1
NC,54453,719375,0,915,5109,379,759,180,197,36921,A,1251,5109,485619,39620,407151,54453,1251,149,848,15635,773828,773828,16483,773828,28,0
ND,3320,94233,0,28,218,379,759,180,197,3008,D,73,218,158524,39620,407151,3320,67,6,7,93,97553,97553,100,97553,1,0
NE,17957,140685,0,135,1234,379,759,180,197,11980,D,249,1234,485619,39620,407151,17957,1900,149,147,1987,158642,158642,2134,158642,5,22
NH,5558,103318,0,54,558,379,160,180,197,4290,B,339,558,485619,39620,407151,5558,1900,149,14,0,108876,108876,14,108876,0,5
NJ,169734,1113717,0,1092,19512,307,759,216,197,29517,A+,12949,19512,485619,39620,407151,169734,12949,149,319,15733,1283451,1283451,16052,1283451,54,111
NM,10694,287382,0,139,1754,379,759,180,197,4742,C,469,1754,485619,39620,407151,10694,1900,149,129,4516,298076,298076,4645,298076,0,8
NV,13997,234529,0,389,5109,100,759,50,197,658,A+,492,5109,285790,39620,407151,13997,1900,149,462,3999,248526,248526,4461,248526,0,0
NY,389085,3111723,0,1104,89995,302,759,228,197,69710,A,24766,89995,485619,39620,407151,389085,1900,149,597,48112,3500808,3500808,48709,3500808,27,0
OH,46127,624310,0,570,7379,205,1876,126,197,0,B,2735,7379,485619,39620,407151,42767,2497,238,590,10246,670437,670437,10836,670437,31,87
OK,11028,284029,0,265,1288,111,759,180,197,7888,A+,371,1288,296988,12295,284029,11028,1900,149,295,12104,295057,295057,12399,295057,2,20
OR,7274,203438,0,184,983,58,759,28,197,2604,A+,192,983,485619,39620,407151,7018,1900,149,191,3893,210712,210712,4084,210712,0,14
PA,82696,596407,0,738,5109,379,759,151,197,64502,A+,6464,5109,485619,39620,407151,80347,1900,149,510,10745,679103,679103,11255,679103,38,0
PR,6685,113280,0,77,5109,9,759,2,197,0,C,149,5109,114723,2326,112331,1550,57,92,121,0,119965,119965,121,119965,0,0
RI,16612,128896,0,105,1958,19,759,17,197,1562,A+,906,1958,232592,23582,209010,16612,1900,149,77,1599,145508,145508,1676,145508,3,8
SC,26613,282638,0,824,2377,379,759,180,197,12317,A,673,2377,317438,34800,282638,26572,673,0,912,4459,309251,309251,5371,309251,14,83
SD,6353,67633,0,85,624,379,759,180,197,5497,B,83,624,485619,39620,407151,38775,1900,149,27,630,73986,73986,657,73986,2,8
TN,36303,669116,0,721,2336,379,759,180,197,24068,B,542,2336,705164,42154,663010,36048,521,21,750,4564,705419,705419,5314,705419,11,35
TX,120370,1476920,0,4092,5109,379,759,180,197,70714,B,2220,5109,1597290,39620,407151,120370,1900,149,5489,42792,1597290,1597290,48281,1597290,28,0
UT,18300,283976,0,214,1226,77,344,180,153,10057,A,163,1226,485619,39620,407151,18300,1900,149,394,2570,302276,302276,2964,302276,5,34
VA,58994,509383,291,847,8572,245,759,126,197,7725,A+,1645,8572,565835,39620,407151,56452,1542,103,529,9725,568668,568377,10254,568377,25,61
VI,76,2544,33,961,5109,379,759,180,197,64,C,6,5109,485619,39620,407151,38775,6,149,0,42,2653,2620,42,2620,0,0
VT,1164,58164,0,19,5109,379,759,180,197,927,B,56,5109,485619,39620,407151,1164,56,149,1,720,59328,59328,721,59328,0,0
WA,28870,448334,0,204,4062,379,759,37,197,0,B,1276,4062,485619,39620,407151,28870,1276,149,190,2076,477204,477204,2266,477204,6,13
WI,28175,478165,142,240,3268,93,716,180,197,19852,A+,750,3268,485619,39620,407151,25331,750,149,297,11531,506482,506340,11828,506340,5,37
WV,2582,151746,0,21,5109,5,759,2,197,1790,B,92,5109,485619,39620,407151,2493,1900,149,30,3094,154328,154328,3124,154328,3,0
WY,1254,27485,0,8,109,379,759,180,197,953,C,20,109,38300,1149,37151,992,1900,149,24,1323,28739,28739,1347,28739,0,4
AK,761,90063,0,13,5109,379,759,1,197,491,A,12,5109,90824,39620,407151,761,12,149,6,2767,90824,90824,2773,90824,0,0
AL,30454,318656,0,663,2471,379,725,180,424,15974,B,841,2471,485619,39620,407151,30031,831,10,433,3999,349110,349110,4432,349110,2,11
AR,16083,240256,0,237,1164,379,759,61,186,10793,A,227,1164,485619,39620,407151,16083,1900,149,941,13164,256339,256339,14105,256339,3,12
AS,0,174,0,961,5109,379,759,180,197,0,C,0,5109,485619,39620,407151,0,1900,149,0,0,174,174,0,174,0,0
AZ,54586,375204,0,1992,4255,583,759,379,197,7581,A+,1342,4255,429418,39620,407151,54214,1251,91,2196,7850,429790,429790,10046,429790,3,0
CA,178054,3233632,0,4804,5109,1412,759,180,197,0,B,5515,5109,3411686,39620,407151,178054,1900,149,4230,88200,3411686,3411686,92430,3411686,20,0
CO,30539,252233,0,256,5327,379,759,180,197,4328,A,1429,5327,485619,39620,407151,27800,1900,149,190,4196,282772,282772,4386,282772,0,4
CT,45782,358499,0,140,10099,379,759,180,197,7842,B,4263,10099,401986,39620,407151,43487,3403,860,27,6324,404281,404281,6351,404281,3,0
DC,10058,71946,0,155,5109,50,759,34,197,1182,A+,535,5109,485619,39620,407151,38775,1900,149,38,2444,82004,82004,2482,82004,2,0
DE,10820,85903,0,89,5109,379,759,180,197,6459,A,504,5109,485619,39620,407151,9764,446,58,45,1704,96723,96723,1749,96723,0,0
FL,100217,1517270,1546,961,13407,379,759,180,197,0,A,3266,13407,1911676,131152,1777209,100217,3266,149,2926,15265,1619033,1617487,18191,1617487,12,82
GA,65928,642098,0,1000,9953,379,2155,180,197,0,A,2648,9953,708026,60017,648009,65928,1900,149,1227,8492,708026,708026,9719,708026,5,116
GU,224,10180,0,0,5109,0,759,0,197,173,A,5,5109,10293,216,10077,216,1900,149,2,392,10404,10404,394,10404,0,0
HI,814,67897,0,961,97,379,759,180,197,651,D,17,97,79795,39620,407151,38775,1900,149,11,840,68711,68711,851,68711,0,1
IA,26051,232581,0,169,5109,51,759,28,197,16240,A+,686,5109,485619,39620,407151,26051,1900,149,88,1392,258632,258632,1480,258632,1,0
ID,4006,68962,0,41,283,12,101,180,197,3305,A,89,283,72547,39620,407151,3585,69,20,0,0,72968,72968,0,72968,0,0
IL,138224,1241779,0,1628,5109,419,759,250,197,0,A,6875,5109,1379003,39620,407151,137224,6671,204,462,17757,1380003,1380003,18219,1380003,24,0
IN,42633,376283,0,756,6819,283,1452,108,197,31739,A+,2553,6819,485619,39620,407151,38775,2363,190,210,6786,418916,418916,6996,418916,13,31
KS,12465,142548,0,961,1056,379,342,180,149,722,A,259,1056,485619,39620,407151,38775,1900,149,406,6958,155013,155013,7364,155013,5,21
KY,13839,308193,0,349,2532,67,987,180,197,3534,B,526,2532,485619,39620,407151,13449,522,4,89,4662,322032,322032,4751,322032,0,10
LA,50239,567825,0,630,5109,379,759,77,197,39792,B,3117,5109,485619,39620,407151,38775,3004,113,461,6791,618064,618064,7252,618064,12,0
MA,107210,672853,0,920,11094,180,759,107,197,91404,A+,7874,11094,975415,39620,407151,102469,7694,180,149,6594,780063,780063,6743,780063,16,9
MD,64603,410122,0,602,10572,232,759,180,197,4776,A,3074,10572,572731,39620,407151,64603,2945,129,297,5397,474725,474725,5694,474725,8,28
ME,2971,78033,0,27,336,13,759,6,197,2409,B,102,336,80662,3619,76924,2640,102,149,14,0,81004,81004,14,81004,0,0
MI,67957,850060,0,557,5109,209,759,99,197,49290,A+,6097,5109,934545,84485,850060,61409,5853,244,246,10345,918017,918017,10591,918017,7,0
MN,33227,479910,0,332,3830,156,1180,180,197,29065,A,1416,3830,513137,39620,407151,33227,1384,32,307,8467,513137,513137,8774,513137,4,33
MO,18143,299231,0,415,5109,379,759,66,197,0,B,961,5109,270232,17275,252506,18143,1900,149,140,2077,317374,317374,2217,317374,5,0
MP,30,8139,0,961,5109,379,759,180,197,19,D,2,5109,8169,39620,407151,30,2,149,0,0,8169,8169,0,8169,0,0
MS,22287,230962,0,710,2881,148,759,95,197,17242,A,978,2881,253098,39620,407151,22136,961,17,1646,12888,253249,253249,14534,253249,40,114
MT,740,70565,0,15,90,379,759,180,197,548,C,21,90,485619,39620,407151,740,1900,149,23,925,71305,71305,948,71305,1,1
NC,53605,703740,0,870,5109,379,759,180,197,36921,A,1223,5109,485619,39620,407151,53605,1223,149,804,10766,757345,757345,11570,757345,3,0
ND,3313,94140,0,31,218,379,759,180,197,2952,D,72,218,158199,39620,407151,3313,66,6,25,1255,97453,97453,1280,97453,1,2
NE,17810,138698,0,141,1212,379,759,180,197,11776,D,244,1212,485619,39620,407151,17810,1900,149,103,2164,156508,156508,2267,156508,0,0
NH,5544,103318,0,55,553,379,159,180,197,4275,B,339,553,485619,39620,407151,5544,1900,149,26,2951,108862,108862,2977,108862,0,2
NJ,169415,1097984,0,1033,19401,287,759,213,197,29522,A+,12895,19401,485619,39620,407151,169415,12895,149,273,22159,1267399,1267399,22432,1267399,25,134
NM,10565,282866,0,134,1746,379,759,180,197,4684,C,469,1746,485619,39620,407151,10565,1900,149,0,0,293431,293431,0,293431,0,0
NV,13535,230530,0,373,5109,100,759,46,197,653,A+,492,5109,280618,39620,407151,13535,1900,149,330,2044,244065,244065,2374,244065,0,0
NY,388488,3063611,0,1122,89995,330,759,228,197,69710,A,24739,89995,485619,39620,407151,388488,1900,149,552,56228,3452099,3452099,56780,3452099,14,0
OH,45537,614064,0,549,7292,217,1852,124,197,0,B,2704,7292,485619,39620,407151,42254,2467,237,729,15651,659601,659601,16380,659601,4,50
OK,10733,271925,0,197,1268,93,759,180,197,7648,A+,369,1268,283875,11340,271925,10733,1900,149,218,0,282658,282658,218,282658,0,25
OR,7083,199545,0,145,969,48,759,27,197,2588,A+,192,969,485619,39620,407151,6836,1900,149,146,3871,206628,206628,4017,206628,2,23
PA,82186,585662,0,745,5109,379,759,156,197,64105,A+,6426,5109,485619,39620,407151,79859,1900,149,456,9647,667848,667848,10103,667848,3,0
PR,6564,113280,0,70,5109,10,759,3,197,0,C,149,5109,114723,2326,112331,1540,57,92,39,0,119844,119844,39,119844,0,0
RI,16535,127297,0,106,1950,18,759,15,197,1554,A+,903,1950,228842,23434,205408,16535,1900,149,59,1596,143832,143832,1655,143832,9,28
SC,25701,278179,0,731,2294,379,759,180,197,10790,A,659,2294,311953,33774,278179,25666,659,0,1008,205,303880,303880,1213,303880,6,0
SD,6326,67003,0,88,616,379,759,180,197,5437,B,81,616,485619,39620,407151,38775,1900,149,29,274,73329,73329,303,73329,0,8
TN,35553,664552,0,664,2301,379,759,180,197,23567,B,531,2301,699854,41499,658355,35302,510,21,451,14025,700105,700105,14476,700105,5,10
TX,114881,1434128,0,3711,5109,379,759,180,197,69190,B,2192,5109,1549009,39620,407151,114881,1900,149,3280,19549,1549009,1549009,22829,1549009,10,0
UT,17906,281406,0,198,1192,67,338,180,150,9863,A,158,1192,485619,39620,407151,17906,1900,149,444,2473,299312,299312,2917,299312,0,8
VA,58465,499658,298,848,8511,240,759,132,197,7663,A+,1620,8511,555607,39620,407151,55949,1517,103,471,11976,558421,558123,12447,558123,9,2
VI,76,2502,15,961,5109,379,759,180,197,64,C,6,5109,485619,39620,407151,38775,6,149,0,0,2593,2578,0,2578,0,0
VT,1163,57444,0,8,5109,379,759,180,197,926,B,56,5109,485619,39620,407151,1163,56,149,4,758,58607,58607,762,58607,0,0
WA,28680,446258,0,205,4049,379,759,42,197,0,B,1270,4049,485619,39620,407151,28680,1270,149,455,8414,474938,474938,8869,474938,5,19
WI,27878,466634,169,246,3231,93,711,180,197,19543,A+,745,3231,485619,39620,407151,25068,745,149,263,6300,494681,494512,6563,494512,1,11
WV,2552,148652,0,21,5109,5,759,2,197,1681,B,89,5109,485619,39620,407151,2461,1900,149,9,606,151204,151204,615,151204,0,0
WY,1230,26162,0,8,105,379,759,180,197,931,C,20,105,36228,1086,35141,974,1900,149,33,0,27392,27392,33,27392,0,5
AK,755,87296,0,15,5109,379,759,1,197,475,A,12,5109,88051,39620,407151,755,12,149,12,1121,88051,88051,1133,88051,0,0
AL,30021,314657,0,625,2460,379,721,180,424,15974,B,839,2460,485619,39620,407151,29598,829,10,472,4683,344678,344678,5155,344678,1,17
AR,15142,227092,0,240,1152,379,759,59,184,10082,A,224,1152,485619,39620,407151,15142,1900,149,0,0,242234,242234,0,242234,0,52
AS,0,174,0,961,5109,379,759,180,197,0,C,0,5109,485619,39620,407151,0,1900,149,0,0,174,174,0,174,0,0
AZ,52390,367354,0,1942,4255,556,759,361,197,7387,A+,1339,4255,419372,39620,407151,52018,1248,91,2592,11872,419744,419744,14464,419744,1,3
CA,173824,3145432,0,4679,5109,1366,759,180,197,0,B,5495,5109,3319256,39620,407151,173824,1900,149,4515,80329,3319256,3319256,84844,3319256,71,0
CO,30349,248037,0,255,5323,379,759,180,197,4309,A,1429,5323,485619,39620,407151,27608,1900,149,162,5155,278386,278386,5317,278386,0,5
CT,45755,352175,0,149,10099,379,759,180,197,7842,B,4260,10099,395590,39620,407151,43415,3401,859,40,2003,397930,397930,2043,397930,9,0
DC,10020,69502,0,168,5109,61,759,37,197,1172,A+,533,5109,485619,39620,407151,38775,1900,149,36,1533,79522,79522,1569,79522,2,0
DE,10775,84199,0,79,5109,379,759,180,197,6459,A,504,5109,485619,39620,407151,9724,446,58,94,2464,94974,94974,2558,94974,0,0
FL,97291,1502005,1625,961,13325,379,759,180,197,0,A,3254,13325,1889662,127837,1758538,97291,3254,149,3494,34530,1600921,1599296,38024,1599296,17,98
GA,64701,633606,0,960,9837,379,2140,180,197,0,A,2643,9837,698307,58928,639379,64701,1900,149,892,3031,698307,698307,3923,698307,1,0
GU,222,9788,0,0,5109,0,759,0,197,173,A,5,5109,10066,214,9852,214,1900,149,0,0,10010,10010,0,10010,0,0
HI,803,67057,0,961,96,379,759,180,197,644,D,17,96,78744,39620,407151,38775,1900,149,14,1112,67860,67860,1126,67860,0,0
IA,25963,231189,0,170,5109,53,759,27,197,16068,A+,685,5109,485619,39620,407151,25963,1900,149,467,6478,257152,257152,6945,257152,4,0
ID,4006,68962,0,31,283,12,101,180,197,3305,A,89,283,72547,39620,407151,3585,69,20,135,1637,72968,72968,1772,72968,0,4
IL,137762,1224022,0,1631,5109,422,759,256,197,0,A,6851,5109,1360784,39620,407151,136762,6647,204,658,23158,1361784,1361784,23816,1361784,22,0
IN,42423,369497,0,744,6788,226,1450,124,197,31302,A+,2540,6788,485619,39620,407151,38775,2350,190,362,9756,411920,411920,10118,411920,4,33
KS,12059,135590,0,961,1035,379,338,180,146,715,A,254,1035,485619,39620,407151,38775,1900,149,0,0,147649,147649,0,147649,0,0
KY,13750,303531,0,354,2522,62,980,180,197,3530,B,526,2522,485619,39620,407151,13369,523,3,120,0,317281,317281,120,317281,2,0
LA,49778,561034,0,589,5109,379,759,69,197,37017,B,3105,5109,485619,39620,407151,38775,2993,112,393,5603,610812,610812,5996,610812,1,0
MA,107061,666259,0,927,11085,194,759,111,197,91404,A+,7858,11085,966551,39620,407151,102333,7677,181,125,8258,773320,773320,8383,773320,30,9
MD,64306,404725,0,608,10544,230,759,180,197,4773,A,3066,10544,565298,39620,407151,64306,2937,129,350,6401,469031,469031,6751,469031,14,47
ME,2957,78033,0,26,336,11,759,5,197,2391,B,102,336,80662,3619,76924,2629,102,149,19,1395,80990,80990,1414,80990,0,3
MI,67711,839715,0,557,5109,209,759,99,197,49290,A+,6090,5109,923961,84246,839715,61230,5846,244,166,12626,907426,907426,12792,907426,3,0
MN,32920,471443,0,322,3797,160,1163,180,197,28663,A,1412,3797,504363,39620,407151,32920,1380,32,453,11867,504363,504363,12320,504363,8,30
MO,18003,297154,0,415,5109,379,759,66,197,0,B,956,5109,270232,17275,252506,18003,1900,149,413,3629,315157,315157,4042,315157,1,0
MP,30,8139,0,961,5109,379,759,180,197,19,D,2,5109,8169,39620,407151,30,2,149,0,0,8169,8169,0,8169,0,0
MS,20641,218074,0,689,2767,156,759,98,197,15323,A,938,2767,238574,39620,407151,20500,922,16,0,0,238715,238715,0,238715,0,0
MT,717,69640,0,15,89,379,759,180,197,548,C,20,89,485619,39620,407151,717,1900,149,19,808,70357,70357,827,70357,0,4
NC,52801,692974,0,845,5109,379,759,180,197,29219,A,1220,5109,485619,39620,407151,52801,1220,149,1412,13022,745775,745775,14434,745775,8,0
ND,3288,92885,0,31,216,379,759,180,197,2910,D,71,216,155976,39620,407151,3288,65,6,37,1905,96173,96173,1942,96173,0,3
NE,17707,136534,0,140,1212,379,759,180,197,11565,D,244,1212,485619,39620,407151,17707,1900,149,116,2271,154241,154241,2387,154241,0,12
NH,5518,100367,0,55,551,379,159,180,197,4244,B,339,551,485619,39620,407151,5518,1900,149,32,286,105885,105885,318,105885,2,2
NJ,169142,1075825,0,1105,19267,278,759,219,197,29450,A+,12870,19267,485619,39620,407151,169142,12870,149,308,25786,1244967,1244967,26094,1244967,13,0
NM,10565,282866,0,134,1746,379,759,180,197,4684,C,469,1746,485619,39620,407151,10565,1900,149,305,8524,293431,293431,8829,293431,5,11
NV,13205,228486,0,370,5109,87,759,49,197,652,A+,492,5109,283893,39620,407151,13205,1900,149,274,2454,241691,241691,2728,241691,1,0
NY,387936,3007383,0,1142,89995,332,759,237,197,69506,A,24725,89995,485619,39620,407151,387936,1900,149,664,66862,3395319,3395319,67526,3395319,15,0
OH,44808,598413,0,496,7242,194,1844,119,197,0,B,2700,7242,485619,39620,407151,41578,2463,237,546,12710,643221,643221,13256,643221,3,41
OK,10515,271925,0,197,1243,93,759,180,197,7531,A+,369,1243,283875,11340,271925,10037,1900,149,478,0,282440,282440,478,282440,1,14
OR,6937,195674,0,154,946,50,759,29,197,2533,A+,190,946,485619,39620,407151,6937,1900,149,187,8329,202611,202611,8516,202611,1,0
PA,81730,576015,0,735,5109,379,759,157,197,62932,A+,6423,5109,485619,39620,407151,79405,1900,149,464,9554,657745,657745,10018,657745,4,0
PR,6525,113280,0,71,5109,13,759,5,197,0,C,149,5109,114723,2326,112331,1533,57,92,62,0,119805,119805,62,119805,2,0
RI,16476,125701,0,123,1922,23,759,12,197,1515,A+,894,1922,225158,23298,201860,16476,1900,149,27,623,142177,142177,650,142177,0,0
SC,24693,277974,0,692,2294,379,759,180,197,10790,A,653,2294,302635,32592,270043,24661,653,0,907,5511,302667,302667,6418,302667,9,0
SD,6297,66729,0,89,608,379,759,180,197,5389,B,81,608,485619,39620,407151,38775,1900,149,72,1039,73026,73026,1111,73026,0,10
TN,35102,650527,0,605,2291,379,759,180,197,23067,B,526,2291,685381,40967,644414,34854,505,21,656,9633,685629,685629,10289,685629,2,25
TX,111601,1414579,0,3409,5109,379,759,180,197,68499,B,2182,5109,1526180,39620,407151,111601,1900,149,3866,58916,1526180,1526180,62782,1526180,17,0
UT,17462,278933,0,222,1184,67,338,180,150,9659,A,158,1184,485619,39620,407151,17462,1900,149,394,3124,296395,296395,3518,296395,3,23
VA,57994,487682,297,863,8509,243,759,125,197,7646,A+,1611,8509,543186,39620,407151,55504,1508,103,551,13721,545973,545676,14272,545676,4,22
VI,76,2502,9,961,5109,379,759,180,197,64,C,6,5109,485619,39620,407151,38775,6,149,2,10,2587,2578,12,2578,0,0
VT,1159,56686,0,11,5109,379,759,180,197,922,B,56,5109,485619,39620,407151,1159,56,149,12,805,57845,57845,817,57845,0,0
WA,28225,437844,0,267,4030,379,759,54,197,0,B,1265,4030,485619,39620,407151,28225,1265,149,-455,-8627,466069,466069,-9082,466069,10,27
WI,27615,460334,153,242,3220,94,710,180,197,19310,A+,744,3220,485619,39620,407151,24819,744,149,289,5771,488102,487949,6060,487949,0,17
WV,2543,148046,0,23,5109,3,759,2,197,1676,B,89,5109,485619,39620,407151,2452,1900,149,57,2136,150589,150589,2193,150589,1,0
WY,1197,26162,0,8,100,379,759,180,197,909,C,20,100,36228,1086,35141,947,1900,149,18,0,27359,27359,18,27359,0,2
AK,743,86175,0,16,5109,379,759,1,197,464,A,12,5109,86918,39620,407151,743,12,149,21,3266,86918,86918,3287,86918,0,0
AL,29549,309974,0,638,2443,379,717,180,418,15974,B,838,2443,485619,39620,407151,29126,828,10,547,7651,339523,339523,8198,339523,16,27
AR,15142,227092,0,224,1100,379,759,53,175,10082,B,224,1100,485619,39620,407151,15142,1900,149,511,6951,242234,242234,7462,242234,10,0
AS,0,174,0,961,5109,379,759,180,197,0,C,0,5109,485619,39620,407151,0,1900,149,0,0,174,174,0,174,0,0
AZ,49798,355482,0,1938,4252,546,759,368,197,7196,A+,1338,4252,404908,39620,407151,49426,1247,91,3109,9955,405280,405280,13064,405280,26,6
CA,169309,3065103,0,4582,5109,1332,759,180,197,0,B,5424,5109,3234412,39620,407151,169309,1900,149,3893,74817,3234412,3234412,78710,3234412,64,0
CO,30187,242882,0,250,5318,379,759,180,197,4296,A,1429,5318,485619,39620,407151,27453,1900,149,286,8337,273069,273069,8623,273069,12,10
CT,45715,350172,0,150,10099,379,759,180,197,7842,B,4251,10099,393475,39620,407151,43303,3394,857,158,3641,395887,395887,3799,395887,13,0
DC,9984,67969,0,177,5109,58,759,40,197,1166,A+,531,5109,485619,39620,407151,38775,1900,149,32,4130,77953,77953,4162,77953,1,0
DE,10681,81735,0,75,5109,379,759,180,197,6395,A,504,5109,485619,39620,407151,9632,446,58,70,1912,92416,92416,1982,92416,0,0
FL,93797,1467475,1630,961,13227,379,759,180,197,0,A,3237,13227,1844106,123815,1717070,93797,3237,149,4049,24352,1562902,1561272,28401,1561272,40,165
GA,63809,630575,0,944,9837,379,2140,180,197,0,A,2642,9837,688588,58013,630575,63809,1900,149,1800,22278,694384,694384,24078,694384,6,65
GU,222,9788,0,0,5109,0,759,0,197,173,A,5,5109,10066,214,9852,214,1900,149,22,273,10010,10010,295,10010,0,0
HI,789,65945,0,961,96,379,759,180,197,642,D,17,96,77620,39620,407151,38775,1900,149,27,963,66734,66734,990,66734,0,1
IA,25496,224711,0,182,5109,58,759,30,197,15963,A+,681,5109,485619,39620,407151,25496,1900,149,221,3337,250207,250207,3558,250207,0,0
ID,3871,67325,0,28,279,9,101,180,197,3183,A,89,279,70791,39620,407151,3466,69,20,128,1523,71196,71196,1651,71196,0,1
IL,137104,1200864,0,1696,5109,454,759,274,197,0,A,6829,5109,1336968,39620,407151,136104,6625,204,634,25331,1337968,1337968,25965,1337968,111,0
IN,42061,359741,0,768,6755,231,1444,113,197,31110,A+,2536,6755,485619,39620,407151,38775,2346,190,315,8600,401802,401802,8915,401802,20,24
KS,12059,135590,0,961,1035,379,338,180,146,715,A,254,1035,485619,39620,407151,38775,1900,149,0,0,147649,147649,0,147649,0,0
KY,13630,303531,0,354,2522,62,980,180,197,3530,B,524,2522,485619,39620,407151,13253,521,3,176,5758,317161,317161,5934,317161,2,28
LA,49385,555431,0,574,5109,379,759,73,197,37017,B,3104,5109,485619,39620,407151,38775,2992,112,870,13037,604816,604816,13907,604816,20,0
MA,106936,658001,0,964,11076,200,759,118,197,91404,A+,7828,11076,956716,39620,407151,102228,7647,181,286,13844,764937,764937,14130,764937,28,40
MD,63956,398324,0,644,10497,238,759,180,197,4745,A,3052,10497,555874,39620,407151,63956,2923,129,408,8203,462280,462280,8611,462280,22,50
ME,2938,76638,0,29,333,13,759,5,197,2380,B,102,333,79248,3592,75537,2610,102,149,25,2390,79576,79576,2415,79576,0,5
MI,67545,827089,0,557,5109,209,759,99,197,49290,A+,6087,5109,911028,83939,827089,61084,5843,244,448,14258,894634,894634,14706,894634,20,0
MN,32467,459576,0,324,3767,161,1155,180,197,28205,A,1404,3767,492043,39620,407151,32467,1372,32,436,16455,492043,492043,16891,492043,11,19
MO,17590,293525,0,415,5109,379,759,66,197,0,B,955,5109,270232,17275,252506,17590,1900,149,389,4442,311115,311115,4831,311115,7,0
MP,30,8139,0,961,5109,379,759,180,197,19,D,2,5109,8169,39620,407151,30,2,149,0,0,8169,8169,0,8169,0,0
MS,20641,218074,0,465,2767,159,759,108,197,15323,A,938,2767,238574,39620,407151,20500,922,16,0,0,238715,238715,0,238715,0,0
MT,698,68832,0,10,85,379,759,180,197,548,C,20,85,485619,39620,407151,698,1900,149,32,1076,69530,69530,1108,69530,0,3
NC,51389,679952,0,883,5109,379,759,180,197,29219,A,1212,5109,485619,39620,407151,51389,1212,149,1549,17479,731341,731341,19028,731341,15,0
ND,3251,90980,0,28,213,379,759,180,197,2882,D,71,213,152043,39620,407151,3251,65,6,25,1600,94231,94231,1625,94231,0,3
NE,17591,134263,0,141,1200,379,759,180,197,11312,D,244,1200,485619,39620,407151,17591,1900,149,176,3832,151854,151854,4008,151854,4,34
NH,5486,100081,0,61,549,379,159,180,197,4209,B,337,549,485619,39620,407151,5486,1900,149,36,1806,105567,105567,1842,105567,6,16
NJ,168834,1050039,0,1125,19267,286,759,238,197,29318,A+,12857,19267,485619,39620,407151,168834,12857,149,338,24192,1218873,1218873,24530,1218873,22,0
NM,10260,274342,0,147,1735,379,759,180,197,4512,C,464,1735,485619,39620,407151,10260,1900,149,107,4320,284602,284602,4427,284602,8,9
NV,12931,226032,0,370,5109,87,759,49,197,652,A+,491,5109,274879,39620,407151,12931,1900,149,445,4158,238963,238963,4603,238963,0,0
NY,387272,2940521,0,1220,89995,335,759,237,197,69506,A,24710,89995,485619,39620,407151,387272,1900,149,716,68114,3327793,3327793,68830,3327793,24,0
OH,44262,585703,0,482,7201,186,1833,118,197,0,B,2697,7201,485619,39620,407151,41062,2460,237,531,13398,629965,629965,13929,629965,30,34
OK,10037,271925,0,197,1229,93,759,180,197,7414,A+,368,1229,283875,11340,271925,10037,1900,149,331,7053,281962,281962,7384,281962,1,20
OR,6750,187345,0,154,946,50,759,29,197,2533,A+,189,946,485619,39620,407151,6344,1900,149,178,0,194095,194095,178,194095,1,0
PA,81266,566461,0,715,5109,379,759,161,197,62574,A+,6419,5109,485619,39620,407151,78947,1900,149,504,10005,647727,647727,10509,647727,20,0
PR,6463,113280,0,83,5109,10,759,4,197,0,C,147,5109,114723,2326,112331,1531,57,90,268,0,119743,119743,268,119743,0,0
RI,16449,125078,0,123,1922,23,759,12,197,1515,A+,894,1922,224148,23263,200885,16449,1900,149,36,681,141527,141527,717,141527,0,0
SC,23786,272463,0,673,2294,379,759,180,197,10790,A,644,2294,296219,31553,264666,23756,644,0,1155,6794,296249,296249,7949,296249,5,0
SD,6225,65690,0,91,598,379,759,180,197,5335,B,81,598,485619,39620,407151,38775,1900,149,67,655,71915,71915,722,71915,0,9
TN,34446,640894,0,588,2266,379,759,180,197,22838,B,524,2266,675101,40201,634900,34207,503,21,429,13222,675340,675340,13651,675340,9,28
TX,107735,1355663,0,3247,5109,379,759,180,197,67096,B,2165,5109,1463398,39620,407151,107735,1900,149,4430,35054,1463398,1463398,39484,1463398,25,0
UT,17068,275809,0,232,1161,66,333,180,149,9390,A,155,1161,485619,39620,407151,17068,1900,149,643,4876,292877,292877,5519,292877,0,16
VA,57443,473961,303,880,8487,267,759,133,197,7607,A+,1607,8487,528914,39620,407151,54953,1504,103,650,18343,531707,531404,18993,531404,5,62
VI,74,2492,20,961,5109,379,759,180,197,64,C,6,5109,485619,39620,407151,38775,6,149,0,42,2586,2566,42,2566,0,0
VT,1147,55881,0,9,5109,379,759,180,197,920,B,56,5109,485619,39620,407151,1147,56,149,3,1138,57028,57028,1141,57028,0,0
WA,28680,446471,0,245,4003,379,759,49,197,0,B,1255,4003,485619,39620,407151,28658,1255,149,14,675,475151,475151,689,475151,10,44
WI,27326,454563,155,239,3203,90,708,180,197,18951,A+,744,3203,485619,39620,407151,24539,744,149,413,9812,482044,481889,10225,481889,14,26
WV,2486,145910,0,22,5109,6,759,2,197,1669,B,88,5109,485619,39620,407151,2403,1900,149,51,2331,148396,148396,2382,148396,0,0
WY,1179,26162,0,8,98,379,759,180,197,896,C,20,98,36228,1086,35141,930,1900,149,6,-9139,27341,27341,-9133,27341,0,0
AK,722,82909,0,18,5109,379,759,1,197,457,A,12,5109,83631,39620,407151,722,12,149,14,2432,83631,83631,2446,83631,0,0
AL,29002,302323,0,650,2416,379,710,180,415,15974,B,822,2416,485619,39620,407151,28583,812,10,796,7995,331325,331325,8791,331325,12,43
AR,14631,220141,0,224,1100,379,759,53,175,9712,B,214,1100,485619,39620,407151,14631,1900,149,703,5635,234772,234772,6338,234772,6,26
AS,0,174,0,961,5109,379,759,180,197,0,C,0,5109,485619,39620,407151,0,1900,149,0,0,174,174,0,174,0,0
AZ,46689,345527,0,1832,4246,519,759,362,197,7018,A+,1312,4246,391850,39620,407151,46323,1224,88,3246,9238,392216,392216,12484,392216,41,5
CA,165416,2990286,0,4587,5109,1329,759,180,197,0,B,5360,5109,3155702,39620,407151,165416,1900,149,4317,76855,3155702,3155702,81172,3155702,70,0
CO,29901,234545,0,270,5308,379,759,180,197,4280,A,1417,5308,485619,39620,407151,27218,1900,149,228,2002,264446,264446,2230,264446,15,14
CT,45557,346531,0,172,10099,379,759,180,197,7842,B,4238,10099,389703,39620,407151,43172,3385,853,117,11678,392088,392088,11795,392088,12,0
DC,9952,63839,0,184,5109,63,759,44,197,1162,A+,530,5109,485619,39620,407151,38775,1900,149,49,1543,73791,73791,1592,73791,3,0
DE,10611,79823,0,75,5109,379,759,180,197,6395,A,504,5109,485619,39620,407151,9580,446,58,112,1638,90434,90434,1750,90434,2,0
FL,89748,1443123,1578,961,13062,379,759,180,197,0,A,3197,13062,1809654,118915,1687546,89748,3197,149,3822,17737,1534449,1532871,21559,1532871,43,200
GA,62009,608297,0,937,9772,379,2122,180,197,0,A,2636,9772,663975,55678,608297,62009,1900,149,1097,6005,670306,670306,7102,670306,31,109
GU,200,9515,0,0,5109,0,759,0,197,173,B,5,5109,9707,192,9515,192,1900,149,7,120,9715,9715,127,9715,0,0
HI,762,64982,0,961,95,379,759,180,197,640,D,17,95,76340,39620,407151,38775,1900,149,18,1352,65744,65744,1370,65744,0,0
IA,25275,221374,0,197,5109,60,759,37,197,15816,A+,681,5109,485619,39620,407151,25275,1900,149,421,5297,246649,246649,5718,246649,2,0
ID,3743,65802,0,28,278,9,101,180,197,3088,A,89,278,69156,39620,407151,3354,69,20,111,1422,69545,69545,1533,69545,1,3
IL,136470,1175533,0,1837,5109,512,759,293,197,0,A,6718,5109,1311003,39620,407151,135470,6580,204,831,26479,1312003,1312003,27310,1312003,0,0
IN,41746,351141,0,773,6731,259,1465,111,197,30760,A+,2516,6731,485619,39620,407151,38775,2327,189,308,7857,392887,392887,8165,392887,25,142
KS,12059,135590,0,961,1035,379,338,180,146,715,A,254,1035,485619,39620,407151,38775,1900,149,378,5147,147649,147649,5525,147649,7,24
KY,13454,297773,0,339,2494,64,978,180,197,3516,B,522,2494,485619,39620,407151,13097,519,3,257,4590,311227,311227,4847,311227,2,12
LA,48515,542394,0,561,5109,379,759,75,197,37017,B,3084,5109,485619,39620,407151,38775,2972,112,-119,45807,590909,590909,45688,590909,22,0
MA,106650,644157,0,994,11036,199,759,124,197,91404,A+,7800,11036,939352,39620,407151,102005,7619,181,228,9319,750807,750807,9547,750807,30,51
MD,63548,390121,0,648,10447,261,759,180,197,4685,A,3030,10447,544072,39620,407151,63548,2901,129,319,5742,453669,453669,6061,453669,14,90
ME,2913,74248,0,26,328,11,759,5,197,2323,A,102,328,77920,3554,74248,2586,102,149,35,3066,77161,77161,3101,77161,0,5
MI,67097,812831,0,557,5109,209,759,99,197,44964,A+,6067,5109,896382,83551,812831,60829,5823,244,299,29443,879928,879928,29742,879928,6,0
MN,32031,443121,0,339,3748,168,1150,180,197,27709,A,1393,3748,475152,39620,407151,32031,1361,32,356,13917,475152,475152,14273,475152,17,30
MO,17201,289083,0,594,5109,379,759,70,197,0,B,948,5109,270232,17275,252506,17201,1900,149,293,8649,306284,306284,8942,306284,2,0
MP,30,8139,0,961,5109,379,759,180,197,19,D,2,5109,8169,39620,407151,30,2,149,0,0,8169,8169,0,8169,0,0
MS,20641,218074,0,661,2767,159,759,108,197,15323,A,938,2767,238574,39620,407151,20641,922,16,0,0,238715,238715,0,238715,0,0
MT,666,67756,0,9,82,379,759,180,197,546,C,20,82,485619,39620,407151,666,1900,149,11,1541,68422,68422,1552,68422,0,1
NC,49840,662473,0,871,5109,379,759,180,197,29219,A,1197,5109,485619,39620,407151,49840,1197,149,1652,16983,712313,712313,18635,712313,22,0
ND,3226,89380,0,26,210,379,759,180,197,2840,D,71,210,148099,39620,407151,3226,65,6,33,1919,92606,92606,1952,92606,1,2
NE,17415,130431,0,149,1166,379,759,180,197,11066,D,240,1166,485619,39620,407151,17415,1900,149,189,2844,147846,147846,3033,147846,6,25
NH,5450,98275,0,56,533,379,158,180,197,4140,B,331,533,485619,39620,407151,5450,1900,149,14,1727,103725,103725,1741,103725,1,2
NJ,168496,1025847,0,1177,19267,286,759,231,197,29209,A+,12835,19267,485619,39620,407151,168496,12835,149,389,22220,1194343,1194343,22609,1194343,35,257
NM,10153,270022,0,157,1726,379,759,180,197,4439,C,456,1726,485619,39620,407151,10153,1900,149,88,4190,280175,280175,4278,280175,4,11
NV,12486,221874,0,370,5109,87,759,49,197,652,A+,491,5109,269097,39620,407151,12486,1900,149,410,3154,234360,234360,3564,234360,2,0
NY,386556,2872407,0,1284,89995,359,759,256,197,69377,A,24686,89995,485619,39620,407151,386556,1900,149,796,78507,3258963,3258963,79303,3258963,25,0
OH,43731,572305,0,525,7167,200,1820,133,197,0,B,2667,7167,485619,39620,407151,40549,2430,237,609,15403,616036,616036,16012,616036,34,63
OK,9706,264872,0,211,1209,96,759,180,197,7212,A+,367,1209,276316,10834,264872,9706,1900,149,352,4673,274578,274578,5025,274578,1,63
OR,6572,187345,0,154,946,50,759,29,197,2533,A+,188,946,485619,39620,407151,6344,1900,149,206,4575,193917,193917,4781,193917,1,13
PA,80762,556456,0,731,5109,379,759,169,197,62186,A+,6399,5109,485619,39620,407151,78451,1900,149,526,12624,637218,637218,13150,637218,38,0
PR,6195,113280,0,78,5109,7,759,3,197,0,C,147,5109,114723,2326,112331,1499,57,90,84,0,119475,119475,84,119475,0,0
RI,16413,124397,0,123,1922,23,759,12,197,1515,A+,894,1922,222392,23189,199203,16413,1900,149,59,1181,140810,140810,1240,140810,9,11
SC,22631,265669,0,660,2294,379,759,180,197,10790,A,639,2294,288277,30232,258045,22608,639,0,1083,6694,288300,288300,7777,288300,18,239
SD,6158,65035,0,95,589,379,759,180,197,5276,B,81,589,485619,39620,407151,38775,1900,149,49,791,71193,71193,840,71193,3,4
TN,34017,627672,0,635,2238,379,759,180,197,22531,B,515,2238,667336,39664,627672,33776,494,21,1188,8107,661689,661689,9295,661689,6,29
TX,103305,1320609,0,3148,5109,379,759,180,197,65329,B,2140,5109,1423914,39620,407151,103305,1900,149,3454,12719,1423914,1423914,16173,1423914,35,0
UT,16425,270933,0,237,1145,63,330,180,148,9113,A,155,1145,485619,39620,407151,16425,1900,149,586,4087,287358,287358,4673,287358,3,25
VA,56793,455618,285,862,8425,251,759,121,197,7563,A+,1602,8425,509930,39620,407151,54312,1499,103,555,9788,512696,512411,10343,512411,16,75
VI,74,2450,11,961,5109,379,759,180,197,64,C,6,5109,485619,39620,407151,38775,6,149,1,96,2535,2524,97,2524,0,0
VT,1144,54743,0,8,5109,379,759,180,197,918,B,56,5109,485619,39620,407151,1144,56,149,9,1133,55887,55887,1142,55887,0,0
WA,28666,445796,0,276,3959,379,759,47,197,0,B,1245,3959,485619,39620,407151,28644,1245,149,91,4328,474462,474462,4419,474462,19,21
WI,26913,444751,158,240,3177,91,704,180,197,18055,A+,730,3177,485619,39620,407151,24154,730,149,323,10838,471822,471664,11161,471664,11,17
WV,2435,143579,0,22,5109,6,759,2,197,1665,B,88,5109,485619,39620,407151,2353,1900,149,17,1568,146014,146014,1585,146014,0,0
WY,1173,35301,0,8,98,379,759,180,197,889,C,20,98,36228,1086,35141,927,1900,149,29,291,36474,36474,320,36474,2,1
AK,708,80477,0,18,5109,379,759,0,197,449,A,12,5109,81185,39620,407151,708,12,149,12,3464,81185,81185,3476,81185,0,0
AL,28206,294328,0,668,2373,379,695,180,405,15974,B,810,2373,485619,39620,407151,27796,801,9,894,10917,322534,322534,11811,322534,20,21
AR,13928,214506,0,226,1074,379,759,53,173,9376,B,208,1074,485619,39620,407151,13928,1900,149,322,7413,228434,228434,7735,228434,11,22
AS,0,174,0,961,5109,379,759,180,197,0,C,0,5109,485619,39620,407151,0,1900,149,0,0,174,174,0,174,0,0
AZ,43443,336289,0,1667,4241,540,759,341,197,6863,A+,1271,4241,379374,39620,407151,43085,1184,87,2519,11020,379732,379732,13539,379732,32,17
CA,161099,2913431,0,4584,5109,1298,759,180,197,0,B,5290,5109,3074530,39620,407151,161099,1900,149,4084,72458,3074530,3074530,76542,3074530,82,0
CO,29673,232543,0,270,5294,379,759,180,197,4253,A,1402,5294,485619,39620,407151,27003,1900,149,231,5318,262216,262216,5549,262216,29,22
CT,45440,334853,0,176,10099,379,759,180,197,7842,B,4226,10099,377931,39620,407151,43078,3378,848,11,7003,380293,380293,7014,380293,7,187
DC,9903,62296,0,189,5109,86,759,45,197,1155,A+,527,5109,485619,39620,407151,38775,1900,149,56,2057,72199,72199,2113,72199,4,0
DE,10499,78185,0,79,5109,379,759,180,197,6350,A,502,5109,485619,39620,407151,9524,444,58,55,2042,88684,88684,2097,88684,0,0
FL,85926,1425386,1457,961,12862,379,759,180,197,0,A,3154,12862,1783115,114435,1665500,85926,3154,149,3207,22346,1512769,1511312,25553,1511312,44,189
GA,60912,602292,0,921,9663,379,2109,180,197,0,A,2605,9663,657419,55127,602292,60912,1900,149,882,11855,663204,663204,12737,663204,30,120
GU,193,9395,0,0,5109,0,759,0,197,170,A,5,5109,9260,184,9076,185,1900,149,5,385,9588,9588,390,9588,0,0
HI,744,63630,0,961,95,379,759,180,197,639,D,17,95,74533,39620,407151,38775,1900,149,4,1127,64374,64374,1131,64374,0,3
IA,24854,216077,0,188,5109,64,759,47,197,15604,A+,679,5109,485619,39620,407151,24854,1900,149,393,5407,240931,240931,5800,240931,6,0
ID,3632,64380,0,23,275,7,101,180,197,3013,A,88,275,67638,39620,407151,3258,68,20,92,1136,68012,68012,1228,68012,0,0
IL,135639,1149054,0,1878,5109,538,759,321,197,0,A,6718,5109,1283832,39620,407151,134778,6537,181,593,24911,1284693,1284693,25504,1284693,52,0
IN,41438,343284,0,754,6589,236,1389,103,197,30175,A+,2491,6589,485619,39620,407151,38775,2304,187,425,13115,384722,384722,13540,384722,16,63
KS,11681,130443,0,961,1011,379,333,180,146,696,A,247,1011,485619,39620,407151,38775,1900,149,0,0,142124,142124,0,142124,0,0
KY,13197,293183,0,400,2482,68,975,180,197,3506,B,520,2482,485619,39620,407151,12846,518,2,202,6309,306380,306380,6511,306380,2,27
LA,48634,496587,0,585,5109,379,759,83,197,37017,B,3062,5109,485619,39620,407151,38775,2950,112,0,0,545221,545221,0,545221,0,0
MA,106422,634838,0,968,10985,227,759,125,197,91404,A+,7770,10985,926804,39620,407151,101853,7591,179,271,8943,741260,741260,9214,741260,36,60
MD,63229,384379,0,660,10357,269,759,180,197,4640,A,3016,10357,535444,39620,407151,63229,2886,130,260,6005,447608,447608,6265,447608,20,48
ME,2878,71182,0,27,323,10,759,4,197,2300,A,102,323,74763,3466,71182,2555,102,149,42,0,74060,74060,42,74060,0,0
MI,66798,783388,0,557,5109,209,759,101,197,44964,A+,6061,5109,866277,82889,783388,60618,5818,243,301,0,850186,850186,301,850186,25,0
MN,31675,429204,0,345,3718,171,1144,180,197,27566,A,1376,3718,460879,39620,407151,31675,1344,32,379,11913,460879,460879,12292,460879,19,29
MO,16908,280434,0,533,5109,379,759,64,197,0,B,946,5109,270232,17275,252506,16908,1900,149,283,12057,297342,297342,12340,297342,37,0
MP,30,8139,0,961,5109,379,759,180,197,19,D,2,5109,8169,39620,407151,30,2,149,0,0,8169,8169,0,8169,0,0
MS,20641,218074,0,668,2767,161,759,100,197,15323,A,938,2767,238574,39620,407151,20500,922,16,0,-5674,238715,238715,-5674,238715,0,0
MT,655,66215,0,8,81,379,759,180,197,545,C,20,81,485619,39620,407151,655,1900,149,25,1330,66870,66870,1355,66870,0,3
NC,48188,645490,0,857,5109,379,759,180,197,29219,A,1175,5109,485619,39620,407151,48188,1175,149,1333,24923,693678,693678,26256,693678,7,0
ND,3193,87461,0,26,208,379,759,180,197,2809,D,70,208,144282,39620,407151,3193,64,6,27,953,90654,90654,980,90654,0,7
NE,17226,127587,0,156,1141,379,759,180,197,10761,D,234,1141,485619,39620,407151,17226,1900,149,195,2231,144813,144813,2426,144813,3,25
NH,5436,96548,0,56,531,379,156,180,197,4104,B,330,531,485619,39620,407151,5436,1900,149,72,1826,101984,101984,1898,101984,4,10
NJ,168107,1003627,0,1258,19010,319,759,257,197,29101,A+,12800,19010,485619,39620,407151,168107,12800,149,404,23489,1171734,1171734,23893,1171734,31,0
NM,10065,265832,0,161,1715,379,759,180,197,4351,C,452,1715,485619,39620,407151,10065,1900,149,132,4212,275897,275897,4344,275897,5,17
NV,12076,218720,0,357,5109,93,759,55,197,641,A+,489,5109,264568,39620,407151,12076,1900,149,234,2952,230796,230796,3186,230796,3,0
NY,385760,2793900,0,1358,89995,388,759,278,197,69243,A,24661,89995,485619,39620,407151,385760,1900,149,618,67923,3179660,3179660,68541,3179660,32,0
OH,43122,556902,0,547,7104,219,1807,149,197,0,B,2633,7104,485619,39620,407151,39973,2401,232,700,14761,600024,600024,15461,600024,22,53
OK,9354,260199,0,197,1146,89,759,180,197,7071,A+,366,1146,271339,10535,260199,9354,1900,149,450,3671,269553,269553,4121,269553,2,0
OR,6366,182770,0,141,933,46,759,28,197,2502,A+,187,933,485619,39620,407151,6140,1900,149,148,4638,189136,189136,4786,189136,4,4
PA,80236,543832,0,740,5109,379,759,170,197,60979,A+,6361,5109,485619,39620,407151,77949,1900,149,418,10819,624068,624068,11237,624068,42,0
PR,6111,113280,0,73,5109,9,759,5,197,0,C,147,5109,114723,2326,112331,1496,57,90,108,0,119391,119391,108,119391,0,0
RI,16354,123216,0,126,1911,23,759,13,197,1502,A+,885,1911,218832,23058,195774,16354,1900,149,71,1219,139570,139570,1290,139570,9,13
SC,21548,258975,0,626,2055,379,759,180,197,9734,A,621,2055,280523,28983,251540,21533,621,0,992,6777,280523,280523,7769,280523,4,0
SD,6109,64244,0,93,585,379,759,180,197,5221,B,78,585,485619,39620,407151,38775,1900,149,59,1306,70353,70353,1365,70353,0,15
TN,32829,619565,0,617,2209,379,759,180,197,21949,B,509,2209,652160,38194,613966,32595,488,21,686,7135,652394,652394,7821,652394,12,29
TX,99851,1307890,0,2947,5109,379,759,180,197,63812,B,2105,5109,1407741,39620,407151,99851,1900,149,3516,34587,1407741,1407741,38103,1407741,43,0
UT,15839,266846,0,282,1120,66,326,180,145,8786,A,152,1120,485619,39620,407151,15839,1900,149,495,3498,282685,282685,3993,282685,3,18
VA,56238,445830,259,857,8350,241,759,129,197,7493,A+,1586,8350,499599,39620,407151,53769,1482,104,463,7264,502327,502068,7727,502068,3,-17
VI,73,2354,13,961,5109,379,759,180,197,64,C,6,5109,485619,39620,407151,38775,6,149,0,0,2440,2427,0,2427,0,0
VT,1135,53610,0,11,5109,379,759,180,197,917,B,56,5109,485619,39620,407151,1135,56,149,5,1077,54745,54745,1082,54745,1,0
WA,28575,441468,0,263,3938,379,759,47,197,0,B,1226,3938,485619,39620,407151,28556,1226,149,320,6299,470043,470043,6619,470043,-5,23
WI,26590,433913,174,240,3160,83,701,180,197,18055,A+,719,3160,485619,39620,407151,23876,719,149,461,10177,460677,460503,10638,460503,7,32
WV,2418,142011,0,25,5109,5,759,2,197,1665,B,88,5109,485619,39620,407151,2336,1900,149,42,3017,144429,144429,3059,144429,0,0
WY,1144,35010,0,8,97,379,759,180,197,870,C,18,97,35916,1025,33164,906,1900,149,30,1055,36154,36154,1085,36154,0,0
AK,696,77013,0,23,5109,379,759,0,197,438,A,12,5109,77709,39620,407151,696,12,149,20,1474,77709,77709,1494,77709,0,0
AL,27312,283411,0,688,2352,379,687,180,401,15974,B,790,2352,485619,39620,407151,26914,784,6,400,4899,310723,310723,5299,310723,5,37
AR,13606,207093,0,217,1052,379,759,53,168,8996,A,197,1052,485619,39620,407151,13606,1900,149,415,14718,220699,220699,15133,220699,15,26
AS,0,174,0,961,5109,379,759,180,197,0,C,0,5109,485619,39620,407151,0,1900,149,0,0,174,174,0,174,0,0
AZ,40924,325269,0,1582,4224,531,759,346,197,6715,A+,1239,4224,365846,39620,407151,40577,1159,80,1827,10032,366193,366193,11859,366193,20,15
CA,157015,2840973,0,4522,5109,1318,759,180,197,0,B,5208,5109,2997988,39620,407151,157015,1900,149,3455,56778,2997988,2997988,60233,2997988,87,0
CO,29442,227225,0,290,5272,379,759,180,197,4231,A,1373,5272,485619,39620,407151,26795,1900,149,143,3368,256667,256667,3511,256667,0,3
CT,45429,327850,0,186,9912,379,759,180,197,7611,B,4219,9912,370638,39620,407151,42788,3373,846,80,4491,373279,373279,4571,373279,9,0
DC,9847,60239,0,197,5109,73,759,47,197,1155,A+,523,5109,485619,39620,407151,38775,1900,149,29,2931,70086,70086,2960,70086,3,0
DE,10444,76143,0,83,5109,379,759,180,197,6305,A,502,5109,485619,39620,407151,9470,444,58,41,472,86587,86587,513,86587,3,0
FL,82719,1403040,1240,961,12673,379,759,180,197,0,A,3110,12673,1752714,110650,1638911,82719,3110,149,2610,22840,1486999,1485759,25450,1485759,25,184
GA,60030,590437,0,881,9543,379,2084,180,197,0,A,2575,9543,644723,54286,590437,60030,1900,149,952,14537,650467,650467,15489,650467,46,89
GU,188,9010,0,0,5109,0,759,0,197,170,A,5,5109,9096,181,8914,180,1900,149,2,164,9198,9198,166,9198,0,0
HI,740,62503,0,961,92,379,759,180,197,637,D,17,92,73078,39620,407151,38775,1900,149,4,1211,63243,63243,1215,63243,0,1
IA,24461,210670,0,188,5109,64,759,47,197,15289,A+,673,5109,485619,39620,407151,24461,1900,149,282,4211,235131,235131,4493,235131,4,0
ID,3540,63244,0,28,275,8,101,180,197,2921,A,88,275,66441,39620,407151,3197,68,20,78,1059,66784,66784,1137,66784,0,5
IL,135046,1124143,0,1878,5109,563,759,331,197,0,A,6666,5109,1258328,39620,407151,134185,6485,181,546,29441,1259189,1259189,29987,1259189,87,0
IN,41013,330169,0,789,6526,238,1384,105,197,29671,A+,2475,6526,485619,39620,407151,38775,2289,186,227,7210,371182,371182,7437,371182,28,45
KS,11681,130443,0,961,1011,379,333,180,146,696,A,247,1011,485619,39620,407151,38775,1900,149,262,4900,142124,142124,5162,142124,2,23
KY,12995,286874,0,416,2455,61,971,180,197,3444,B,518,2455,485619,39620,407151,12646,516,2,166,3670,299869,299869,3836,299869,6,19
LA,48634,496587,0,585,5109,379,759,83,197,37017,B,3062,5109,485619,39620,407151,38775,2950,112,928,11576,545221,545221,12504,545221,20,0
MA,106151,625895,0,998,10925,227,759,135,197,88725,A+,7734,10925,914751,39620,407151,101654,7568,166,266,8133,732046,732046,8399,732046,69,58
MD,62969,378374,0,702,10309,283,759,180,197,4596,A,2996,10309,526882,39620,407151,62969,2866,130,560,11558,441343,441343,12118,441343,14,47
ME,2836,71182,0,27,323,10,759,5,197,2275,A,102,323,74763,3466,71182,2509,102,149,17,1666,74018,74018,1683,74018,1,2
MI,66497,783388,0,562,5109,210,759,131,197,44964,A+,6036,5109,866277,82889,783388,60393,5792,244,228,14123,849885,849885,14351,849885,2,0
MN,31296,417291,0,351,3689,181,1136,180,197,27404,A,1357,3689,448587,39620,407151,31296,1325,32,414,19028,448587,448587,19442,448587,13,31
MO,16625,268377,0,533,5109,379,759,66,197,0,B,909,5109,270232,17275,252506,16625,1900,149,211,0,285002,285002,211,285002,27,0
MP,30,8139,0,961,5109,379,759,180,197,19,D,2,5109,8169,39620,407151,30,2,149,0,0,8169,8169,0,8169,0,0
MS,20641,223748,0,668,2767,161,759,100,197,15323,A,938,2767,238574,39620,407151,20500,922,16,489,3097,244389,244389,3586,244389,23,39
MT,630,64885,0,5,78,379,759,180,197,538,C,20,78,485619,39620,407151,630,1900,149,16,1922,65515,65515,1938,65515,1,-1
NC,46855,620567,0,846,5109,379,759,180,197,29219,A,1168,5109,485619,39620,407151,46855,1168,149,1002,14999,667422,667422,16001,667422,14,0
ND,3166,86508,0,25,201,379,759,180,197,2756,D,70,201,140098,39620,407151,3166,66,4,42,981,89674,89674,1023,89674,1,1
NE,17031,125356,0,156,1116,379,759,180,197,10529,D,231,1116,485619,39620,407151,17031,1900,149,180,2694,142387,142387,2874,142387,11,28
NH,5364,94722,0,62,521,379,155,180,197,4067,B,326,521,485619,39620,407151,5364,1900,149,19,1194,100086,100086,1213,100086,6,2
NJ,167703,980138,0,1352,19010,358,759,254,197,28966,A+,12769,19010,485619,39620,407151,167703,12769,149,277,15782,1147841,1147841,16059,1147841,42,131
NM,9933,261620,0,156,1698,379,759,180,197,4217,C,447,1698,485619,39620,407151,9933,1900,149,88,3544,271553,271553,3632,271553,7,12
NV,11842,215768,0,360,5109,96,759,45,197,640,A+,486,5109,260801,39620,407151,11842,1900,149,184,4952,227610,227610,5136,227610,1,0
NY,385142,2725977,0,1479,89995,431,759,304,197,69085,A,24629,89995,485619,39620,407151,385142,1900,149,567,58774,3111119,3111119,59341,3111119,21,0
OH,42422,542141,0,541,7051,215,1797,148,197,0,B,2611,7051,485619,39620,407151,39303,2377,234,412,16018,584563,584563,16430,584563,14,44
OK,8904,256528,0,181,1146,92,759,180,197,6898,A+,364,1146,267424,10296,256528,8904,1900,149,259,3368,265432,265432,3627,265432,1,16
OR,6218,178132,0,158,929,54,759,26,197,2457,A+,183,929,485619,39620,407151,6007,1900,149,120,4692,184350,184350,4812,184350,1,17
PA,79818,533013,0,788,5109,379,759,179,197,59863,A+,6319,5109,485619,39620,407151,77543,1900,149,335,9404,612831,612831,9739,612831,43,0
PR,6003,113280,0,78,5109,8,759,1,197,0,C,147,5109,114723,2326,112331,1486,57,90,52,0,119283,119283,52,119283,0,0
RI,16283,121997,0,126,1898,17,759,13,197,1489,A+,876,1898,215817,22913,192904,16283,1900,149,51,1207,138280,138280,1258,138280,11,9
SC,20556,252198,0,607,2055,379,759,180,197,9734,A,617,2055,272749,27792,244957,20551,617,0,566,4509,272754,272754,5075,272754,10,0
SD,6050,62938,0,91,570,379,759,180,197,5143,B,78,570,485619,39620,407151,38775,1900,149,84,1702,68988,68988,1786,68988,1,8
TN,32143,612430,0,632,2180,379,759,180,197,21282,B,497,2180,644344,37420,606924,31914,476,21,313,5270,644573,644573,5583,644573,4,34
TX,96335,1273303,0,2793,5109,379,759,180,197,62368,B,2062,5109,1369638,39620,407151,96335,1900,149,3129,18067,1369638,1369638,21196,1369638,33,0
UT,15344,263348,0,270,1102,64,321,180,142,8552,A,149,1102,485619,39620,407151,15344,1900,149,407,2585,278692,278692,2992,278692,4,29
VA,55775,438566,313,938,8367,249,759,120,197,7429,A+,1583,8367,491884,39620,407151,53318,1478,105,444,8459,494654,494341,8903,494341,13,122
VI,73,2354,13,961,5109,379,759,180,197,64,C,6,5109,485619,39620,407151,38775,6,149,0,49,2440,2427,49,2427,0,0
VT,1130,52533,0,5,5109,379,759,180,197,915,B,55,5109,485619,39620,407151,1130,55,149,-1,774,53663,53663,773,53663,0,0
WA,28255,435169,0,256,3915,379,759,47,197,0,B,1231,3915,485619,39620,407151,28233,1231,149,330,8583,463424,463424,8913,463424,10,21
WI,26129,423736,179,244,3128,94,696,180,197,17613,A+,712,3128,485619,39620,407151,23454,712,149,285,9406,450044,449865,9691,449865,9,32
WV,2376,138994,0,23,5109,7,759,2,197,1654,B,88,5109,485619,39620,407151,2295,1900,149,35,4264,141370,141370,4299,141370,0,0
WY,1114,33955,0,7,97,379,759,180,197,862,C,18,97,34839,1025,33164,884,1900,149,25,631,35069,35069,656,35069,0,1
AK,676,75539,0,22,5109,379,759,2,197,429,A,12,5109,76215,39620,407151,676,12,149,12,1766,76215,76215,1778,76215,0,0
AL,26912,278512,0,683,2315,379,682,180,399,13508,B,785,2315,485619,39620,407151,26524,779,6,640,2110,305424,305424,2750,305424,11,56
AR,13191,192375,0,214,1026,379,759,45,165,8352,A,182,1026,485619,39620,407151,13191,1900,149,274,1154,205566,205566,1428,205566,0,23
AS,0,174,0,961,5109,379,759,180,197,0,C,0,5109,485619,39620,407151,0,1900,149,0,0,174,174,0,174,0,0
AZ,39097,315237,0,1506,4209,502,759,340,197,6598,A+,1219,4209,353991,39620,407151,38754,1140,79,2392,6685,354334,354334,9077,354334,25,27
CA,153560,2784195,0,4462,5109,1272,759,180,197,0,B,5121,5109,2937755,39620,407151,153560,1900,149,2108,67465,2937755,2937755,69573,2937755,32,0
CO,29299,223857,0,276,5269,379,759,180,197,4196,A,1373,5269,485619,39620,407151,26666,1900,149,169,3902,253156,253156,4071,253156,25,25
CT,45349,323359,0,201,9912,379,759,180,197,7611,B,4210,9912,365916,39620,407151,42557,3362,848,114,6321,368708,368708,6435,368708,6,0
DC,9818,57308,0,192,5109,70,759,49,197,1155,A+,520,5109,485619,39620,407151,38775,1900,149,19,1261,67126,67126,1280,67126,5,0
DE,10403,75671,0,87,5109,379,759,180,197,6256,A,499,5109,485619,39620,407151,9429,441,58,63,1325,86074,86074,1388,86074,1,0
FL,80109,1380200,1150,961,12489,379,759,180,197,0,A,3085,12489,1722067,107506,1611442,80109,3085,149,2783,27342,1461459,1460309,30125,1460309,55,191
GA,59078,575900,0,875,9454,379,2065,180,197,0,A,2529,9454,629273,53373,575900,59078,1900,149,664,3818,634978,634978,4482,634978,35,132
GU,186,8846,0,961,5109,379,759,180,197,169,B,5,5109,8801,176,8624,178,1900,149,1,273,9032,9032,274,9032,0,0
HI,736,61292,0,961,91,379,759,180,197,630,D,17,91,71575,39620,407151,38775,1900,149,8,546,62028,62028,554,62028,0,0
IA,24179,206459,0,193,5109,71,759,49,197,15025,A+,669,5109,485619,39620,407151,24179,1900,149,126,3124,230638,230638,3250,230638,14,0
ID,3462,62185,0,24,270,6,100,180,197,2877,A,88,270,65306,39620,407151,3121,68,20,63,2604,65647,65647,2667,65647,1,4
IL,134500,1094702,0,1939,5109,561,759,331,197,0,A,6579,5109,1228341,39620,407151,133639,6398,181,623,18106,1229202,1229202,18729,1229202,72,0
IN,40786,322959,0,860,6481,313,1383,121,197,29093,A+,2447,6481,485619,39620,407151,38775,2265,182,356,7560,363745,363745,7916,363745,14,30
KS,11419,125543,0,961,988,379,327,180,143,676,A,245,988,485619,39620,407151,38775,1900,149,0,0,136962,136962,0,136962,0,0
KY,12829,283204,0,395,2436,69,969,180,197,3431,B,512,2436,485619,39620,407151,12490,510,2,182,0,296033,296033,182,296033,7,3
LA,47706,485011,0,588,5109,379,759,77,197,37017,B,3042,5109,485619,39620,407151,38775,2930,112,534,13458,532717,532717,13992,532717,24,0
MA,105885,617762,0,1045,10867,244,759,151,197,88725,A+,7665,10867,903422,39620,407151,101474,7508,157,195,6221,723647,723647,6416,723647,18,50
MD,62409,366816,0,742,10262,284,759,180,197,4579,B,2982,10262,511288,39620,407151,62409,2851,131,377,7740,429225,429225,8117,429225,35,40
ME,2819,69516,0,30,321,10,759,6,197,2233,B,101,321,73071,3441,69516,2499,101,149,9,1355,72335,72335,1364,72335,0,4
MI,66269,769265,0,562,5109,210,759,131,197,44964,A+,6034,5109,851830,82565,769265,60189,5790,244,184,11313,835534,835534,11497,835534,17,0
MN,30882,398263,0,357,3658,185,1128,180,197,27006,A,1344,3658,429145,39620,407151,30882,1313,31,189,6034,429145,429145,6223,429145,9,28
MO,16414,268377,0,524,5109,379,759,66,197,0,B,882,5109,270232,17275,252506,16414,1900,149,225,4625,284791,284791,4850,284791,2,0
MP,30,8139,0,961,5109,379,759,180,197,19,D,2,5109,8169,39620,407151,30,2,149,0,0,8169,8169,0,8169,0,0
MS,20152,220651,0,668,2728,160,759,98,197,15323,A,915,2728,240664,39620,407151,20013,899,16,353,9947,240803,240803,10300,240803,20,48
MT,614,62963,0,8,79,379,759,180,197,535,C,19,79,485619,39620,407151,614,1900,149,5,2635,63577,63577,2640,63577,0,1
NC,45853,605568,0,829,5109,379,759,180,197,29219,A,1154,5109,485619,39620,407151,45853,1154,149,751,12191,651421,651421,12942,651421,36,0
ND,3124,85527,0,26,200,379,759,180,197,2720,D,69,200,135691,39620,407151,3124,66,3,23,852,88651,88651,875,88651,1,3
NE,16851,122662,0,160,1088,379,759,180,197,10351,D,220,1088,485619,39620,407151,16851,1900,149,126,1632,139513,139513,1758,139513,4,13
NH,5345,93528,0,69,519,379,154,180,197,4041,B,320,519,485619,39620,407151,5345,1900,149,0,0,98873,98873,0,98873,0,0
NJ,167426,964356,0,1291,18879,362,759,245,197,28872,A+,12727,18879,485619,39620,407151,167426,12727,149,323,15376,1131782,1131782,15699,1131782,51,124
NM,9845,258076,0,161,1686,379,759,180,197,4160,C,440,1686,485619,39620,407151,9845,1900,149,122,4134,267921,267921,4256,267921,5,61
NV,11658,210816,0,349,5109,87,759,48,197,640,A+,485,5109,254799,39620,407151,11658,1900,149,379,5661,222474,222474,6040,222474,2,0
NY,384575,2667203,0,1538,89995,449,759,303,197,68938,A,24608,89995,485619,39620,407151,384575,1900,149,631,59937,3051778,3051778,60568,3051778,29,0
OH,42010,526123,0,528,7007,216,1784,151,197,0,B,2597,7007,485619,39620,407151,38911,2362,235,434,10531,568133,568133,10965,568133,24,59
OK,8645,253160,0,172,1130,75,759,180,197,6765,A+,363,1130,263882,10130,253160,8645,1900,149,228,10573,261805,261805,10801,261805,4,13
OR,6098,173440,0,141,912,50,759,22,197,2431,A+,182,912,485619,39620,407151,5897,1900,149,278,3124,179538,179538,3402,179538,2,13
PA,79483,523609,0,800,5109,379,759,179,197,59612,A+,6276,5109,485619,39620,407151,77230,1900,149,362,9700,603092,603092,10062,603092,33,0
PR,5951,113280,0,94,5109,9,759,1,197,0,C,147,5109,114723,2326,112331,1479,57,90,61,0,119231,119231,61,119231,0,0
RI,16232,120790,0,129,1889,16,759,13,197,1479,A+,865,1889,213138,22800,190338,16232,1900,149,52,1486,137022,137022,1538,137022,14,7
SC,19990,247689,0,571,2055,379,759,180,197,9734,A,607,2055,267679,27086,240593,19990,607,149,612,11510,267679,267679,12122,267679,5,67
SD,5966,61236,0,92,562,379,759,180,197,5069,B,77,562,485619,39620,407151,38775,1900,149,38,769,67202,67202,807,67202,2,18
TN,31830,607160,0,621,2146,379,759,180,197,20710,B,493,2146,638772,36995,601777,31612,472,21,670,8342,638990,638990,9012,638990,10,40
TX,93206,1255236,0,2518,5109,379,759,180,197,60681,B,2029,5109,1348442,39620,407151,93206,1900,149,4098,29583,1348442,1348442,33681,1348442,46,0
UT,14937,260763,0,271,1073,379,311,180,138,8470,B,145,1073,485619,39620,407151,14937,1900,149,329,2433,275700,275700,2762,275700,2,32
VA,55331,430107,257,904,8245,241,759,125,197,7341,A+,1570,8245,483024,39620,407151,52917,1465,105,445,5994,485695,485438,6439,485438,18,113
VI,73,2305,5,961,5109,379,759,180,197,64,C,6,5109,485619,39620,407151,38775,6,149,0,0,2383,2378,0,2378,0,0
VT,1131,51759,0,12,5109,379,759,180,197,914,B,55,5109,485619,39620,407151,1131,55,149,3,330,52890,52890,333,52890,0,0
WA,27925,426586,0,235,3894,379,759,38,197,0,B,1221,3894,485619,39620,407151,27876,1221,149,432,10510,454511,454511,10942,454511,4,38
WI,25844,414330,192,275,3096,100,687,180,197,17122,A+,703,3096,485619,39620,407151,23198,703,149,298,10883,440366,440174,11181,440174,9,35
WV,2341,134730,0,24,5109,8,759,3,197,1636,B,88,5109,485619,39620,407151,2261,1900,149,43,5075,137071,137071,5118,137071,0,0
WY,1089,33324,0,7,96,379,759,180,197,852,C,18,96,34190,1025,33164,866,1900,149,29,1778,34413,34413,1807,34413,0,3
AK,664,73773,0,21,5109,379,759,3,197,417,A,12,5109,74437,39620,407151,664,12,149,3,967,74437,74437,970,74437,0,0
AL,26272,276402,0,641,2259,379,676,180,395,13508,B,774,2259,485619,39620,407151,25892,769,5,657,4562,302674,302674,5219,302674,1,4
AR,12917,191221,0,206,1003,379,759,45,163,8352,B,182,1003,485619,39620,407151,12917,1900,149,416,6733,204138,204138,7149,204138,3,5
AS,0,174,0,961,5109,379,759,180,197,0,C,0,5109,485619,39620,407151,0,1900,149,0,0,174,174,0,174,0,0
AZ,36705,308552,0,1449,4182,464,759,307,197,6462,A+,1194,4182,344929,39620,407151,36377,1127,67,1014,6198,345257,345257,7212,345257,8,34
CA,151452,2716730,0,4323,5109,1270,759,180,197,0,B,5089,5109,2868182,39620,407151,151452,1900,149,2597,63589,2868182,2868182,66186,2868182,26,0
CO,29130,219955,0,276,5244,379,759,180,197,4196,A,1348,5244,485619,39620,407151,26523,1900,149,113,4329,249085,249085,4442,249085,0,0
CT,45235,317038,0,203,9912,379,759,180,197,7611,B,4204,9912,359486,39620,407151,42448,3356,848,147,4775,362273,362273,4922,362273,3,0
DC,9799,56047,0,191,5109,76,759,48,197,1155,A+,515,5109,485619,39620,407151,38775,1900,149,32,1284,65846,65846,1316,65846,0,0
DE,10340,74346,0,88,5109,379,759,180,197,6172,A,498,5109,485619,39620,407151,9378,440,58,76,2823,84686,84686,2899,84686,2,0
FL,77326,1352858,1167,961,12298,379,759,180,197,0,A,3030,12298,1684379,103802,1577532,77326,3030,149,1758,19411,1431351,1430184,21169,1430184,8,74
GA,58414,572082,0,865,9322,379,2043,180,197,0,A,2494,9322,625055,52973,572082,58414,1900,149,733,8973,630496,630496,9706,630496,43,74
GU,185,8573,0,961,5109,379,759,180,197,169,B,5,5109,8706,174,8531,177,1900,149,0,215,8758,8758,215,8758,0,0
HI,728,60746,0,961,91,379,759,180,197,629,D,17,91,70877,39620,407151,38775,1900,149,5,1147,61474,61474,1152,61474,0,2
IA,24053,203335,0,197,5109,71,759,51,197,14625,A+,655,5109,485619,39620,407151,24053,1900,149,127,2627,227388,227388,2754,227388,3,0
ID,3399,59581,0,23,266,5,98,180,197,2837,A,87,266,62642,39620,407151,3061,67,20,0,0,62980,62980,0,62980,0,0
IL,133877,1076596,0,1961,5109,569,759,340,197,0,A,6507,5109,1209612,39620,407151,133016,6326,181,473,18154,1210473,1210473,18627,1210473,18,0
IN,40430,315399,0,882,6451,305,1368,123,197,28744,A+,2433,6451,485619,39620,407151,38775,2251,182,521,6917,355829,355829,7438,355829,11,32
KS,11419,125543,0,961,988,379,327,180,143,676,A,245,988,485619,39620,407151,38775,1900,149,372,7438,136962,136962,7810,136962,2,15
KY,12647,283204,0,383,2433,63,969,180,197,3416,B,505,2433,485619,39620,407151,12326,503,2,202,1064,295851,295851,1266,295851,6,0
LA,47172,471553,0,568,5109,379,759,76,197,37017,B,3018,5109,485619,39620,407151,38775,2906,112,553,8840,518725,518725,9393,518725,4,0
MA,105690,611541,0,1026,10817,253,759,167,197,88725,A+,7647,10817,485619,39620,407151,101334,7490,157,87,4434,717231,717231,4521,717231,23,15
MD,62032,359076,0,745,10222,292,759,180,197,4567,B,2947,10222,500791,39620,407151,62032,2817,130,331,5468,421108,421108,5799,421108,8,57
ME,2810,68161,0,31,317,11,759,4,197,2189,B,101,317,71697,3425,68161,2495,101,149,17,1096,70971,70971,1113,70971,1,3
MI,66085,757952,0,562,5109,210,759,139,197,44964,A+,6017,5109,839866,82274,757952,60064,5772,245,31,10508,824037,824037,10539,824037,1,0
MN,30693,392229,0,353,3630,186,1121,180,197,26609,A,1335,3630,422922,39620,407151,30693,1304,31,222,4990,422922,422922,5212,422922,6,20
MO,16189,263752,0,612,5109,379,759,64,197,0,B,880,5109,270232,17275,252506,16189,1900,149,379,4073,279941,279941,4452,279941,1,0
MP,30,8139,0,961,5109,379,759,180,197,19,D,2,5109,8169,39620,407151,30,2,149,0,0,8169,8169,0,8169,0,0
MS,19799,210704,0,661,2680,163,759,100,197,15323,A,895,2680,230503,39620,407151,19664,879,16,283,16167,230503,230503,16450,230503,4,15
MT,609,60328,0,7,78,379,759,180,197,510,C,19,78,485619,39620,407151,609,1900,149,8,2022,60937,60937,2030,60937,0,1
NC,45102,593377,0,797,5109,379,759,180,197,29219,A,1118,5109,485619,39620,407151,45102,1118,149,983,10366,638479,638479,11349,638479,9,0
ND,3101,84675,0,31,197,379,759,180,197,2683,F,68,197,133896,39620,407151,3101,65,3,21,875,87776,87776,896,87776,1,0
NE,16725,121030,0,160,1075,379,759,180,197,10121,D,216,1075,485619,39620,407151,16725,1900,149,92,1548,137755,137755,1640,137755,0,5
NH,5345,93528,0,69,519,379,154,180,197,4041,B,320,519,485619,39620,407151,5345,1900,149,46,2406,98873,98873,2452,98873,2,6
NJ,167103,948980,0,1342,18755,399,759,267,197,28819,A+,12676,18755,485619,39620,407151,167103,12676,149,222,18245,1116083,1116083,18467,1116083,51,18
NM,9723,253942,0,162,1625,379,759,180,197,4114,C,435,1625,485619,39620,407151,9723,1900,149,102,4569,263665,263665,4671,263665,4,0
NV,11279,205155,0,346,5109,85,759,40,197,636,A+,483,5109,248498,39620,407151,11279,1900,149,106,5717,216434,216434,5823,216434,4,0
NY,383944,2607266,0,1608,89995,470,759,323,197,68851,A,24579,89995,485619,39620,407151,383944,1900,149,620,55991,2991210,2991210,56611,2991210,28,0
OH,41576,515592,0,513,6948,216,1776,157,197,0,B,2573,6948,485619,39620,407151,38536,2342,231,428,10520,557168,557168,10948,557168,16,53
OK,8417,242587,0,149,1117,67,759,180,197,6628,A+,359,1117,252624,9456,242587,8417,1900,149,186,0,251004,251004,186,251004,0,1
OR,5820,170316,0,125,899,50,759,19,197,2396,A+,180,899,485619,39620,407151,5625,1900,149,184,2070,176136,176136,2254,176136,4,24
PA,79121,513909,0,851,5109,379,759,178,197,58549,A+,6243,5109,485619,39620,407151,76883,1900,149,323,9474,593030,593030,9797,593030,28,0
PR,5890,113280,0,104,5109,8,759,2,197,0,C,147,5109,114723,2326,112331,1477,57,90,79,0,119170,119170,79,119170,0,0
RI,16180,119304,0,127,1882,21,759,14,197,1474,A+,851,1882,210226,22694,187532,16180,1900,149,76,1711,135484,135484,1787,135484,18,29
SC,19378,236179,0,536,1988,379,759,180,197,8682,A+,602,1988,262473,26294,236179,19378,602,149,583,6638,255557,255557,7221,255557,2,0
SD,5928,60467,0,93,544,379,759,180,197,4961,B,75,544,485619,39620,407151,38775,1900,149,30,1046,66395,66395,1076,66395,0,5
TN,31160,598818,0,642,2106,379,759,180,197,20062,B,483,2106,629769,36284,593485,30951,462,21,728,14030,629978,629978,14758,629978,8,19
TX,89108,1225653,0,2326,5109,379,759,180,197,59089,B,1983,5109,1314761,39620,407151,89108,1900,149,1254,17524,1314761,1314761,18778,1314761,7,0
UT,14608,258330,0,184,1041,72,304,180,134,8380,B,143,1041,485619,39620,407151,14608,1900,149,295,4930,272938,272938,5225,272938,4,13
VA,54886,424113,259,902,8132,269,759,130,197,7230,A+,1552,8132,476573,39620,407151,52460,1444,108,380,9619,479258,478999,9999,478999,6,-4
VI,73,2305,5,961,5109,379,759,180,197,64,C,6,5109,485619,39620,407151,38775,6,149,1,0,2383,2378,1,2378,0,0
VT,1128,51429,0,16,5109,379,759,180,197,912,B,55,5109,485619,39620,407151,1128,55,149,1,1574,52557,52557,1575,52557,0,0
WA,27493,416076,0,197,3856,379,759,41,197,0,B,1217,3856,485619,39620,407151,27407,1217,149,398,10277,443569,443569,10675,443569,4,11
WI,25546,403447,188,284,3061,100,680,180,197,16837,A+,694,3061,485619,39620,407151,22932,694,149,206,6081,429181,428993,6287,428993,2,12
WV,2298,129655,0,25,5109,8,759,2,197,1585,B,88,5109,485619,39620,407151,2220,1900,149,9,745,131953,131953,754,131953,0,0
WY,1060,31546,0,4,93,379,759,180,197,834,C,18,93,32387,941,30446,841,1900,149,0,-459,32606,32606,-459,32606,0,0
AK,661,72806,0,11,5109,379,759,1,197,411,A,12,5109,73467,39620,407151,661,12,149,7,1657,73467,73467,1664,73467,0,0
AL,25615,271840,0,576,2255,379,675,180,395,13508,B,773,2255,485619,39620,407151,25235,768,5,1014,3189,297455,297455,4203,297455,0,14
AR,12501,184488,0,204,998,379,759,46,162,8110,A,179,998,485619,39620,407151,12501,1900,149,954,9018,196989,196989,9972,196989,3,19
AS,0,174,0,961,5109,379,759,180,197,0,C,0,5109,485619,39620,407151,0,1900,149,0,0,174,174,0,174,0,0
AZ,35691,302354,0,1457,4148,452,759,317,197,6333,A+,1186,4148,337728,39620,407151,35374,1119,67,1233,8415,338045,338045,9648,338045,3,33
CA,148855,2653141,0,4247,5109,1280,759,180,197,0,B,5063,5109,2801996,39620,407151,148855,1900,149,3212,74391,2801996,2801996,77603,2801996,74,0
CO,29017,215626,0,262,5244,379,759,180,197,4178,A,1348,5244,485619,39620,407151,26408,1900,149,195,7987,244643,244643,8182,244643,0,10
CT,45088,312263,0,205,9912,379,759,180,197,7611,B,4201,9912,354445,39620,407151,42182,3355,846,94,7090,357351,357351,7184,357351,15,0
DC,9767,54763,0,186,5109,71,759,50,197,1150,A+,515,5109,485619,39620,407151,38775,1900,149,58,1436,64530,64530,1494,64530,4,0
DE,10264,71523,0,93,5109,379,759,180,197,6172,A,496,5109,485619,39620,407151,9313,438,58,35,1653,81787,81787,1688,81787,1,0
FL,75568,1333447,1184,961,12224,379,759,180,197,0,A,3022,12224,1658074,101662,1553385,75568,3022,149,2016,36586,1410199,1409015,38602,1409015,6,69
GA,57681,563109,0,829,9248,379,2034,180,197,0,A,2451,9248,615466,52357,563109,57681,1900,149,880,20230,620790,620790,21110,620790,5,24
GU,185,8358,0,961,5109,379,759,180,197,168,B,5,5109,8426,176,8249,177,1900,149,0,0,8543,8543,0,8543,0,0
HI,723,59599,0,961,89,379,759,180,197,628,D,17,89,69512,39620,407151,38775,1900,149,17,967,60322,60322,984,60322,0,2
IA,23926,200708,0,203,5109,77,759,47,197,14383,A+,652,5109,485619,39620,407151,23926,1900,149,209,4817,224634,224634,5026,224634,2,0
ID,3399,59581,0,22,266,6,98,180,197,2837,A,87,266,62642,39620,407151,3061,67,20,46,276,62980,62980,322,62980,0,1
IL,133404,1058442,0,1914,5109,562,759,328,197,0,A,6489,5109,1190985,39620,407151,132543,6308,181,672,21368,1191846,1191846,22040,1191846,19,0
IN,39909,308482,0,869,6419,301,1360,113,197,28522,A+,2422,6419,485619,39620,407151,38775,2240,182,366,7388,348391,348391,7754,348391,9,70
KS,11047,118105,0,961,973,379,324,180,143,667,A,243,973,485619,39620,407151,38775,1900,149,0,0,129152,129152,0,129152,0,0
KY,12445,282140,0,410,2433,68,969,180,197,3409,B,499,2433,485619,39620,407151,12125,497,2,0,0,294585,294585,0,294585,0,0
LA,46619,462713,0,556,5109,379,759,76,197,33904,B,3014,5109,485619,39620,407151,38775,2901,113,336,4613,509332,509332,4949,509332,10,0
MA,105603,607107,0,1039,10802,244,759,156,197,88725,A+,7624,10802,485619,39620,407151,101276,7467,157,208,8906,712710,712710,9114,712710,48,30
MD,61701,353608,0,751,10165,313,759,180,197,4541,B,2939,10165,492305,39620,407151,61701,2811,128,396,6155,415309,415309,6551,415309,13,112
ME,2793,67065,0,29,314,10,759,5,197,2173,B,100,314,70589,3413,67065,2486,100,149,36,1472,69858,69858,1508,69858,0,1
MI,66054,747444,0,636,5109,253,759,139,197,44964,A+,6016,5109,829523,82079,747444,59990,5771,245,218,13797,813498,813498,14015,813498,3,0
MN,30471,387239,0,369,3610,186,1110,180,197,26090,A,1329,3610,417710,39620,407151,30471,1298,31,6,-6,417710,417710,0,417710,15,29
MO,15810,259679,0,647,5109,379,759,65,197,0,B,879,5109,270232,17275,252506,15810,1900,149,0,5693,275489,275489,5693,275489,0,0
MP,30,8139,0,961,5109,379,759,180,197,19,D,2,5109,8169,39620,407151,30,2,149,0,233,8169,8169,233,8169,0,0
MS,19516,194537,0,667,2665,151,759,99,197,13356,A,891,2665,213753,39620,407151,19216,873,16,168,0,214053,214053,168,214053,2,21
MT,601,58306,0,6,77,379,759,180,197,510,C,19,77,485619,39620,407151,601,1900,149,13,890,58907,58907,903,58907,1,0
NC,44119,583011,0,798,5109,379,759,180,197,23653,A,1109,5109,485619,39620,407151,44119,1109,149,1443,13997,627130,627130,15440,627130,5,0
ND,3080,83800,0,35,197,379,759,180,197,2658,F,67,197,131874,39620,407151,3080,64,3,22,985,86880,86880,1007,86880,0,0
NE,16633,119482,0,156,1070,379,759,180,197,9879,D,216,1070,485619,39620,407151,16633,1900,149,120,1618,136115,136115,1738,136115,0,3
NH,5299,91122,0,70,513,379,152,180,197,3905,B,318,513,485619,39620,407151,5299,1900,149,48,2417,96421,96421,2465,96421,3,10
NJ,166881,930735,0,1391,18737,386,759,285,197,28714,A+,12625,18737,485619,39620,407151,166881,12625,149,276,19125,1097616,1097616,19401,1097616,36,30
NM,9621,249373,0,172,1625,379,759,180,197,4072,C,431,1625,485619,39620,407151,9621,1900,149,95,3615,258994,258994,3710,258994,5,0
NV,11173,199438,0,332,5109,83,759,69,197,627,A+,479,5109,241729,39620,407151,11173,1900,149,227,5504,210611,210611,5731,210611,1,0
NY,383324,2551275,0,1657,89995,499,759,346,197,68761,A,24551,89995,485619,39620,407151,383324,1900,149,694,61665,2934599,2934599,62359,2934599,24,0
OH,41148,505072,0,511,6895,216,1762,145,197,0,B,2557,6895,485619,39620,407151,38188,2327,230,300,7022,546220,546220,7322,546220,3,31
OK,8231,242587,0,149,1116,67,759,180,197,6578,A+,359,1116,252624,9456,242587,8231,1900,149,158,4221,250818,250818,4379,250818,0,5
OR,5636,168246,0,133,875,47,759,15,197,2396,A+,176,875,485619,39620,407151,5207,1900,149,101,3302,173882,173882,3403,173882,2,0
PA,78798,504435,0,852,5109,379,759,189,197,58310,A+,6215,5109,485619,39620,407151,76567,1900,149,336,7846,583233,583233,8182,583233,4,0
PR,5811,113280,0,110,5109,6,759,2,197,0,C,147,5109,114723,2326,112331,1471,57,90,121,0,119091,119091,121,119091,1,0
RI,16104,117593,0,141,1853,28,759,17,197,1435,A+,833,1853,207085,22514,184571,16104,1900,149,32,884,133697,133697,916,133697,0,0
SC,18795,229541,0,521,1988,379,759,180,197,8682,A+,600,1988,255096,25555,229541,18795,600,149,840,5590,248336,248336,6430,248336,1,0
SD,5898,59421,0,87,539,379,759,180,197,4899,B,75,539,485619,39620,407151,38775,1900,149,65,741,65319,65319,806,65319,0,8
TN,30432,584788,0,588,2087,379,759,180,197,19896,B,475,2087,615043,35423,579620,30255,454,21,891,12967,615220,615220,13858,615220,3,14
TX,87854,1208129,0,2287,5109,379,759,180,197,58341,B,1976,5109,1295983,39620,407151,87854,1900,149,1843,33821,1295983,1295983,35664,1295983,19,0
UT,14313,253400,0,178,1028,379,302,180,134,8252,B,139,1028,485619,39620,407151,14313,1900,149,332,4599,267713,267713,4931,267713,0,16
VA,54506,414494,302,958,8136,334,759,155,197,7178,A+,1546,8136,466597,39620,407151,52103,1438,108,637,8370,469302,469000,9007,469000,5,46
VI,72,2305,2,961,5109,379,759,180,197,64,C,6,5109,485619,39620,407151,38775,6,149,0,21,2379,2377,21,2377,0,0
VT,1127,49855,0,26,5109,379,759,180,197,909,B,55,5109,485619,39620,407151,1127,55,149,2,1047,50982,50982,1049,50982,0,0
WA,27095,405799,0,229,3845,379,759,49,197,0,B,1213,3845,485619,39620,407151,26934,1213,149,110,3650,432894,432894,3760,432894,9,28
WI,25340,397366,184,289,3049,101,680,180,197,16558,A+,692,3049,485619,39620,407151,22758,692,149,251,8967,422890,422706,9218,422706,1,14
WV,2289,128910,0,30,5109,8,759,2,197,1571,B,88,5109,485619,39620,407151,2213,1900,149,30,3652,131199,131199,3682,131199,0,0
WY,1060,32005,0,5,93,379,759,180,197,834,C,18,93,32387,941,30446,841,1900,149,10,0,33065,33065,10,33065,0,0
AK,654,71149,0,12,5109,379,759,2,197,405,A,12,5109,71803,39620,407151,654,12,149,29,894,71803,71803,923,71803,0,0
AL,24601,268651,0,563,2241,379,672,180,395,13508,B,773,2241,485619,39620,407151,24221,768,5,891,5976,293252,293252,6867,293252,4,39
AR,11547,175470,0,203,979,379,759,49,160,7607,A,176,979,485619,39620,407151,11547,1900,149,0,5895,187017,187017,5895,187017,0,18
AS,0,174,0,961,5109,379,759,180,197,0,C,0,5109,485619,39620,407151,0,1900,149,0,0,174,174,0,174,0,0
AZ,34458,293939,0,1412,4115,447,759,309,197,6209,A+,1183,4115,328085,39620,407151,34146,1116,67,1540,4078,328397,328397,5618,328397,39,36
CA,145643,2578750,0,4411,5109,1313,759,180,197,0,B,4989,5109,2724393,39620,407151,145643,1900,149,3660,58475,2724393,2724393,62135,2724393,46,0
CO,28822,207639,0,274,5234,379,759,180,197,4184,A,1348,5234,485619,39620,407151,28822,1900,149,175,1916,236461,236461,2091,236461,9,177
CT,44994,305173,0,233,9912,379,759,180,197,7611,B,4186,9912,347190,39620,407151,42017,3342,844,305,4730,350167,350167,5035,350167,27,0
DC,9709,53327,0,197,5109,78,759,52,197,1143,A+,511,5109,485619,39620,407151,38775,1900,149,55,1028,63036,63036,1083,63036,5,0
DE,10229,69870,0,93,5109,379,759,180,197,6116,A,495,5109,485619,39620,407151,9278,437,58,56,2349,80099,80099,2405,80099,1,0
FL,73552,1296861,1241,961,12155,379,759,180,197,0,A,3016,12155,1612617,99168,1510430,73552,3016,149,2581,31933,1371654,1370413,34514,1370413,49,169
GA,56801,542879,0,810,9224,379,2029,180,197,0,A,2446,9224,599680,51203,548477,56801,1900,149,1018,6704,599680,599680,7722,599680,28,43
GU,185,8358,0,961,5109,379,759,180,197,168,B,5,5109,8426,174,8249,185,1900,149,1,15,8543,8543,16,8543,0,0
HI,706,58632,0,961,87,379,759,180,197,627,D,17,87,68738,39620,407151,38775,1900,149,14,745,59338,59338,759,59338,0,1
IA,23717,195891,0,200,5109,76,759,43,197,14326,A+,650,5109,485619,39620,407151,23717,1900,149,380,4684,219608,219608,5064,219608,7,0
ID,3353,59305,0,24,265,5,98,180,197,2776,A,87,265,62328,39620,407151,3023,67,20,51,1175,62658,62658,1226,62658,1,0
IL,132732,1037074,0,2117,5109,610,759,352,197,0,A,6470,5109,1168945,39620,407151,131871,6289,181,673,21171,1169806,1169806,21844,1169806,29,0
IN,39543,301094,0,871,6349,316,1354,118,197,28241,A+,2413,6349,485619,39620,407151,38775,2231,182,397,5060,340637,340637,5457,340637,17,0
KS,11047,118105,0,961,973,379,324,180,143,667,A,243,973,485619,39620,407151,38775,1900,149,0,0,129152,129152,0,129152,0,0
KY,12445,282140,0,410,2433,68,969,180,197,3409,B,499,2433,485619,39620,407151,12125,497,2,500,12991,294585,294585,13491,294585,6,27
LA,46283,458100,0,542,5109,379,759,76,197,33904,B,3004,5109,485619,39620,407151,38775,2891,113,1288,23561,504383,504383,24849,504383,8,0
MA,105395,598201,0,1069,10772,249,759,162,197,88725,A+,7576,10772,485619,39620,407151,101070,7420,156,336,9901,703596,703596,10237,703596,38,46
MD,61305,347453,0,799,10053,321,759,180,197,4536,B,2926,10053,483826,39620,407151,61305,2799,127,692,7971,408758,408758,8663,408758,26,130
ME,2757,65593,0,29,313,10,759,4,197,2152,B,100,313,69073,3370,65593,2452,100,149,36,1427,68350,68350,1463,68350,0,5
MI,65836,733647,0,636,5109,253,759,139,197,44964,A+,6013,5109,815374,81727,733647,59801,5768,245,164,13032,799483,799483,13196,799483,23,0
MN,30465,387245,0,390,3581,191,1104,180,197,25620,A,1314,3581,417710,39620,407151,30172,1283,31,2,9656,417710,417710,9658,417710,9,24
MO,15810,253986,0,595,5109,379,759,69,197,0,B,879,5109,270232,17275,252506,15810,1900,149,225,4436,269796,269796,4661,269796,7,0
MP,30,7906,0,961,5109,379,759,180,197,19,D,2,5109,7936,39620,407151,30,2,149,0,174,7936,7936,174,7936,0,0
MS,19348,194537,0,684,2644,160,759,103,197,13356,A,889,2644,213753,39620,407151,19216,873,16,257,-865,213885,213885,-608,213885,8,1
MT,588,57416,0,7,77,379,759,180,197,510,C,18,77,485619,39620,407151,588,1900,149,15,967,58004,58004,982,58004,0,0
NC,42676,569014,0,823,5109,379,759,180,197,23653,A,1104,5109,485619,39620,407151,42676,1104,149,1427,14566,611690,611690,15993,611690,12,0
ND,3058,82815,0,35,197,379,759,180,197,2630,F,67,197,129794,39620,407151,3058,64,3,42,1667,85873,85873,1709,85873,0,0
NE,16513,117864,0,157,1067,379,759,180,197,9610,D,216,1067,485619,39620,407151,16513,1900,149,198,3406,134377,134377,3604,134377,4,38
NH,5251,88705,0,76,503,379,149,180,197,3843,B,315,503,485619,39620,407151,5251,1900,149,42,1997,93956,93956,2039,93956,7,-1
NJ,166605,911610,0,1395,18707,409,759,279,197,28606,A+,12589,18707,485619,39620,407151,166605,12589,149,441,22378,1078215,1078215,22819,1078215,100,100
NM,9526,245758,0,179,1625,379,759,180,197,3983,C,426,1625,485619,39620,407151,9526,1900,149,0,0,255284,255284,0,255284,0,0
NV,10946,193934,0,351,5109,81,759,43,197,627,A+,478,5109,235500,39620,407151,10946,1900,149,268,5165,204880,204880,5433,204880,3,0
NY,382630,2489610,0,1734,89995,517,759,360,197,68584,A,24527,89995,485619,39620,407151,382630,1900,149,916,69924,2872240,2872240,70840,2872240,32,0
OH,40848,498050,0,516,6864,230,1754,152,197,0,B,2554,6864,485619,39620,407151,37893,2324,230,424,14756,538898,538898,15180,538898,46,50
OK,8073,238366,0,154,1111,67,759,180,197,6495,A+,359,1111,248091,9456,238366,8073,1900,149,225,0,246439,246439,225,246439,0,8
OR,5535,164944,0,133,875,47,759,15,197,2396,A+,174,875,485619,39620,407151,5207,1900,149,158,4132,170479,170479,4290,170479,1,0
PA,78462,496589,0,875,5109,379,759,192,197,58061,A+,6211,5109,485619,39620,407151,76237,1900,149,463,8204,575051,575051,8667,575051,49,0
PR,5690,113280,0,117,5109,4,759,3,197,0,C,146,5109,114723,2326,112331,1460,56,90,154,0,118970,118970,154,118970,0,0
RI,16072,116709,0,141,1853,28,759,17,197,1435,A+,833,1853,205138,22438,182700,16072,1900,149,49,1226,132781,132781,1275,132781,0,0
SC,17955,223951,0,523,1988,379,759,180,197,8682,A+,599,1988,248562,24611,223951,17955,599,149,785,5062,241906,241906,5847,241906,6,0
SD,5833,58680,0,85,531,379,759,180,197,4828,B,75,531,485619,39620,407151,38775,1900,149,91,1417,64513,64513,1508,64513,1,6
TN,29541,571821,0,583,2073,379,759,180,197,19731,B,472,2073,601161,34409,566752,29340,451,21,415,10774,601362,601362,11189,601362,4,24
TX,86011,1174308,0,2242,5109,379,759,180,197,56535,B,1957,5109,1260319,39620,407151,86011,1900,149,2331,31031,1260319,1260319,33362,1260319,18,0
UT,13981,248801,0,236,1012,379,300,180,132,8114,B,139,1012,485619,39620,407151,13981,1900,149,404,3592,262782,262782,3996,262782,0,24
VA,53869,406124,283,959,8090,295,759,142,197,7131,A+,1541,8090,457623,39620,407151,51499,1435,106,658,8805,460276,459993,9463,459993,7,62
VI,72,2284,7,961,5109,379,759,180,197,64,C,6,5109,485619,39620,407151,38775,6,149,0,63,2363,2356,63,2356,0,0
VT,1125,48808,0,11,5109,379,759,180,197,908,B,55,5109,485619,39620,407151,1125,55,149,6,1293,49933,49933,1299,49933,0,0
WA,26985,402149,0,225,3817,379,759,43,197,0,B,1204,3817,485619,39620,407151,26805,1204,149,160,5929,429134,429134,6089,429134,10,45
WI,25089,388399,167,285,3035,99,677,180,197,16231,A+,691,3035,485619,39620,407151,22518,691,149,294,11037,413655,413488,11331,413488,2,32
WV,2259,125258,0,29,5109,9,759,2,197,1568,B,88,5109,485619,39620,407151,2183,1900,149,26,3452,127517,127517,3478,127517,2,0
WY,1050,32005,0,5,93,379,759,180,197,833,C,18,93,32387,941,30446,832,1900,149,23,1132,33055,33055,1155,33055,0,1
AK,625,70255,0,15,5109,379,759,3,197,403,A,12,5109,70880,39620,407151,625,12,149,14,1855,70880,70880,1869,70880,1,0
AL,23710,262675,0,624,2202,379,658,180,384,13508,B,769,2202,485619,39620,407151,23333,764,5,865,6694,286385,286385,7559,286385,14,37
AR,11547,169575,0,203,961,379,759,49,157,7607,A,176,961,485619,39620,407151,11547,1900,149,731,3726,181122,181122,4457,181122,5,36
AS,0,174,0,961,5109,379,759,180,197,0,C,0,5109,485619,39620,407151,0,1900,149,0,0,174,174,0,174,0,0
AZ,32918,289861,0,1336,4079,429,759,278,197,5980,A+,1144,4079,320816,39620,407151,30955,1060,67,1654,11543,322779,322779,13197,322779,17,38
CA,141983,2520275,0,4480,5109,1310,759,180,197,0,B,4943,5109,2662258,39620,407151,141983,1900,149,2702,61909,2662258,2662258,64611,2662258,62,0
CO,28647,205723,0,279,5057,379,759,180,197,4169,A,1339,5057,485619,39620,407151,26040,1900,149,148,3877,234370,234370,4025,234370,11,22
CT,44689,300443,0,244,9912,379,759,180,197,7611,B,4159,9912,342338,39620,407151,41895,3321,838,228,13833,345132,345132,14061,345132,13,0
DC,9654,52299,0,212,5109,82,759,57,197,1143,A+,506,5109,485619,39620,407151,38775,1900,149,65,2600,61953,61953,2665,61953,4,0
DE,10173,67521,0,100,5109,379,759,180,197,6062,A,494,5109,485619,39620,407151,9222,436,58,67,3594,77694,77694,3661,77694,0,0
FL,70971,1264928,1242,961,11986,379,759,180,197,0,A,2967,11986,1571222,96007,1472224,70971,2967,149,1902,27249,1337141,1335899,29151,1335899,29,136
GA,55783,536175,0,836,9181,379,2021,180,197,0,A,2418,9181,586426,50251,536175,55783,1900,149,810,6907,591958,591958,7717,591958,43,108
GU,184,8343,0,961,5109,379,759,180,197,168,B,5,5109,8426,174,8249,174,1900,149,1,146,8527,8527,147,8527,0,0
HI,692,57887,0,961,86,379,759,180,197,623,D,17,86,67392,39620,407151,38775,1900,149,7,1277,58579,58579,1284,58579,0,1
IA,23337,191207,0,225,5109,81,759,47,197,14227,A+,643,5109,485619,39620,407151,23337,1900,149,399,5606,214544,214544,6005,214544,4,0
ID,3302,58130,0,20,265,5,98,180,197,2684,A,86,265,61114,39620,407151,2984,66,20,42,1275,61432,61432,1317,61432,1,3
IL,132059,1015903,0,2209,5109,648,759,375,197,0,A,6441,5109,1147101,39620,407151,131198,6260,181,732,24179,1147962,1147962,24911,1147962,78,0
IN,39146,296034,0,906,6349,329,1354,116,197,27811,A+,2396,6349,485619,39620,407151,38775,2214,182,398,7440,335180,335180,7838,335180,16,35
KS,11047,118105,0,961,973,379,324,180,143,667,A,243,973,485619,39620,407151,38775,1900,149,235,5175,129152,129152,5410,129152,3,19
KY,11945,269149,0,514,2406,81,967,180,197,3379,B,493,2406,485619,39620,407151,11637,491,2,0,0,281094,281094,0,281094,0,0
LA,44995,434539,0,549,5109,379,759,74,197,33904,B,2996,5109,485619,39620,407151,38775,2883,113,523,9338,479534,479534,9861,479534,9,0
MA,105059,588300,0,1143,10726,276,759,170,197,88725,A+,7538,10726,485619,39620,407151,100811,7382,156,392,9879,693359,693359,10271,693359,46,72
MD,60613,339482,0,836,9923,331,759,180,197,4474,B,2900,9923,473271,39620,407151,60613,2773,127,416,7309,400095,400095,7725,400095,25,134
ME,2721,64166,0,32,308,11,759,5,197,2105,B,100,308,67585,3311,64166,2420,100,149,54,1376,66887,66887,1430,66887,0,0
MI,65672,720615,0,636,5109,253,759,139,197,42041,A+,5990,5109,802036,81421,720615,59621,5745,245,223,15544,786287,786287,15767,786287,5,0
MN,30463,377589,0,403,3557,191,1093,180,197,25028,A,1305,3557,408052,39620,407151,29795,1274,31,45,12773,408052,408052,12818,408052,25,35
MO,15585,249550,0,593,5109,379,759,69,197,0,B,872,5109,270232,17275,252506,15585,1900,149,195,5900,265135,265135,6095,265135,12,0
MP,30,7732,0,961,5109,379,759,180,197,19,D,2,5109,7762,39620,407151,30,2,149,0,181,7762,7762,181,7762,0,0
MS,19091,195402,0,710,2643,172,759,94,197,13356,A,881,2643,213753,39620,407151,18959,856,16,608,0,214493,214493,608,214493,13,29
MT,573,56449,0,7,77,379,759,180,197,489,C,18,77,485619,39620,407151,573,1900,149,10,1235,57022,57022,1245,57022,0,3
NC,41249,554448,0,760,5109,379,759,180,197,23653,A,1092,5109,485619,39620,407151,41249,1092,149,1768,21252,595697,595697,23020,595697,28,0
ND,3016,81148,0,35,197,379,759,180,197,2573,F,67,197,126489,39620,407151,3016,64,3,36,1340,84164,84164,1376,84164,0,4
NE,16315,114458,0,164,1029,379,759,180,197,9229,D,212,1029,485619,39620,407151,16315,1900,149,290,2821,130773,130773,3111,130773,17,29
NH,5209,86708,0,73,504,379,149,180,197,3665,A,308,504,485619,39620,407151,5209,1900,149,31,1979,91917,91917,2010,91917,7,4
NJ,166164,889232,0,1480,18607,415,759,300,197,28509,A+,12489,18607,485619,39620,407151,166164,12489,149,348,24255,1055396,1055396,24603,1055396,46,115
NM,9526,245758,0,179,1625,379,759,180,197,3983,C,426,1625,485619,39620,407151,9526,1900,149,276,9451,255284,255284,9727,255284,16,42
NV,10678,188769,0,328,5109,77,759,36,197,604,A+,475,5109,229273,39620,407151,10678,1900,149,279,5914,199447,199447,6193,199447,0,0
NY,381714,2419686,0,1898,89995,552,759,387,197,68399,A,24495,89995,485619,39620,407151,381714,1900,149,822,71573,2801400,2801400,72395,2801400,53,0
OH,40424,483294,0,547,6814,217,1745,144,197,0,B,2508,6814,485619,39620,407151,37519,2280,228,420,10715,523718,523718,11135,523718,18,61
OK,7848,238366,0,154,1103,65,759,180,197,6391,A+,359,1103,248091,9156,238366,7848,1900,149,222,4547,246214,246214,4769,246214,2,11
OR,5377,160812,0,133,875,47,759,15,197,2370,A+,173,875,485619,39620,407151,5207,1900,149,140,4245,166189,166189,4385,166189,2,11
PA,77999,488385,0,899,5109,379,759,202,197,56939,A+,6162,5109,485619,39620,407151,75800,1900,149,66,11946,566384,566384,12012,566384,49,0
PR,5536,113280,0,92,5109,7,759,4,197,0,C,146,5109,114723,2326,112331,1443,56,90,184,24595,118816,118816,24779,118816,2,0
RI,16023,115483,0,141,1853,28,759,17,197,1435,A+,833,1853,202294,22336,179958,16023,1900,149,81,2093,131506,131506,2174,131506,10,11
SC,17170,218889,0,512,1988,379,759,180,197,8682,A+,593,1988,242543,23654,218889,17170,593,149,729,5273,236059,236059,6002,236059,5,90
SD,5742,57263,0,87,525,379,759,180,197,4755,B,74,525,485619,39620,407151,38775,1900,149,77,1184,63005,63005,1261,63005,1,11
TN,29126,561047,0,608,2049,379,759,180,197,19425,B,468,2049,594960,33913,561047,28942,447,21,588,54291,590173,590173,54879,590173,27,38
TX,83680,1143277,0,2166,5109,379,759,180,197,55258,B,1939,5109,1226957,39620,407151,83680,1900,149,2097,18540,1226957,1226957,20637,1226957,19,0
UT,13577,245209,0,197,988,379,294,180,130,7935,B,139,988,485619,39620,407151,13577,1900,149,325,3793,258786,258786,4118,258786,8,20
VA,53211,397319,363,1026,8028,297,759,143,197,7002,A+,1534,8028,448172,39620,407151,50853,1426,108,564,42569,450893,450530,43133,450530,14,64
VI,72,2221,6,961,5109,379,759,180,197,64,C,6,5109,485619,39620,407151,38775,6,149,0,41,2299,2293,41,2293,0,0
VT,1119,47515,0,16,5109,379,759,180,197,907,B,55,5109,485619,39620,407151,1119,55,149,9,1416,48634,48634,1425,48634,0,0
WA,26825,396220,0,226,3772,379,759,8,197,0,B,1194,3772,485619,39620,407151,26619,1194,149,266,8925,423045,423045,9191,423045,4,-1
WI,24795,377362,172,287,3003,104,670,180,197,15783,A+,689,3003,485619,39620,407151,22246,689,149,354,11308,402329,402157,11662,402157,7,27
WV,2233,121806,0,29,5109,9,759,2,197,1553,B,86,5109,485619,39620,407151,2157,1900,149,21,2898,124039,124039,2919,124039,1,0
WY,1027,30873,0,5,92,379,759,180,197,814,C,18,92,31684,941,30446,811,1900,149,18,264,31900,31900,282,31900,0,0
AK,611,68400,0,18,5109,379,759,4,197,397,A,11,5109,69011,39620,407151,611,11,149,18,1273,69011,69011,1291,69011,0,0
AL,22845,255981,0,647,2165,379,650,180,380,13508,B,755,2165,485619,39620,407151,22474,750,5,856,4913,278826,278826,5769,278826,11,36
AR,10816,165849,0,187,925,379,759,45,150,7351,A,171,925,485619,39620,407151,10816,1900,149,448,0,176665,176665,448,176665,6,24
AS,0,174,0,961,5109,379,759,180,197,0,C,0,5109,485619,39620,407151,0,1900,149,0,0,174,174,0,174,0,0
AZ,31264,278318,0,1291,4041,429,759,278,197,5980,A+,1127,4041,309273,39620,407151,30955,1060,67,1412,8483,309582,309582,9895,309582,32,41
CA,139281,2458366,0,4534,5109,1325,759,180,197,0,B,4881,5109,2597647,39620,407151,139281,1900,149,3090,53759,2597647,2597647,56849,2597647,105,0
CO,28499,201846,0,277,5035,379,759,180,197,4150,A,1328,5035,485619,39620,407151,25915,1900,149,152,4099,230345,230345,4251,230345,16,10
CT,44461,286610,0,246,9912,379,759,180,197,7611,B,4146,9912,328353,39620,407151,41743,3308,838,114,7953,331071,331071,8067,331071,26,243
DC,9589,49699,0,238,5109,82,759,53,197,1143,A+,502,5109,485619,39620,407151,38775,1900,149,52,1044,59288,59288,1096,59288,3,0
DE,10106,63927,0,109,5109,379,759,180,197,6001,A,494,5109,485619,39620,407151,9158,436,58,50,2238,74033,74033,2288,74033,1,0
FL,69069,1237679,1242,961,11850,379,759,180,197,0,A,2938,11850,1535825,93533,1439362,69069,2938,149,1698,26027,1307990,1306748,27725,1306748,49,229
GA,54973,529268,0,842,9073,379,2006,180,197,0,A,2375,9073,578933,49665,529278,54973,1900,149,993,12293,584241,584241,13286,584241,46,99
GU,183,8197,0,961,5109,379,759,180,197,168,B,5,5109,8366,175,8191,175,1900,149,1,97,8380,8380,98,8380,0,0
HI,685,56610,0,961,85,379,759,180,197,622,D,17,85,65852,39620,407151,38775,1900,149,3,1119,57295,57295,1122,57295,0,1
IA,22938,185601,0,242,5109,75,759,48,197,13956,A+,639,5109,485619,39620,407151,22938,1900,149,387,5323,208539,208539,5710,208539,9,0
ID,3260,56855,0,28,262,7,99,180,197,2628,A,85,262,59802,39620,407151,2947,65,20,40,1023,60115,60115,1063,60115,0,0
IL,131327,991724,0,2365,5109,638,759,379,197,0,B,6363,5109,1122327,39620,407151,130603,6185,178,766,21559,1123051,1123051,22325,1123051,90,0
IN,38748,288594,0,887,6314,331,1345,118,197,27321,A+,2380,6314,485619,39620,407151,38775,2198,182,411,6837,327342,327342,7248,327342,25,53
KS,10812,112930,0,961,954,379,316,180,139,657,A,240,954,485619,39620,407151,38775,1900,149,0,0,123742,123742,0,123742,0,0
KY,11945,269149,0,514,2406,81,967,180,197,3379,B,493,2406,485619,39620,407151,11637,491,2,62,6618,281094,281094,6680,281094,9,10
LA,44472,425201,0,553,5109,379,759,77,197,33904,B,2987,5109,485619,39620,407151,38775,2874,113,442,9111,469673,469673,9553,469673,19,0
MA,104667,578421,0,1260,10654,296,759,181,197,88725,A+,7492,10654,485619,39620,407151,100504,7337,155,511,10487,683088,683088,10998,683088,38,72
MD,60197,332173,0,902,9789,358,759,180,197,4365,B,2875,9789,463507,39620,407151,60197,2750,125,732,6996,392370,392370,7728,392370,31,34
ME,2667,62790,0,29,308,12,759,5,197,2062,B,100,308,66146,3248,62790,2380,100,149,30,1487,65457,65457,1517,65457,0,5
MI,65449,705071,0,661,5109,249,759,150,197,42041,A+,5985,5109,786154,81083,705071,59496,5738,247,267,14202,770520,770520,14469,770520,33,0
MN,30418,364816,0,411,3522,196,1091,180,197,24870,A,1280,3522,395234,39620,407151,29316,1249,31,219,13182,395234,395234,13401,395234,13,40
MO,15390,243650,0,537,5109,379,759,59,197,0,B,860,5109,270232,17275,252506,15390,1900,149,203,7208,259040,259040,7411,259040,12,0
MP,30,7551,0,961,5109,379,759,180,197,19,D,2,5109,7581,39620,407151,30,2,149,0,58,7581,7581,58,7581,0,0
MS,18483,195402,0,655,2614,160,759,99,197,13356,A,868,2614,213753,39620,407151,18351,851,17,0,0,213885,213885,0,213885,0,0
MT,563,55214,0,7,74,379,759,180,197,487,C,18,74,485619,39620,407151,563,1900,149,2,1159,55777,55777,1161,55777,0,0
NC,39481,533196,0,812,5109,379,759,180,197,23653,A,1064,5109,485619,39620,407151,39481,1064,149,1310,17717,572677,572677,19027,572677,11,0
ND,2980,79808,0,32,193,379,759,180,197,2515,D,67,193,123082,39620,407151,2980,64,3,39,1089,82788,82788,1128,82788,0,0
NE,16025,111637,0,175,1000,379,759,180,197,8946,D,195,1000,485619,39620,407151,16025,1900,149,142,2358,127662,127662,2500,127662,4,11
NH,5178,84729,0,81,500,379,147,180,197,3585,B,301,500,485619,39620,407151,5178,1900,149,46,1214,89907,89907,1260,89907,7,4
NJ,165816,864977,0,1512,18492,445,759,319,197,28376,A+,12443,18492,485619,39620,407151,165816,12443,149,470,21389,1030793,1030793,21859,1030793,66,269
NM,9250,236307,0,197,1583,379,759,180,197,3806,C,410,1583,485619,39620,407151,9250,1900,149,145,3755,245557,245557,3900,245557,6,0
NV,10399,182855,0,337,5109,72,759,35,197,560,A+,475,5109,221786,39620,407151,10399,1900,149,235,5696,193254,193254,5931,193254,1,0
NY,380892,2348113,0,2042,89995,581,759,424,197,68211,A,24442,89995,485619,39620,407151,380892,1900,149,736,60103,2729005,2729005,60839,2729005,38,0
OH,40004,472579,0,563,6753,225,1732,155,197,0,B,2490,6753,485619,39620,407151,37120,2263,227,429,10270,512583,512583,10699,512583,33,60
OK,7626,233819,0,153,1092,58,759,180,197,6263,A+,357,1092,243214,9395,233819,7626,1900,149,146,4002,241445,241445,4148,241445,2,17
OR,5237,156567,0,130,864,39,759,19,197,2350,A+,171,864,485619,39620,407151,5076,1900,149,177,4869,161804,161804,5046,161804,2,7
PA,77933,476439,0,946,5109,379,759,215,197,55665,A+,6113,5109,485619,39620,407151,75119,1900,149,467,9475,554372,554372,9942,554372,51,0
PR,5352,88685,0,91,5109,7,759,4,197,0,C,144,5109,90045,2060,87930,1403,56,88,23,0,94037,94037,23,94037,1,0
RI,15942,113390,0,146,1842,26,759,16,197,1419,A+,823,1842,197705,22130,175575,15942,1900,149,87,1438,129332,129332,1525,129332,11,14
SC,16441,213616,0,494,1898,379,759,180,197,7928,A+,588,1898,236456,22760,213616,16441,588,149,682,-23157,230057,230057,-22475,230057,13,0
SD,5665,56079,0,87,514,379,759,180,197,4664,B,73,514,485619,39620,407151,38775,1900,149,61,998,61744,61744,1059,61744,4,11
TN,28538,506756,0,606,2011,379,759,180,197,18992,B,441,2011,485619,39620,407151,28340,441,149,477,5990,535294,535294,6467,535294,5,21
TX,81583,1124737,0,2008,5109,379,759,180,197,54096,B,1920,5109,1206320,39620,407151,81583,1900,149,1826,43407,1206320,1206320,45233,1206320,35,0
UT,13252,241416,0,188,968,379,282,180,123,7745,B,131,968,485619,39620,407151,13252,1900,149,388,4520,254668,254668,4908,254668,3,14
VA,52647,354750,358,1069,7964,273,759,138,197,6895,A+,1520,7964,405025,39620,407151,50275,1413,107,470,8563,407755,407397,9033,407397,6,-17
VI,72,2180,28,961,5109,379,759,180,197,64,C,6,5109,485619,39620,407151,38775,6,149,0,11,2280,2252,11,2252,0,0
VT,1110,46099,0,12,5109,379,759,180,197,905,B,55,5109,485619,39620,407151,1110,55,149,15,1452,47209,47209,1467,47209,0,0
WA,26559,387295,0,226,3773,379,759,63,197,0,B,1190,3773,485619,39620,407151,26269,1190,149,278,10931,413854,413854,11209,413854,14,26
WI,24441,366054,188,306,2976,101,660,180,197,15348,A+,682,2976,485619,39620,407151,21926,682,149,371,8942,390683,390495,9313,390495,11,33
WV,2212,118908,0,38,5109,8,759,2,197,1516,B,85,5109,485619,39620,407151,2136,1900,149,24,3106,121120,121120,3130,121120,0,0
WY,1009,30609,0,7,92,379,759,180,197,814,C,18,92,31402,941,30446,793,1900,149,29,737,31618,31618,766,31618,0,0
AK,593,67127,0,22,5109,379,759,3,197,392,A,11,5109,67720,39620,407151,593,11,149,20,810,67720,67720,830,67720,0,0
AL,21989,251068,0,646,2129,379,646,180,378,13508,B,744,2129,485619,39620,407151,21626,739,5,567,4751,273057,273057,5318,273057,15,42
AR,10368,165849,0,181,901,379,759,49,147,7116,A,165,901,485619,39620,407151,10368,1900,149,288,10148,176217,176217,10436,176217,4,36
AS,0,174,0,961,5109,379,759,180,197,0,C,0,5109,485619,39620,407151,0,1900,149,0,0,174,174,0,174,0,0
AZ,29852,269835,0,1274,4000,413,759,273,197,5851,A+,1095,4000,299687,39620,407151,38775,1900,149,1556,4918,299687,299687,6474,299687,25,41
CA,136191,2404607,0,4719,5109,1326,759,180,197,0,B,4776,5109,2540798,39620,407151,136191,1900,149,2702,51851,2540798,2540798,54553,2540798,79,0
CO,28347,197747,0,305,5025,379,759,180,197,4130,A,1312,5025,485619,39620,407151,25787,1900,149,164,4043,226094,226094,4207,226094,20,166
CT,44347,278657,0,270,9669,379,759,180,197,7284,B,4120,9669,320044,39620,407151,41387,3283,837,168,4814,323004,323004,4982,323004,23,0
DC,9537,48655,0,245,5109,79,759,60,197,1143,A+,499,5109,485619,39620,407151,38775,1900,149,63,977,58192,58192,1040,58192,4,0
DE,10056,61689,0,108,5109,379,759,180,197,5939,A,493,5109,485619,39620,407151,38775,435,58,36,956,71745,71745,992,71745,1,0
FL,67371,1211652,1134,961,11621,379,759,180,197,0,A,2889,11621,1501053,91285,1406853,67371,2889,149,1371,19347,1280157,1279023,20718,1279023,38,161
GA,53980,516975,0,817,8974,379,1991,180,197,0,A,2329,8974,565758,48783,516975,53980,1900,149,731,13041,570955,570955,13772,570955,44,102
GU,182,8100,0,961,5109,379,759,180,197,164,B,5,5109,8076,172,7904,174,1900,149,2,304,8282,8282,306,8282,0,0
HI,682,55491,0,961,84,379,759,180,197,621,D,17,84,64501,39620,407151,38775,1900,149,6,693,56173,56173,699,56173,0,0
IA,22551,180278,0,245,5109,73,759,49,197,13628,A+,630,5109,485619,39620,407151,22551,1900,149,315,4791,202829,202829,5106,202829,6,0
ID,3220,55832,0,20,262,7,99,180,197,2554,A,85,262,58746,39620,407151,2914,65,20,31,1344,59052,59052,1375,59052,2,2
IL,130561,970165,0,2458,5109,706,759,394,197,0,A,6273,5109,1100002,39620,407151,129837,6095,178,625,20195,1100726,1100726,20820,1100726,77,0
IN,38337,281757,0,894,6261,307,1334,113,197,26791,A+,2355,6261,485619,39620,407151,38775,2173,182,304,4400,320094,320094,4704,320094,16,36
KS,10812,112930,0,961,954,379,316,180,139,657,A,240,954,485619,39620,407151,38775,1900,149,162,4071,123742,123742,4233,123742,4,18
KY,11883,262531,0,508,2396,68,966,180,197,3375,B,484,2396,485619,39620,407151,11576,482,2,175,14301,274414,274414,14476,274414,7,10
LA,44030,416090,0,549,5109,379,759,72,197,33904,B,2968,5109,485619,39620,407151,38775,2855,113,418,6034,460120,460120,6452,460120,11,0
MA,104156,567934,0,1345,10582,319,759,200,197,84621,A+,7454,10582,485619,39620,407151,100158,7300,154,267,9831,672090,672090,10098,672090,46,75
MD,59465,325177,0,955,9755,379,759,180,197,4310,B,2844,9755,451967,39620,407151,59465,2719,125,561,5999,384642,384642,6560,384642,33,79
ME,2637,61303,0,27,303,10,759,5,197,2023,B,100,303,64615,3204,61303,2350,100,149,31,1489,63940,63940,1520,63940,0,1
MI,65182,690869,0,661,5109,249,759,150,197,42041,A+,5952,5109,771552,80683,690869,59278,5708,244,15,0,756051,756051,15,756051,1,0
MN,30199,351634,0,427,3482,193,1083,180,197,24675,A,1267,3482,381833,39620,407151,28869,1236,31,333,11707,381833,381833,12040,381833,39,41
MO,15187,236442,0,533,5109,379,759,59,197,0,B,848,5109,270232,17275,252506,15187,1900,149,274,5660,251629,251629,5934,251629,8,0
MP,30,7493,0,961,5109,379,759,180,197,19,D,2,5109,7523,39620,407151,30,2,149,0,0,7523,7523,0,7523,0,0
MS,18483,195402,0,655,2614,160,759,99,197,13356,A,868,2614,213753,39620,407151,18351,851,17,715,4958,213885,213885,5673,213885,31,79
MT,561,54055,0,7,74,379,759,180,197,487,C,18,74,485619,39620,407151,561,1900,149,7,1425,54616,54616,1432,54616,0,2
NC,38171,515479,0,780,5109,379,759,180,197,23653,A,1053,5109,485619,39620,407151,38171,1053,149,1011,16928,553650,553650,17939,553650,24,0
ND,2941,78719,0,33,193,379,759,180,197,2482,D,67,193,119728,39620,407151,2941,64,3,40,954,81660,81660,994,81660,2,4
NE,15883,109279,0,181,989,379,759,180,197,8820,D,191,989,485619,39620,407151,15883,1900,149,131,2339,125162,125162,2470,125162,3,22
NH,5132,83515,0,80,496,379,146,180,197,3501,B,294,496,485619,39620,407151,5132,1900,149,53,1471,88647,88647,1524,88647,8,4
NJ,165346,843588,0,1701,18223,471,759,342,197,28207,A+,12377,18223,485619,39620,407151,165346,12377,149,550,18887,1008934,1008934,19437,1008934,74,154
NM,9105,232552,0,193,1583,379,759,180,197,3699,C,404,1583,485619,39620,407151,9105,1900,149,43,2813,241657,241657,2856,241657,4,25
NV,10164,177159,0,359,5109,70,759,38,197,557,A+,474,5109,215087,39620,407151,10164,1900,149,134,3600,187323,187323,3734,187323,2,0
NY,380156,2288010,0,2190,89995,630,759,462,197,68019,A,24404,89995,485619,39620,407151,380156,1900,149,674,61623,2668166,2668166,62297,2668166,56,0
OH,39575,462309,0,575,6693,232,1714,159,197,0,B,2457,6693,485619,39620,407151,36710,2231,226,413,11081,501884,501884,11494,501884,36,73
OK,7480,229817,0,150,1075,63,759,180,197,6166,A+,355,1075,239005,8624,229817,7480,1900,149,117,3139,237297,237297,3256,237297,2,14
OR,5060,151698,0,136,857,40,759,18,197,2332,A+,169,857,485619,39620,407151,5060,1900,149,72,3069,156758,156758,3141,156758,0,6
PA,77466,466964,0,992,5109,379,759,218,197,54560,A+,6062,5109,485619,39620,407151,74684,1900,149,410,7716,544430,544430,8126,544430,48,0
PR,5329,88685,0,97,5109,8,759,5,197,0,C,143,5109,90045,2060,87930,1402,63,80,144,0,94014,94014,144,94014,1,0
RI,15855,111952,0,148,1828,27,759,16,197,1406,A+,812,1828,194137,21937,172200,15855,1900,149,104,1364,127807,127807,1468,127807,4,13
SC,15759,236773,0,513,1898,379,759,180,197,7928,A+,575,1898,261377,24604,236773,15759,575,149,531,4019,252532,252532,4550,252532,7,0
SD,5604,55081,0,101,503,379,759,180,197,4573,B,69,503,485619,39620,407151,38775,1900,149,81,1445,60685,60685,1526,60685,1,16
TN,28061,500766,0,624,1990,379,759,180,197,18516,B,436,1990,485619,39620,407151,27869,436,149,486,7144,528827,528827,7630,528827,1,16
TX,79757,1081330,0,2153,5109,379,759,180,197,52449,B,1885,5109,1161087,39620,407151,79757,1900,149,2504,11228,1161087,1161087,13732,1161087,32,0
UT,12864,236896,0,223,954,379,276,180,116,7587,B,128,954,485619,39620,407151,12864,1900,149,305,2595,249760,249760,2900,249760,1,23
VA,52177,346187,407,1155,7981,296,759,139,197,6826,A+,1514,7981,395972,39620,407151,49785,1408,106,439,7069,398771,398364,7508,398364,18,135
VI,72,2169,6,961,5109,379,759,180,197,64,C,6,5109,485619,39620,407151,38775,6,149,1,32,2247,2241,33,2241,0,0
VT,1095,44647,0,11,5109,379,759,180,197,903,B,55,5109,485619,39620,407151,1095,55,149,11,1503,45742,45742,1514,45742,0,0
WA,26281,376364,0,238,3747,379,759,92,197,0,B,1176,3747,485619,39620,407151,25901,1176,149,277,11278,402645,402645,11555,402645,15,48
WI,24070,357112,190,328,2943,114,654,180,197,14999,A+,671,2943,485619,39620,407151,21593,671,149,336,9902,381372,381182,10238,381182,10,39
WV,2188,115802,0,24,5109,9,759,5,197,1485,B,85,5109,485619,39620,407151,2114,1900,149,19,3633,117990,117990,3652,117990,1,0
WY,980,29872,0,8,92,379,759,180,197,804,C,18,92,30795,923,29871,768,1900,149,10,506,30852,30852,516,30852,1,1
AK,573,66317,0,12,5109,379,759,1,197,389,A,11,5109,66890,39620,407151,573,11,149,10,968,66890,66890,978,66890,1,0
AL,21422,246317,0,628,2087,379,631,180,375,11395,B,729,2087,485619,39620,407151,21071,725,4,497,7251,267739,267739,7748,267739,11,33
AR,10080,155701,0,173,865,379,759,44,144,6875,A,161,865,485619,39620,407151,10080,1900,149,340,4854,165781,165781,5194,165781,6,21
AS,0,174,0,961,5109,379,759,180,197,0,C,0,5109,485619,39620,407151,0,1900,149,0,0,174,174,0,174,0,0
AZ,28296,264917,0,1243,3959,438,759,264,197,5764,A+,1070,3959,293213,39620,407151,38775,1900,149,618,4514,293213,293213,5132,293213,23,48
CA,133489,2352756,0,4583,5109,1345,759,180,197,0,B,4697,5109,2486245,39620,407151,133489,1900,149,2170,52885,2486245,2486245,55055,2486245,44,0
CO,28183,193704,0,304,4859,379,759,180,197,4112,A,1292,4859,485619,39620,407151,25627,1900,149,182,4221,221887,221887,4403,221887,18,374
CT,44179,273843,0,293,9669,379,759,180,197,7284,B,4097,9669,315014,39620,407151,41171,3266,831,87,4240,318022,318022,4327,318022,13,0
DC,9474,47678,0,255,5109,89,759,59,197,1143,A+,495,5109,485619,39620,407151,38775,1900,149,85,1301,57152,57152,1386,57152,4,0
DE,10020,60733,0,108,5109,379,759,180,197,5888,A,492,5109,485619,39620,407151,38775,434,58,48,758,70753,70753,806,70753,2,0
FL,66000,1192305,1100,961,11460,379,759,180,197,0,A,2851,11460,1474600,89566,1382146,66000,2851,149,1096,22659,1259405,1258305,23755,1258305,53,178
GA,53249,503934,0,834,8872,379,1960,180,197,0,A,2285,8872,551908,47974,503934,53249,1900,149,752,7056,557183,557183,7808,557183,77,126
GU,180,7796,0,961,5109,379,759,180,197,163,B,5,5109,7797,172,7625,172,1900,149,1,246,7976,7976,247,7976,0,0
HI,676,54798,0,961,84,379,759,180,197,618,D,17,84,63533,39620,407151,38775,1900,149,1,326,55474,55474,327,55474,0,0
IA,22236,175487,0,255,5109,82,759,51,197,13411,A+,624,5109,485619,39620,407151,22236,1900,149,249,3852,197723,197723,4101,197723,12,0
ID,3189,54488,0,21,260,7,99,180,197,2509,A,83,260,57376,39620,407151,2888,63,20,50,1586,57677,57677,1636,57677,0,0
IL,129936,949970,0,2573,5109,726,759,437,197,0,A,6196,5109,1079182,39620,407151,129212,6018,178,797,19512,1079906,1079906,20309,1079906,94,0
IN,38033,277357,0,853,6225,307,1330,113,197,26205,A+,2339,6225,485619,39620,407151,38775,2158,181,410,5477,315390,315390,5887,315390,23,46
KS,10650,108859,0,961,936,379,311,180,136,625,A,236,936,485619,39620,407151,38775,1900,149,0,0,119509,119509,0,119509,0,0
KY,11708,248230,0,525,2386,75,966,180,197,3365,B,477,2386,485619,39620,407151,11419,475,2,232,6849,259938,259938,7081,259938,5,18
LA,43612,410056,0,568,5109,379,759,67,197,33904,B,2957,5109,485619,39620,407151,38775,2844,113,562,10504,453668,453668,11066,453668,13,0
MA,103889,558103,0,1397,10507,315,759,202,197,84621,A+,7408,10507,485619,39620,407151,99955,7255,153,263,4460,661992,661992,4723,661992,55,82
MD,58904,319178,0,970,9676,386,759,180,197,4279,B,2811,9676,443478,39620,407151,58904,2686,125,500,6079,378082,378082,6579,378082,35,47
ME,2606,59814,0,29,302,10,759,7,197,1992,B,100,302,63075,3156,59814,2606,100,149,18,757,62420,62420,775,62420,1,1
MI,65167,690869,0,661,5109,249,759,150,197,42041,A+,5951,5109,771552,80683,690869,59278,5708,244,63,16809,756036,756036,16872,756036,9,0
MN,29866,339927,0,455,3441,199,1068,180,197,24221,A,1228,3441,369793,39620,407151,28523,1217,11,430,8451,369793,369793,8881,369793,20,40
MO,14913,230782,0,533,5109,379,759,59,197,0,B,840,5109,270232,17275,252506,14913,1900,149,179,4055,245695,245695,4234,245695,21,0
MP,30,7493,0,961,5109,379,759,180,197,19,D,2,5109,7523,39620,407151,30,2,149,2,279,7523,7523,281,7523,0,0
MS,17768,190444,0,598,2535,142,759,83,197,13356,A,837,2535,208089,39620,407151,17645,821,16,0,0,208212,208212,0,208212,0,0
MT,554,52630,0,5,72,379,759,180,197,485,C,18,72,485619,39620,407151,554,1900,149,6,1586,53184,53184,1592,53184,0,3
NC,37160,498551,0,774,5109,379,759,180,197,23653,A,1029,5109,485619,39620,407151,37160,1029,149,676,14922,535711,535711,15598,535711,23,0
ND,2901,77765,0,32,189,379,759,180,197,2450,D,65,189,116878,39620,407151,2901,62,3,21,465,80666,80666,486,80666,3,5
NE,15752,106940,0,176,967,379,759,180,197,8637,D,188,967,485619,39620,407151,15752,1900,149,118,1167,122692,122692,1285,122692,0,32
NH,5079,82044,0,78,492,379,145,180,197,3392,B,286,492,485619,39620,407151,5079,1900,149,36,1535,87123,87123,1571,87123,0,3
NJ,164796,824701,0,1736,18069,510,759,373,197,28036,A+,12303,18069,485619,39620,407151,164796,12303,149,299,14109,989497,989497,14408,989497,89,19
NM,9062,229739,0,183,1558,379,759,180,197,3380,C,400,1558,485619,39620,407151,9062,1900,149,122,4304,238801,238801,4426,238801,4,25
NV,10030,173559,0,350,5109,86,759,41,197,557,A+,472,5109,211157,39620,407151,10030,1900,149,244,3342,183589,183589,3586,183589,3,0
NY,379482,2226387,0,2344,89995,663,759,485,197,67808,A,24348,89995,485619,39620,407151,379482,1900,149,683,49290,2605869,2605869,49973,2605869,49,0
OH,39162,451228,0,639,6620,238,1708,153,197,0,B,2421,6620,485619,39620,407151,36355,2196,225,325,13247,490390,490390,13572,490390,17,70
OK,7363,226678,0,148,1061,66,759,180,197,6073,A+,353,1061,235731,8491,226678,7363,1900,149,158,12080,234041,234041,12238,234041,5,22
OR,4988,148629,0,145,851,47,759,20,197,2313,A+,169,851,485619,39620,407151,4841,1900,149,66,3672,153617,153617,3738,153617,5,8
PA,77056,459248,0,1032,5109,379,759,237,197,53670,A+,6014,5109,485619,39620,407151,74298,1900,149,493,7861,536304,536304,8354,536304,61,0
PR,5185,88685,0,95,5109,9,759,6,197,0,B,142,5109,90045,2060,87930,1386,63,79,139,0,93870,93870,139,93870,0,0
RI,15751,110588,0,144,1815,31,759,19,197,1398,A+,808,1815,191076,21735,169341,15751,1900,149,68,1164,126339,126339,1232,126339,9,8
SC,15228,232754,0,541,1898,379,759,180,197,7928,A+,568,1898,256710,23956,232754,15228,568,149,428,2893,247982,247982,3321,247982,11,84
SD,5523,53636,0,90,487,379,759,180,197,4483,B,68,487,485619,39620,407151,38775,1900,149,52,1288,59159,59159,1340,59159,3,5
TN,27575,493622,0,587,1974,379,759,180,197,18013,B,435,1974,485619,39620,407151,27575,435,149,631,7803,521197,521197,8434,521197,14,26
TX,77253,1070102,0,2056,5109,379,759,180,197,51140,B,1853,5109,1147355,39620,407151,77253,1900,149,1637,25402,1147355,1147355,27039,1147355,23,0
UT,12559,234301,0,230,931,379,274,180,116,7391,B,127,931,485619,39620,407151,12559,1900,149,237,3724,246860,246860,3961,246860,3,13
VA,51738,339118,383,1169,7846,311,759,155,197,6677,A+,1496,7846,388480,39620,407151,49362,1391,105,487,6777,391239,390856,7264,390856,19,116
VI,71,2137,4,961,5109,379,759,180,197,63,C,6,5109,485619,39620,407151,38775,6,149,0,9,2212,2208,9,2208,0,0
VT,1084,43144,0,16,5109,379,759,180,197,901,B,55,5109,485619,39620,407151,1084,55,149,9,1421,44228,44228,1430,44228,0,0
WA,26004,365086,0,205,3699,379,759,60,197,0,B,1161,3699,485619,39620,407151,25580,1161,149,272,9513,391090,391090,9785,391090,2,30
WI,23734,347210,174,505,2904,117,649,180,197,14583,A+,661,2904,485619,39620,407151,21308,661,149,300,13957,371118,370944,14257,370944,15,44
WV,2169,112169,0,24,5109,9,759,4,197,1477,B,84,5109,485619,39620,407151,2095,1900,149,16,717,114338,114338,733,114338,0,0
WY,970,29366,0,8,91,379,759,180,197,789,C,17,91,30126,903,29222,760,1900,149,10,352,30336,30336,362,30336,0,0
AK,563,65349,0,7,5109,379,759,0,197,384,B,10,5109,65912,39620,407151,563,10,149,19,989,65912,65912,1008,65912,0,0
AL,20925,239066,0,593,2054,379,623,180,371,11395,B,718,2054,485619,39620,407151,20590,714,4,425,0,259991,259991,425,259991,26,32
AR,9740,150847,0,171,844,379,759,46,143,6424,A,155,844,485619,39620,407151,9740,1900,149,314,0,160587,160587,314,160587,1,0
AS,0,174,0,961,5109,379,759,180,197,0,C,0,5109,485619,39620,407151,0,1900,149,0,0,174,174,0,174,0,0
AZ,27678,260403,0,1266,3911,390,759,246,197,5639,A+,1047,3911,288081,39620,407151,38775,1900,149,789,5671,288081,288081,6460,288081,3,64
CA,131319,2299871,0,4506,5109,1301,759,180,197,0,B,4653,5109,2431190,39620,407151,131319,1900,149,2507,66465,2431190,2431190,68972,2431190,27,0
CO,28001,189483,0,322,4485,379,759,180,197,4091,A,1274,4485,485619,39620,407151,25457,1900,149,153,4317,217484,217484,4470,217484,0,5
CT,44092,269603,0,324,9669,379,759,180,197,7284,B,4084,9669,310654,39620,407151,41051,3239,845,124,4548,313695,313695,4672,313695,13,0
DC,9389,46377,0,268,5109,102,759,72,197,1143,A+,491,5109,485619,39620,407151,38775,1900,149,57,1162,55766,55766,1219,55766,2,0
DE,9972,59975,0,113,5109,379,759,180,197,5791,A,490,5109,485619,39620,407151,38775,432,58,30,920,69947,69947,950,69947,2,0
FL,64904,1169646,1024,961,11282,379,759,180,197,0,A,2798,11282,1445259,88102,1354303,64904,2798,149,966,17426,1235574,1234550,18392,1234550,12,67
GA,52497,496878,0,819,8746,379,1925,180,197,0,A,2208,8746,544371,47493,496878,52497,1900,149,599,8892,549375,549375,9491,549375,28,61
GU,179,7550,0,961,5109,379,759,180,197,163,B,5,5109,7729,171,7550,171,1900,149,0,266,7729,7729,266,7729,0,0
HI,675,54472,0,961,84,379,759,180,197,617,D,17,84,63259,39620,407151,38775,1900,149,2,1090,55147,55147,1092,55147,0,1
IA,21987,171635,0,265,5109,85,759,53,197,13028,A+,612,5109,485619,39620,407151,21987,1900,149,320,5110,193622,193622,5430,193622,8,0
ID,3139,52902,0,23,260,8,99,180,197,2461,A,83,260,55742,39620,407151,2840,63,20,0,0,56041,56041,0,56041,0,0
IL,129139,930458,0,2496,5109,713,759,443,197,0,A,6102,5109,1058873,39620,407151,128415,5924,178,1382,15441,1059597,1059597,16823,1059597,198,0
IN,37623,271880,0,902,6179,346,1325,130,197,25608,A+,2316,6179,485619,39620,407151,38775,2135,181,226,5014,309503,309503,5240,309503,13,43
KS,10650,108859,0,961,936,379,311,180,136,625,A,236,936,485619,39620,407151,38775,1900,149,257,5599,119509,119509,5856,119509,4,19
KY,11476,241381,0,486,2368,76,958,180,197,3359,B,472,2368,485619,39620,407151,11212,470,2,189,3606,252857,252857,3795,252857,2,7
LA,43050,399552,0,582,5109,379,759,71,197,33904,B,2944,5109,485619,39620,407151,38775,2831,113,234,8303,442602,442602,8537,442602,8,0
MA,103626,553643,0,1415,10425,322,759,209,197,84621,A+,7353,10425,485619,39620,407151,99755,7217,136,190,4589,657269,657269,4779,657269,37,32
MD,58404,313099,0,979,9629,392,759,180,197,4240,B,2776,9629,435363,39620,407151,58404,2653,123,431,6269,371503,371503,6700,371503,27,83
ME,2588,59057,0,37,301,12,759,7,197,1891,B,99,301,62295,3133,59057,2305,99,149,18,2658,61645,61645,2676,61645,0,3
MI,65104,674060,0,661,5109,249,759,191,197,42041,A+,5942,5109,754408,80348,674060,59265,5707,244,135,12804,739164,739164,12939,739164,15,0
MN,29436,331476,0,452,3401,198,1052,180,197,23657,A,1208,3401,360912,39620,407151,28224,1197,11,448,7323,360912,360912,7771,360912,11,34
MO,14734,226727,0,611,5109,379,759,76,197,0,B,819,5109,270232,17275,252506,14734,1900,149,181,4422,241461,241461,4603,241461,10,0
MP,28,7214,0,961,5109,379,759,180,197,19,D,2,5109,7241,39620,407151,28,2,149,1,0,7242,7242,1,7242,0,0
MS,17768,190444,0,598,2535,142,759,83,197,13356,A,837,2535,208089,39620,407151,17645,821,16,498,4465,208212,208212,4963,208212,20,13
MT,548,51044,0,2,69,379,759,180,197,475,C,18,69,485619,39620,407151,548,1900,149,3,4211,51592,51592,4214,51592,0,0
NC,36484,483629,0,739,5109,379,759,180,197,23653,A,1006,5109,485619,39620,407151,36484,1006,149,938,7949,520113,520113,8887,520113,10,0
ND,2880,77300,0,29,184,379,759,180,197,2336,D,62,184,115259,39620,407151,2880,59,3,19,228,80180,80180,247,80180,3,1
NE,15634,105773,0,166,935,379,759,180,197,8455,D,188,935,485619,39620,407151,15634,1900,149,91,1547,121407,121407,1638,121407,0,7
NH,5043,80509,0,86,489,379,145,180,197,3392,B,286,489,485619,39620,407151,5043,1900,149,24,1519,85552,85552,1543,85552,3,2
NJ,164497,810592,0,1740,18050,498,759,361,197,27941,A+,12214,18050,485619,39620,407151,164497,12214,149,333,14331,975089,975089,14664,975089,38,0
NM,8940,225435,0,177,1533,379,759,180,197,3307,C,396,1533,485619,39620,407151,8940,1900,149,140,5088,234375,234375,5228,234375,4,44
NV,9786,170217,0,339,5109,74,759,44,197,522,A+,469,5109,206514,39620,407151,9786,1900,149,137,4169,180003,180003,4306,180003,4,0
NY,378799,2177097,0,2371,89995,678,759,507,197,67687,A,24299,89995,485619,39620,407151,378799,1900,149,702,57352,2555896,2555896,58054,2555896,40,0
OH,38837,437981,0,644,6550,245,1668,158,197,0,B,2404,6550,485619,39620,407151,36077,2177,227,361,7433,476818,476818,7794,476818,27,53
OK,7205,214598,0,158,1039,65,759,180,197,6014,A+,348,1039,223245,8109,214598,38775,1900,149,55,0,221803,221803,55,221803,0,13
OR,4922,144957,0,137,843,43,759,18,197,2237,A+,164,843,485619,39620,407151,4775,1900,149,114,1365,149879,149879,1479,149879,0,24
PA,76563,451387,0,1174,5109,379,759,268,197,53670,A+,5953,5109,485619,39620,407151,73827,1900,149,351,7214,527950,527950,7565,527950,10,0
PR,5046,88685,0,107,5109,8,759,7,197,0,B,142,5109,90045,2060,87930,1373,63,79,61,0,93731,93731,61,93731,0,0
RI,15683,109424,0,146,1807,28,759,20,197,1390,A+,799,1807,188324,21516,166808,15683,1900,149,45,884,125107,125107,929,125107,27,32
SC,14800,229861,0,507,1814,379,759,180,197,7347,A+,557,1814,253262,23401,229861,14800,557,149,514,6288,244661,244661,6802,244661,11,0
SD,5471,52348,0,92,482,379,759,180,197,4403,B,65,482,485619,39620,407151,38775,1900,149,33,726,57819,57819,759,57819,0,4
TN,26944,485819,0,617,1948,379,759,180,197,17563,B,421,1948,485619,39620,407151,26944,421,149,563,13432,512763,512763,13995,512763,3,16
TX,75616,1044700,0,1935,5109,379,759,180,197,49758,B,1830,5109,1120316,39620,407151,75616,1900,149,638,19232,1120316,1120316,19870,1120316,0,0
UT,12322,230577,0,182,918,379,270,180,112,7255,B,124,918,485619,39620,407151,12322,1900,149,256,4692,242899,242899,4948,242899,3,18
VA,51251,332341,373,1173,7730,308,759,160,197,6557,A+,1477,7730,381220,39620,407151,48879,1373,104,570,3206,383965,383592,3776,383592,5,6
VI,71,2128,3,961,5109,379,759,180,197,62,C,6,5109,485619,39620,407151,38775,6,149,0,3,2202,2199,3,2199,0,0
VT,1075,41723,0,13,5109,379,759,180,197,895,B,55,5109,485619,39620,407151,1075,55,149,12,1568,42798,42798,1580,42798,0,0
WA,25732,355573,0,213,3669,379,759,66,197,0,B,1159,3669,485619,39620,407151,25203,1159,149,313,7963,381305,381305,8276,381305,6,17
WI,23434,333253,206,528,2860,110,637,180,197,14242,A+,646,2860,485619,39620,407151,21038,646,149,222,7386,356893,356687,7608,356687,-1,12
WV,2153,111452,0,24,5109,9,759,4,197,1468,B,84,5109,485619,39620,407151,2083,1900,149,9,1789,113605,113605,1798,113605,0,0
WY,960,29014,0,7,91,379,759,180,197,773,C,17,91,29762,892,28869,748,1900,149,13,1210,29974,29974,1223,29974,0,1
AK,544,64360,0,7,5109,379,759,1,197,382,B,10,5109,64904,39620,407151,544,10,149,8,995,64904,64904,1003,64904,0,-48
AL,20500,239066,0,518,2022,379,615,180,364,11395,B,692,2022,485619,39620,407151,20166,688,4,457,13465,259566,259566,13922,259566,3,29
AR,9426,150847,0,145,844,379,759,35,143,6424,A,154,844,485619,39620,407151,9426,1900,149,325,3191,160273,160273,3516,160273,0,6
AS,0,174,0,961,5109,379,759,180,197,0,C,0,5109,485619,39620,407151,0,1900,149,0,0,174,174,0,174,0,0
AZ,26889,254732,0,1252,3847,392,759,248,197,5517,A+,1044,3847,281621,39620,407151,38775,1900,149,1438,8537,281621,281621,9975,281621,2,70
CA,128812,2233406,0,4525,5109,1288,759,180,197,0,B,4626,5109,2362218,39620,407151,128812,1900,149,2796,51122,2362218,2362218,53918,2362218,67,0
CO,27848,185166,0,299,4480,379,759,180,197,4074,A,1274,4480,485619,39620,407151,25319,1900,149,233,4504,213014,213014,4737,213014,0,8
CT,43968,265055,0,333,9669,379,759,180,197,7284,B,4071,9669,305996,39620,407151,40941,3229,842,150,5444,309023,309023,5594,309023,16,0
DC,9332,45215,0,285,5109,90,759,73,197,1143,A+,489,5109,485619,39620,407151,38775,1900,149,63,806,54547,54547,869,54547,6,0
DE,9942,59055,0,103,5109,379,759,180,197,5792,A,488,5109,485619,39620,407151,38775,430,58,97,1265,68997,68997,1362,68997,3,0
FL,63938,1152220,1161,961,11215,379,759,180,197,0,A,2786,11215,1422347,86827,1332711,63938,2786,149,1180,40793,1217319,1216158,41973,1216158,13,52
GA,51898,487986,0,783,8685,379,1909,180,197,0,A,2180,8685,534861,46875,487986,51898,1900,149,589,16438,539884,539884,17027,539884,6,23
GU,179,7284,0,961,5109,379,759,180,197,162,B,5,5109,7116,170,6945,171,1900,149,0,0,7463,7463,0,7463,0,0
HI,673,53382,0,961,83,379,759,180,197,616,D,17,83,62005,39620,407151,38775,1900,149,9,789,54055,54055,798,54055,0,0
IA,21667,166525,0,269,5109,86,759,54,197,12805,A+,604,5109,485619,39620,407151,21667,1900,149,189,3289,188192,188192,3478,188192,6,0
ID,3139,52902,0,30,260,8,99,180,197,2461,A,83,260,55742,39620,407151,2840,63,20,28,774,56041,56041,802,56041,0,3
IL,127757,915017,0,2550,5109,720,759,438,197,0,A,5904,5109,1042774,39620,407151,127757,5904,149,867,19833,1042774,1042774,20700,1042774,40,0
IN,37397,266866,0,913,6136,335,1317,133,197,25138,A+,2303,6136,485619,39620,407151,38775,2121,182,400,6333,304263,304263,6733,304263,11,45
KS,10393,103260,0,961,917,379,306,180,135,612,A,232,917,485619,39620,407151,38775,1900,149,0,0,113653,113653,0,113653,0,0
KY,11287,237775,0,495,2361,75,958,180,197,3344,B,470,2361,485619,39620,407151,11031,468,2,0,0,249062,249062,0,249062,0,0
LA,42816,391249,0,575,5109,379,759,74,197,31728,B,2936,5109,485619,39620,407151,38775,2825,111,330,5666,434065,434065,5996,434065,11,0
MA,103436,549054,0,1442,10393,335,759,221,197,84621,A+,7316,10393,485619,39620,407151,99562,7179,137,304,7547,652490,652490,7851,652490,27,24
MD,57973,306830,0,1003,9546,404,759,180,197,4240,B,2749,9546,427155,39620,407151,57973,2625,124,491,6936,364803,364803,7427,364803,9,95
ME,2570,56399,0,34,298,15,759,7,197,1864,B,99,298,59552,3049,56399,2295,99,149,46,0,58969,58969,46,58969,1,2
MI,64969,661256,0,864,5109,315,759,191,197,42041,A+,5927,5109,741368,80112,661256,59211,5698,244,55,10314,726225,726225,10369,726225,11,0
MN,28988,324153,0,450,3367,199,1044,180,197,22992,A,1197,3367,353141,39620,407151,27886,1186,11,135,9409,353141,353141,9544,353141,16,31
MO,14553,222305,0,657,5109,379,759,84,197,0,B,809,5109,270232,17275,252506,14553,1900,149,111,6682,236858,236858,6793,236858,0,0
MP,27,7214,0,961,5109,379,759,180,197,19,D,2,5109,7241,39620,407151,27,2,149,1,545,7241,7241,546,7241,0,0
MS,17270,185979,0,585,2522,133,759,69,197,11203,A,817,2522,203127,39620,407151,17148,801,16,501,9625,203249,203249,10126,203249,14,47
MT,545,46833,0,2,69,379,759,180,197,475,C,18,69,485619,39620,407151,545,1900,149,5,619,47378,47378,624,47378,0,1
NC,35546,475680,0,696,5109,379,759,180,197,18860,A,996,5109,485619,39620,407151,35546,996,149,921,12955,511226,511226,13876,511226,4,0
ND,2861,77072,0,28,183,379,759,180,197,2307,D,59,183,113847,39620,407151,2861,56,3,45,1008,79933,79933,1053,79933,0,1
NE,15543,104226,0,167,928,379,759,180,197,8255,D,188,928,485619,39620,407151,15543,1900,149,164,2058,119769,119769,2222,119769,2,9
NH,5019,78990,0,84,487,379,145,180,197,3319,B,283,487,485619,39620,407151,5019,1900,149,0,0,84009,84009,0,84009,0,0
NJ,164164,796261,0,1882,18050,503,759,385,197,27824,A+,12176,18050,485619,39620,407151,164164,12176,149,271,40706,960425,960425,40977,960425,70,27
NM,8800,220347,0,176,1489,379,759,180,197,3286,C,392,1489,485619,39620,407151,8800,1900,149,128,4379,229147,229147,4507,229147,5,0
NV,9649,166048,0,348,5109,80,759,44,197,522,A+,465,5109,201608,39620,407151,9649,1900,149,189,3737,175697,175697,3926,175697,2,0
NY,378097,2119745,0,2427,89995,704,759,534,197,67544,A,24259,89995,485619,39620,407151,378097,1900,149,781,59654,2497842,2497842,60435,2497842,47,0
OH,38476,430548,0,603,6497,240,1657,167,197,0,B,2377,6497,485619,39620,407151,35731,2155,222,365,10133,469024,469024,10498,469024,7,37
OK,7150,214598,0,158,1026,65,759,180,197,5981,A+,348,1026,223245,8109,214598,38775,1900,149,147,0,221748,221748,147,221748,3,0
OR,4808,143592,0,121,819,39,759,16,197,2237,A+,164,819,485619,39620,407151,4808,1900,149,146,2095,148400,148400,2241,148400,1,0
PA,76212,444173,0,1174,5109,379,759,268,197,53670,A+,5943,5109,485619,39620,407151,73479,1900,149,506,9051,520385,520385,9557,520385,12,0
PR,4985,88685,0,105,5109,6,759,7,197,0,B,142,5109,90045,2060,87930,1364,63,79,70,0,93670,93670,70,93670,0,0
RI,15638,108540,0,182,1775,37,759,23,197,1336,A+,772,1775,186461,21401,165060,15638,1900,149,49,758,124178,124178,807,124178,0,0
SC,14286,223573,0,477,1814,379,759,180,197,7347,A+,546,1814,246331,22758,223573,14286,546,149,370,4745,237859,237859,5115,237859,1,0
SD,5438,51622,0,87,478,379,759,180,197,4335,B,65,478,485619,39620,407151,38775,1900,149,71,1531,57060,57060,1602,57060,0,4
TN,26381,472387,0,561,1932,379,759,180,197,17222,B,418,1932,485619,39620,407151,26381,418,149,310,7037,498768,498768,7347,498768,1,9
TX,74978,1025468,0,1878,5109,379,759,180,197,49758,B,1830,5109,1100446,39620,407151,74978,1900,149,1425,5744,1100446,1100446,7169,1100446,11,0
UT,12066,225885,0,207,900,379,269,180,111,7108,B,121,900,485619,39620,407151,12066,1900,149,268,2534,237951,237951,2802,237951,0,10
VA,50681,329135,385,1186,7724,316,759,165,197,6538,A+,1472,7724,377484,39620,407151,48349,1369,103,1284,7401,380201,379816,8685,379816,12,171
VI,71,2125,4,961,5109,379,759,180,197,62,C,6,5109,485619,39620,407151,38775,6,149,0,0,2200,2196,0,2196,0,0
VT,1063,40155,0,14,5109,379,759,180,197,890,B,55,5109,485619,39620,407151,1063,55,149,17,1118,41218,41218,1135,41218,0,0
WA,25419,347610,0,205,3652,379,759,57,197,0,B,1153,3652,485619,39620,407151,24739,1153,149,192,2180,373029,373029,2372,373029,4,13
WI,23212,325867,183,491,2848,107,638,180,197,14047,A+,647,2848,485619,39620,407151,20835,647,149,275,11065,349262,349079,11340,349079,2,16
WV,2144,109663,0,28,5109,9,759,4,197,1451,B,84,5109,485619,39620,407151,2075,1900,149,13,2071,111807,111807,2084,111807,0,0
WY,947,27804,0,4,90,379,759,180,197,757,C,17,90,28538,858,26843,734,1900,149,8,235,28751,28751,243,28751,0,0
AK,536,63365,0,7,48,379,759,1,197,382,A,10,48,63901,39620,407151,536,10,149,12,2899,63901,63901,2911,63901,0,48
AL,20043,225601,0,473,1993,379,612,180,363,11395,B,689,1993,485619,39620,407151,19709,685,4,656,5515,245644,245644,6171,245644,13,44
AR,9101,147656,0,154,838,379,759,36,142,6266,A,154,838,485619,39620,407151,9101,1900,149,450,8696,156757,156757,9146,156757,2,46
AS,0,174,0,961,5109,379,759,180,197,0,C,0,5109,485619,39620,407151,0,1900,149,0,0,174,174,0,174,0,0
AZ,25451,246195,0,1278,3777,391,759,292,197,5399,A+,1042,3777,271646,39620,407151,38775,1900,149,1119,6662,271646,271646,7781,271646,30,65
CA,126016,2182284,0,4526,5109,1315,759,180,197,0,B,4559,5109,2308300,39620,407151,126016,1900,149,3115,66722,2308300,2308300,69837,2308300,74,0
CO,27615,180662,0,299,4472,379,759,180,197,4055,A,1274,4472,485619,39620,407151,25099,1900,149,255,4598,208277,208277,4853,208277,19,12
CT,43818,259611,0,333,9669,379,759,180,197,7284,B,4055,9669,300281,39620,407151,40670,3218,837,358,15684,303429,303429,16042,303429,17,0
DC,9269,44409,0,276,5109,100,759,68,197,1138,A+,483,5109,485619,39620,407151,38775,1900,149,70,1747,53678,53678,1817,53678,8,0
DE,9845,57790,0,117,5109,379,759,180,197,5696,A,485,5109,485619,39620,407151,38775,427,58,72,834,67635,67635,906,67635,0,0
FL,62758,1111427,1265,961,11163,379,759,180,197,0,A,2773,11163,1372933,85372,1284797,62758,2773,149,1270,37975,1175450,1174185,39245,1174185,28,97
GA,51309,471548,0,788,8662,379,1901,180,197,0,A,2174,8662,522857,46119,476738,51309,1900,149,688,14381,522857,522857,15069,522857,0,16
GU,179,7284,0,961,5109,379,759,180,197,162,B,5,5109,7116,170,6945,171,1900,149,0,89,7463,7463,89,7463,0,0
HI,664,52593,0,961,83,379,759,180,197,614,D,17,83,60985,39620,407151,38775,1900,149,9,912,53257,53257,921,53257,0,0
IA,21478,163236,0,299,5109,102,759,62,197,12715,A+,598,5109,485619,39620,407151,21478,1900,149,326,3725,184714,184714,4051,184714,6,0
ID,3111,52128,0,21,257,8,98,180,197,2408,A,83,257,54949,39620,407151,2821,63,20,57,1558,55239,55239,1615,55239,0,2
IL,126890,895184,0,2702,5109,770,759,476,197,0,A,5864,5109,1022074,39620,407151,126890,5864,149,975,20180,1022074,1022074,21155,1022074,69,0
IN,36997,260533,0,926,6091,344,1304,133,197,24729,A+,2292,6091,485619,39620,407151,38775,2110,182,419,5473,297530,297530,5892,297530,34,38
KS,10393,103260,0,961,917,379,306,180,135,612,A,232,917,485619,39620,407151,38775,1900,149,0,0,113653,113653,0,113653,0,0
KY,11287,237775,0,495,2361,75,958,180,197,3344,B,470,2361,485619,39620,407151,11031,468,2,310,6335,249062,249062,6645,249062,4,16
LA,42486,385583,0,582,5109,379,759,77,197,31728,B,2925,5109,485619,39620,407151,38775,2814,111,497,6786,428069,428069,7283,428069,13,0
MA,103132,541507,0,1529,10369,359,759,238,197,84621,A+,7289,10369,485619,39620,407151,99301,7152,137,575,9295,644639,644639,9870,644639,54,66
MD,57482,299894,0,1059,9451,418,759,180,197,4175,B,2740,9451,417904,39620,407151,57482,2616,124,712,8938,357376,357376,9650,357376,38,105
ME,2524,56399,0,35,296,14,759,7,197,1845,B,98,296,59552,3049,56399,2253,98,149,42,1349,58923,58923,1391,58923,0,3
MI,64914,650942,0,864,5109,315,759,191,197,42041,A+,5916,5109,730837,79895,650942,59107,5683,244,93,10492,715856,715856,10585,715856,7,0
MN,28853,314744,0,473,3336,206,1044,180,197,22253,A,1181,3336,343597,39620,407151,27501,1170,11,165,10247,343597,343597,10412,343597,22,47
MO,14442,215623,0,666,5109,379,759,79,197,0,B,809,5109,270232,17275,252506,14442,1900,149,189,5334,230065,230065,5523,230065,10,0
MP,26,6669,0,961,5109,379,759,180,197,16,D,2,5109,6695,39620,407151,26,2,149,0,0,6695,6695,0,6695,0,0
MS,16769,176354,0,604,2475,149,759,84,197,11203,A,803,2475,193008,39620,407151,16654,787,16,10,0,193123,193123,10,193123,0,0
MT,540,46214,0,1,68,379,759,180,197,472,C,18,68,485619,39620,407151,540,1900,149,-1,867,46754,46754,866,46754,0,0
NC,34625,462725,0,708,5109,379,759,180,197,18860,A,992,5109,485619,39620,407151,34625,992,149,1370,13833,497350,497350,15203,497350,26,0
ND,2816,76064,0,29,182,379,759,180,197,2268,D,59,182,111537,39620,407151,2816,56,3,71,1953,78880,78880,2024,78880,0,2
NE,15379,102168,0,181,919,379,759,180,197,7957,D,186,919,485619,39620,407151,15379,1900,149,262,2463,117547,117547,2725,117547,0,14
NH,5019,78990,0,84,487,379,145,180,197,3319,B,283,487,485619,39620,407151,5019,1900,149,143,4101,84009,84009,4244,84009,10,15
NJ,163893,755555,0,1933,18023,539,759,410,197,27641,A+,12106,18023,485619,39620,407151,163893,12106,149,557,0,919448,919448,557,919448,57,143
NM,8672,215968,0,175,1489,379,759,180,197,3206,C,387,1489,485619,39620,407151,8672,1900,149,319,6564,224640,224640,6883,224640,4,73
NV,9460,162311,0,348,5109,80,759,44,197,522,A+,463,5109,196976,39620,407151,9460,1900,149,194,5470,171771,171771,5664,171771,3,0
NY,377316,2060091,0,2603,89995,720,759,554,197,67261,A,24212,89995,485619,39620,407151,377316,1900,149,1108,76787,2437407,2437407,77895,2437407,37,0
OH,38111,420415,0,628,6460,256,1650,155,197,0,B,2370,6460,485619,39620,407151,35408,2148,222,353,11978,458526,458526,12331,458526,15,75
OK,7003,214598,0,158,1026,65,759,180,197,5867,A+,345,1026,223245,8109,214598,38775,1900,149,96,5034,221601,221601,5130,221601,1,12
OR,4662,141497,0,121,819,39,759,16,197,2237,A+,163,819,485619,39620,407151,4442,1900,149,92,2821,146159,146159,2913,146159,2,0
PA,75706,435122,0,1174,5109,379,759,268,197,52560,A+,5931,5109,485619,39620,407151,72979,1900,149,701,10921,510828,510828,11622,510828,45,0
PR,4915,88685,0,100,5109,7,759,4,197,0,B,142,5109,90045,2060,87930,1360,63,79,295,28263,93600,93600,28558,93600,1,0
RI,15589,107782,0,182,1775,37,759,23,197,1336,A+,772,1775,184803,21324,163479,15589,1900,149,68,1126,123371,123371,1194,123371,0,0
SC,13916,218828,0,453,1814,379,759,180,197,7347,A+,545,1814,241088,22260,218828,13916,545,149,463,982,232744,232744,1445,232744,7,0
SD,5367,50091,0,93,474,379,759,180,197,4273,B,65,474,485619,39620,407151,38775,1900,149,90,2005,55458,55458,2095,55458,0,7
TN,26071,465350,0,535,1923,379,759,180,197,17124,B,417,1923,485619,39620,407151,26071,417,149,551,8698,491421,491421,9249,491421,9,30
TX,73553,1019724,0,1822,5109,379,759,180,197,48895,B,1819,5109,1093277,39620,407151,73553,1900,149,1940,29761,1093277,1093277,31701,1093277,31,0
UT,11798,223351,0,147,890,379,266,180,110,6939,B,121,890,485619,39620,407151,11798,1900,149,546,2406,235149,235149,2952,235149,1,20
VA,49397,321734,350,1171,7553,324,759,169,197,6382,A+,1460,7553,368857,39620,407151,47123,1357,103,865,6496,371481,371131,7361,371131,7,-44
VI,71,2125,4,961,5109,379,759,180,197,62,C,6,5109,485619,39620,407151,38775,6,149,0,145,2200,2196,145,2196,0,0
VT,1046,39037,0,16,5109,379,759,180,197,888,B,55,5109,485619,39620,407151,1046,55,149,19,947,40083,40083,966,40083,0,0
WA,25227,345430,0,247,3639,379,759,86,197,0,B,1149,3639,485619,39620,407151,24635,1149,149,204,3545,370657,370657,3749,370657,11,24
WI,22937,314802,177,492,2832,118,636,180,197,13770,A+,645,2832,485619,39620,407151,20571,645,149,338,11470,337916,337739,11808,337739,12,41
WV,2131,107592,0,27,5109,11,759,3,197,1446,B,84,5109,485619,39620,407151,2065,1900,149,12,1193,109723,109723,1205,109723,0,0
WY,939,27569,0,4,90,379,759,180,197,757,C,17,90,28295,858,26843,726,1900,149,6,890,28508,28508,896,28508,0,0
AK,524,60466,0,8,5109,379,759,1,197,380,A,10,5109,60990,39620,407151,524,10,149,11,882,60990,60990,893,60990,0,0
AL,19387,220086,0,582,1949,379,603,180,358,11395,B,676,1949,485619,39620,407151,19073,672,4,315,3859,239473,239473,4174,239473,23,20
AR,8651,138960,0,147,792,379,759,32,138,5919,A,152,792,485619,39620,407151,8651,1900,149,584,4547,147611,147611,5131,147611,10,35
AS,0,174,0,961,5109,379,759,180,197,0,C,0,5109,485619,39620,407151,0,1900,149,0,0,174,174,0,174,0,0
AZ,24332,239533,0,1234,3712,375,759,241,197,5298,A+,1012,3712,263865,39620,407151,38775,1900,149,1579,12531,263865,263865,14110,263865,16,70
CA,122901,2115562,0,4625,5109,1333,759,180,197,0,B,4485,5109,2238463,39620,407151,122901,1900,149,3094,52698,2238463,2238463,55792,2238463,63,0
CO,27360,176064,0,319,4460,379,759,180,197,4034,A,1255,4460,485619,39620,407151,24848,1900,149,300,5924,203424,203424,6224,203424,1,17
CT,43460,243927,0,350,9669,379,759,180,197,7284,B,4038,9669,293474,39620,407151,38775,3196,842,221,5641,287387,287387,5862,287387,31,0
DC,9199,42662,0,273,5109,99,759,75,197,1138,A+,475,5109,485619,39620,407151,38775,1900,149,79,686,51861,51861,765,51861,0,0
DE,9773,56956,0,128,5109,379,759,180,197,5631,A,485,5109,485619,39620,407151,38775,427,58,27,793,66729,66729,820,66729,2,0
FL,61488,1073452,1193,961,11066,379,759,180,197,0,A,2745,11066,1327264,83619,1240903,61488,2745,149,1305,26592,1136133,1134940,27897,1134940,54,143
GA,50621,457167,0,790,8646,379,1897,180,197,0,A,2174,8646,507788,45258,462530,50621,1900,149,774,10683,507788,507788,11457,507788,27,89
GU,179,7195,0,961,5109,379,759,180,197,162,B,5,5109,7116,170,6945,171,1900,149,0,390,7374,7374,390,7374,0,0
HI,655,51681,0,961,83,379,759,180,197,611,D,17,83,59842,39620,407151,38775,1900,149,2,1696,52336,52336,1698,52336,0,0
IA,21152,159511,0,299,5109,102,759,62,197,12585,A+,592,5109,485619,39620,407151,21152,1900,149,347,5381,180663,180663,5728,180663,12,0
ID,3054,50570,0,29,255,8,98,180,197,2362,A,83,255,53333,39620,407151,2763,63,20,64,3755,53624,53624,3819,53624,0,2
IL,125915,875004,0,2911,5109,817,759,500,197,0,A,5795,5109,1000919,39620,407151,125915,5795,149,1156,17747,1000919,1000919,18903,1000919,59,0
IN,36578,255060,0,924,6053,368,1293,147,197,24317,A+,2258,6053,485619,39620,407151,38775,2078,180,482,5922,291638,291638,6404,291638,27,54
KS,10393,103260,0,961,917,379,306,180,135,612,A,232,917,485619,39620,407151,38775,1900,149,223,5377,113653,113653,5600,113653,10,27
KY,10977,231440,0,505,2345,73,958,180,197,3316,B,466,2345,485619,39620,407151,10734,465,1,272,6220,242417,242417,6492,242417,8,13
LA,41989,378797,0,604,5109,379,759,75,197,31728,B,2912,5109,485619,39620,407151,38775,2801,111,427,9173,420786,420786,9600,420786,29,0
MA,102557,532212,0,1533,10303,350,759,238,197,84621,A+,7235,10303,485619,39620,407151,98796,7097,138,494,9340,634769,634769,9834,634769,34,65
MD,56770,290956,0,1076,9346,455,759,180,197,4159,B,2702,9346,405414,39620,407151,56770,2580,122,912,9796,347726,347726,10708,347726,34,129
ME,2482,55050,0,35,293,13,759,7,197,1797,B,98,293,58140,2986,55050,2210,98,149,36,1295,57532,57532,1331,57532,3,2
MI,64821,640450,0,617,5109,321,759,205,197,38099,A+,5909,5109,720088,79638,640450,59073,5672,244,205,12543,705271,705271,12748,705271,8,0
MN,28688,304497,0,478,3289,220,1044,180,197,21864,A,1159,3289,333185,39620,407151,26980,1148,11,398,10639,333185,333185,11037,333185,33,36
MO,14253,210289,0,666,5109,379,759,79,197,0,B,799,5109,254990,16681,237939,14253,1900,149,196,5685,224542,224542,5881,224542,13,0
MP,26,6669,0,961,5109,379,759,180,197,16,D,2,5109,6695,39620,407151,26,2,149,0,0,6695,6695,0,6695,0,0
MS,16759,176354,0,604,2475,149,759,84,197,11203,A,803,2475,193008,39620,407151,16654,787,16,199,7929,193113,193113,8128,193113,9,135
MT,541,45347,0,1,68,379,759,180,197,470,C,18,68,485619,39620,407151,541,1900,149,2,1244,45888,45888,1246,45888,1,0
NC,33255,448892,0,717,5109,379,759,180,197,18860,A,966,5109,485619,39620,407151,33255,966,149,1289,12556,482147,482147,13845,482147,6,0
ND,2745,74111,0,30,180,379,759,180,197,2242,D,59,180,107509,39620,407151,2745,56,3,39,1073,76856,76856,1112,76856,1,5
NE,15117,99705,0,190,905,379,759,180,197,7598,D,186,905,485619,39620,407151,15117,1900,149,251,2316,114822,114822,2567,114822,-1,3
NH,4876,74889,0,86,472,379,145,180,197,3187,B,273,472,485619,39620,407151,4876,1900,149,81,3719,79765,79765,3800,79765,8,4
NJ,163336,755555,0,1933,17880,542,759,410,197,27433,A+,12049,17880,485619,39620,407151,163336,12049,149,806,60356,918891,918891,61162,918891,79,276
NM,8353,209404,0,170,1416,379,759,180,197,3115,C,383,1416,485619,39620,407151,8353,1900,149,213,4548,217757,217757,4761,217757,8,0
NV,9266,156841,0,341,5109,72,759,47,197,522,A+,460,5109,191125,39620,407151,9266,1900,149,176,4508,166107,166107,4684,166107,0,0
NY,376208,1983304,0,2728,89995,758,759,583,197,66992,A,24175,89995,485619,39620,407151,376208,1900,149,1075,65405,2359512,2359512,66480,2359512,42,0
OH,37758,408437,0,671,6385,259,1632,168,197,0,B,2355,6385,485619,39620,407151,35096,2135,220,476,8468,446195,446195,8944,446195,16,73
OK,6907,209564,0,164,1014,66,759,180,197,5781,A+,344,1014,218010,7921,209564,38775,1900,149,0,4749,216471,216471,4749,216471,0,0
OR,4570,138676,0,121,819,39,759,16,197,2214,A+,161,819,485619,39620,407151,4442,1900,149,96,3838,143246,143246,3934,143246,2,7
PA,75005,424201,0,1174,5109,379,759,268,197,52069,A+,5886,5109,485619,39620,407151,72292,1900,149,445,7259,499206,499206,7704,499206,69,0
PR,4620,60422,0,116,5109,9,759,7,197,0,B,141,5109,61702,1952,59701,1330,63,78,112,0,65042,65042,112,65042,1,0
RI,15521,106656,0,182,1775,37,759,23,197,1336,A+,772,1775,182000,21126,160874,15521,1900,149,105,1520,122177,122177,1625,122177,16,10
SC,13453,217846,0,453,1814,379,759,180,197,7347,A+,538,1814,238808,20962,217846,13453,538,149,448,0,231299,231299,448,231299,13,25
SD,5277,48086,0,83,467,379,759,180,197,4179,B,65,467,485619,39620,407151,38775,1900,149,30,711,53363,53363,741,53363,1,3
TN,25520,456652,0,505,1893,379,759,180,197,16925,B,408,1893,485619,39620,407151,25520,408,149,400,5634,482172,482172,6034,482172,7,38
TX,71613,989963,0,1855,5109,379,759,180,197,47865,B,1788,5109,1061576,39620,407151,71613,1900,149,1693,21328,1061576,1061576,23021,1061576,21,0
UT,11252,220945,0,133,870,379,262,180,109,6788,B,120,870,485619,39620,407151,11252,1900,149,439,4251,232197,232197,4690,232197,3,20
VA,48532,315238,374,1205,7597,320,759,161,197,6392,A+,1453,7597,361519,39620,407151,46281,1350,103,676,9504,364144,363770,10180,363770,8,47
VI,71,1980,8,961,5109,379,759,180,197,62,C,6,5109,485619,39620,407151,38775,6,149,0,5,2059,2051,5,2051,0,0
VT,1027,38090,0,14,5109,379,759,180,197,882,B,55,5109,485619,39620,407151,1027,55,149,1,1282,39117,39117,1283,39117,0,0
WA,25023,341885,0,285,3615,379,759,91,197,0,B,1138,3615,485619,39620,407151,24482,1138,149,346,5913,366908,366908,6259,366908,3,37
WI,22599,303332,174,526,2791,124,625,180,197,13337,A+,633,2791,485619,39620,407151,20249,633,149,406,11965,326105,325931,12371,325931,7,52
WV,2119,106399,0,27,5109,11,759,3,197,1445,B,84,5109,485619,39620,407151,2054,1900,149,27,2442,108518,108518,2469,108518,6,0
WY,933,26679,0,4,90,379,759,180,197,755,C,17,90,27400,849,26550,721,1900,149,18,605,27612,27612,623,27612,0,3
AK,513,59584,0,13,5109,379,759,1,197,376,A,10,5109,60097,39620,407151,513,10,149,8,1907,60097,60097,1915,60097,0,0
AL,19072,216227,0,601,1929,379,601,180,357,11395,B,653,1929,485619,39620,407151,18766,651,2,221,3484,235299,235299,3705,235299,0,29
AR,8067,134413,0,138,757,379,759,30,127,5717,A,142,757,485619,39620,407151,8067,1900,149,0,0,142480,142480,0,142480,0,26
AS,0,174,0,961,5109,379,759,180,197,0,C,0,5109,485619,39620,407151,0,1900,149,0,0,174,174,0,174,0,0
AZ,22753,227002,0,1079,3642,375,759,223,197,5172,A+,996,3642,249755,39620,407151,38775,1900,149,520,4710,249755,249755,5230,249755,15,53
CA,119807,2062864,0,4455,5109,1279,759,180,197,0,B,4422,5109,2182671,39620,407151,119807,1900,149,2120,49257,2182671,2182671,51377,2182671,61,0
CO,27060,170140,0,356,4443,379,759,180,197,4014,A,1254,4443,485619,39620,407151,24557,1900,149,272,2751,197200,197200,3023,197200,26,24
CT,43239,238286,0,373,9669,379,759,180,197,7284,B,4007,9669,285314,39620,407151,38775,3171,836,148,4941,281525,281525,5089,281525,18,-4124
DC,9120,41976,0,276,5109,98,759,73,197,1138,A+,475,5109,485619,39620,407151,38775,1900,149,104,1430,51096,51096,1534,51096,2,0
DE,9746,56163,0,142,5109,379,759,180,197,5562,A,483,5109,485619,39620,407151,38775,425,58,34,955,65909,65909,989,65909,8,0
FL,60183,1046860,1221,961,10923,379,759,180,197,0,A,2691,10923,1292876,81817,1208362,60183,2691,149,1419,24711,1108264,1107043,26130,1107043,41,127
GA,49847,446484,0,807,8557,379,1872,180,197,0,A,2147,8557,496331,44479,451852,49847,1900,149,953,12666,496331,496331,13619,496331,24,138
GU,179,6805,0,961,5109,379,759,180,197,162,B,5,5109,6829,171,407151,171,1900,149,1,256,6984,6984,257,6984,0,0
HI,653,49985,0,961,83,379,759,180,197,612,D,17,83,57942,39620,407151,38775,1900,149,0,1130,50638,50638,1130,50638,0,0
IA,20805,154130,0,310,5109,105,759,70,197,12333,A+,580,5109,485619,39620,407151,20805,1900,149,750,9740,174935,174935,10490,174935,6,0
ID,2990,46815,0,28,253,3,98,180,197,2311,A,83,253,49524,39620,407151,2709,63,20,57,806,49805,49805,863,49805,0,2
IL,124759,857257,0,3044,5109,853,759,516,197,0,A,5736,5109,982016,39620,407151,124759,5736,149,929,21912,982016,982016,22841,982016,115,0
IN,36096,249138,0,979,5999,372,1286,144,197,23707,A+,2231,5999,485619,39620,407151,38775,2052,179,384,7035,285234,285234,7419,285234,24,47
KS,10170,97883,0,961,890,379,302,180,131,592,A,222,890,485619,39620,407151,38775,1900,149,0,0,108053,108053,0,108053,0,0
KY,10705,225220,0,518,2332,67,954,180,197,3303,B,458,2332,485619,39620,407151,10479,456,2,295,3431,235925,235925,3726,235925,8,15
LA,41562,369624,0,613,5109,379,759,82,197,31728,B,2883,5109,485619,39620,407151,38775,2772,111,429,8670,411186,411186,9099,411186,13,0
MA,102063,522872,0,1637,10238,401,759,249,197,84621,A+,7201,10238,485619,39620,407151,98376,7062,139,471,6703,624935,624935,7174,624935,49,87
MD,55858,281160,0,1096,9217,456,759,180,197,3985,B,2668,9217,392240,39620,407151,55858,2546,122,876,8517,337018,337018,9393,337018,2,106
ME,2446,53755,0,35,291,14,759,7,197,1739,B,95,291,56799,2940,53755,2181,95,149,28,3164,56201,56201,3192,56201,0,6
MI,64616,627907,0,617,5109,321,759,205,197,38099,A+,5901,5109,707130,79223,627907,59001,5665,244,234,14734,692523,692523,14968,692523,17,0
MN,28290,293858,0,512,3253,244,1033,180,197,21490,A,1126,3253,322148,39620,407151,26273,1115,11,401,10539,322148,322148,10940,322148,29,50
MO,14057,204604,0,599,5109,379,759,82,197,0,B,786,5109,183650,14498,168871,13774,1900,149,290,7018,218661,218661,7308,218661,0,0
MP,26,6669,0,961,5109,379,759,180,197,16,D,2,5109,6695,39620,407151,26,2,149,3,135,6695,6695,138,6695,0,0
MS,16560,168425,0,633,2340,145,759,97,197,11203,A,794,2340,184335,39620,407151,16447,778,16,238,0,184985,184985,238,184985,12,0
MT,539,44103,0,1,68,379,759,180,197,467,C,17,68,485619,39620,407151,539,1900,149,14,1180,44642,44642,1194,44642,0,0
NC,31966,436336,0,659,5109,379,759,180,197,18860,A,960,5109,485619,39620,407151,31966,960,149,1189,17850,468302,468302,19039,468302,21,0
ND,2706,73038,0,32,175,379,759,180,197,2209,D,58,175,104888,39620,407151,2706,55,3,27,1215,75744,75744,1242,75744,4,3
NE,14866,97389,0,211,902,379,759,180,197,7005,D,187,902,485619,39620,407151,14866,1900,149,255,2034,112255,112255,2289,112255,6,51
NH,4795,71170,1643,88,468,379,144,180,197,3157,B,265,468,485619,39620,407151,4795,1900,149,46,180,77608,75965,226,75965,9,6
NJ,162530,695199,0,1982,17604,537,759,459,197,27231,A+,11970,17604,485619,39620,407151,162530,11970,149,462,19847,857729,857729,20309,857729,90,214
NM,8140,204856,0,170,1416,379,759,180,197,3013,C,375,1416,485619,39620,407151,8140,1900,149,116,6043,212996,212996,6159,212996,8,0
NV,9090,152333,0,364,5109,79,759,47,197,512,A+,460,5109,185648,39620,407151,9090,1900,149,155,5013,161423,161423,5168,161423,5,0
NY,375133,1917899,0,2849,89995,832,759,613,197,66756,A,24133,89995,485619,39620,407151,375133,1900,149,1048,62511,2293032,2293032,63559,2293032,54,0
OH,37282,399969,0,693,6312,267,1623,181,197,0,B,2339,6312,485619,39620,407151,34639,2117,222,490,10656,437251,437251,11146,437251,40,61
OK,6907,204815,0,148,1014,63,759,180,197,5781,A+,344,1014,213142,7802,204815,38775,1900,149,102,3568,211722,211722,3670,211722,3,11
OR,4474,134838,0,124,812,40,759,13,197,2199,A+,159,812,485619,39620,407151,4350,1900,149,75,2569,139312,139312,2644,139312,0,12
PA,74560,416942,0,1174,5109,379,759,268,197,51019,A+,5817,5109,485619,39620,407151,71881,1900,149,538,15573,491502,491502,16111,491502,76,0
PR,4508,60422,0,114,5109,15,759,9,197,0,B,140,5109,61702,1952,59701,1322,63,77,485,0,64930,64930,485,64930,0,0
RI,15416,105136,0,185,1765,42,759,29,197,1326,A+,756,1765,178303,20913,157390,15416,1900,149,117,2000,120552,120552,2117,120552,14,12
SC,13005,217846,0,453,1789,379,759,180,197,6976,A+,525,1789,238808,20962,217846,13005,525,149,354,7572,230851,230851,7926,230851,7,0
SD,5247,47375,0,86,464,379,759,180,197,4163,B,64,464,485619,39620,407151,38775,1900,149,85,3875,52622,52622,3960,52622,2,8
TN,25120,451018,0,547,1855,379,759,180,197,16643,B,401,1855,485619,39620,407151,25120,401,149,298,5061,476138,476138,5359,476138,13,26
TX,69920,968635,0,1796,5109,379,759,180,197,46799,B,1767,5109,1038555,39620,407151,69920,1900,149,1649,30138,1038555,1038555,31787,1038555,33,0
UT,10813,216694,0,164,850,379,258,180,108,6628,B,117,850,485619,39620,407151,10813,1900,149,316,3210,227507,227507,3526,227507,0,21
VA,47856,305734,412,1266,7550,321,759,171,197,6284,A+,1445,7550,351354,39620,407151,45620,1338,107,951,10252,354002,353590,11203,353590,17,74
VI,71,1975,2,961,5109,379,759,180,197,62,C,6,5109,485619,39620,407151,38775,6,149,1,19,2048,2046,20,2046,0,0
VT,1026,36808,0,13,5109,379,759,180,197,881,B,55,5109,485619,39620,407151,1026,55,149,36,603,37834,37834,639,37834,0,0
WA,24677,335972,0,272,3578,379,759,94,197,0,B,1135,3578,485619,39620,407151,24124,1135,149,292,4297,360649,360649,4589,360649,6,35
WI,22193,291367,196,551,2739,117,616,180,197,12980,A+,626,2739,485619,39620,407151,19892,626,149,532,11656,313756,313560,12188,313560,10,39
WV,2092,103957,0,28,5109,11,759,2,197,1399,B,78,5109,485619,39620,407151,38775,1900,149,21,2260,106049,106049,2281,106049,0,0
WY,915,26074,0,4,87,379,759,180,197,714,C,17,87,26777,826,25016,703,1900,149,0,361,26989,26989,361,26989,0,0
AK,505,57677,0,11,5109,379,759,0,197,373,A,10,5109,58182,39620,407151,505,10,149,18,1961,58182,58182,1979,58182,0,0
AL,18851,212743,0,610,1900,379,591,180,355,11395,B,653,1900,485619,39620,407151,18554,651,2,209,7583,231594,231594,7792,231594,2,21
AR,8067,134413,0,132,731,379,759,31,124,5717,A,142,731,485619,39620,407151,8067,1900,149,624,8620,142480,142480,9244,142480,9,13
AS,0,174,0,961,5109,379,759,180,197,0,C,0,5109,485619,39620,407151,0,1900,149,0,0,174,174,0,174,0,0
AZ,22233,222292,0,1092,3589,379,759,239,197,5076,A+,981,3589,244525,39620,407151,38775,1900,149,983,5709,244525,244525,6692,244525,40,69
CA,117687,2013607,0,4458,5109,1313,759,180,197,0,B,4361,5109,2131294,39620,407151,117687,1900,149,2377,57326,2131294,2131294,59703,2131294,75,0
CO,26788,167389,0,388,4419,379,759,180,197,3983,A,1228,4419,485619,39620,407151,24311,1900,149,211,3429,194177,194177,3640,194177,43,47
CT,43091,233345,0,406,13793,379,759,180,197,7511,B,3989,13793,279457,39620,407151,38775,3156,833,112,5714,276436,276436,5826,276436,17,0
DC,9016,40546,0,285,5109,103,759,72,197,1138,A+,473,5109,485619,39620,407151,38775,1900,149,130,1731,49562,49562,1861,49562,3,0
DE,9712,55208,0,153,5109,379,759,180,197,5493,A,475,5109,485619,39620,407151,38775,418,57,27,831,64920,64920,858,64920,4,0
FL,58764,1022149,1191,961,10796,379,759,180,197,0,B,2650,10796,1259176,79855,1176653,58764,2650,149,1317,29844,1082104,1080913,31161,1080913,37,118
GA,48894,433818,0,815,8419,379,1841,180,197,0,B,2123,8419,482712,43637,439075,48894,1900,149,687,7738,482712,482712,8425,482712,21,85
GU,178,6549,0,961,5109,379,759,180,197,151,B,5,5109,6497,170,407151,170,1900,149,1,335,6727,6727,336,6727,0,0
HI,653,48855,0,961,83,379,759,180,197,609,D,17,83,56569,39620,407151,38775,1900,149,1,586,49508,49508,587,49508,0,0
IA,20055,144390,0,314,5109,116,759,76,197,12064,A+,574,5109,485619,39620,407151,20055,1900,149,39,716,164445,164445,755,164445,13,0
ID,2933,46009,0,30,251,3,98,180,197,2282,A,83,251,48669,39620,407151,2660,63,20,27,782,48942,48942,809,48942,0,4
IL,123830,835345,0,3173,5109,844,759,508,197,0,A,5621,5109,959175,39620,407151,123830,5621,149,982,23489,959175,959175,24471,959175,96,0
IN,35712,242103,0,1017,5952,358,1282,138,197,23182,A+,2207,5952,485619,39620,407151,38775,2032,175,475,5421,277815,277815,5896,277815,10,50
KS,10170,97883,0,961,890,379,302,180,131,592,A,222,890,485619,39620,407151,38775,1900,149,159,4582,108053,108053,4741,108053,5,28
KY,10410,221789,0,488,2317,68,950,180,197,3283,B,450,2317,485619,39620,407151,10192,449,1,225,4703,232199,232199,4928,232199,8,10
LA,41133,360954,0,617,5109,379,759,86,197,31728,B,2870,5109,485619,39620,407151,38775,2759,111,387,8567,402087,402087,8954,402087,35,0
MA,101592,516169,0,1684,10151,393,759,263,197,78108,A+,7152,10151,485619,39620,407151,97964,7012,140,429,7937,617761,617761,8366,617761,67,88
MD,54982,272643,0,1109,9111,471,759,180,197,3970,B,2666,9111,380716,39620,407151,54982,2544,122,807,11003,327625,327625,11810,327625,20,154
ME,2418,50591,0,44,285,14,759,10,197,1699,B,95,285,55237,2903,52234,2903,95,149,41,0,53009,53009,41,53009,1,-2
MI,64382,613173,0,646,5109,328,759,224,197,38099,A+,5884,5109,692016,78843,613173,58878,5657,243,279,16101,677555,677555,16380,677555,15,0
MN,27889,283319,0,537,3203,254,1022,180,197,21169,A,1097,3203,311208,39620,407151,25870,1086,11,513,15388,311208,311208,15901,311208,15,69
MO,13767,197586,0,571,5109,379,759,70,197,0,B,786,5109,183650,14498,168871,13767,1900,149,192,5731,211353,211353,5923,211353,3,0
MP,23,6534,0,961,5109,379,759,180,197,16,D,2,5109,6557,39620,407151,23,2,149,0,0,6557,6557,0,6557,0,0
MS,16322,168425,0,602,2340,141,759,96,197,11203,A,782,2340,184335,39620,407151,15910,767,15,302,4947,184747,184747,5249,184747,15,44
MT,525,42923,0,1,68,379,759,180,197,464,C,17,68,485619,39620,407151,525,1900,149,2,1234,43448,43448,1236,43448,0,1
NC,30777,418486,0,684,5109,379,759,180,197,18860,A,939,5109,485619,39620,407151,30777,939,149,888,13454,449263,449263,14342,449263,18,0
ND,2679,71823,0,34,172,379,759,180,197,2169,C,54,172,101327,39620,407151,2679,51,3,33,825,74502,74502,858,74502,0,2
NE,14611,95355,0,194,851,379,759,180,197,6743,C,181,851,485619,39620,407151,14611,1900,149,266,3282,109966,109966,3548,109966,3,851
NH,4749,70990,1726,97,462,379,142,180,197,3071,B,256,462,485619,39620,407151,4749,1900,149,64,1331,77465,75739,1395,75739,11,6
NJ,162068,675352,0,2250,17390,612,759,459,197,27008,A+,11880,17390,485619,39620,407151,162068,11880,149,523,19220,837420,837420,19743,837420,110,0
NM,8024,198813,0,182,1416,379,759,180,197,2960,C,367,1416,485619,39620,407151,8024,1900,149,224,3498,206837,206837,3722,206837,5,99
NV,8935,147320,0,372,5109,84,759,47,197,501,A+,455,5109,180008,39620,407151,8935,1900,149,105,4059,156255,156255,4164,156255,3,0
NY,374085,1855388,0,2978,89995,865,759,638,197,66502,A,24079,89995,485619,39620,407151,374085,1900,149,1045,60597,2229473,2229473,61642,2229473,56,134
OH,36792,389313,0,704,6251,283,1604,198,197,0,B,2299,6251,485619,39620,407151,34208,2080,219,442,15755,426105,426105,16197,426105,41,75
OK,6805,201247,0,136,1003,59,759,180,197,5711,A+,341,1003,209286,7716,201247,38775,1900,149,113,3282,208052,208052,3395,208052,2,9
OR,4399,132269,0,112,800,27,759,10,197,2199,A+,159,800,485619,39620,407151,4280,1900,149,64,2395,136668,136668,2459,136668,2,5
PA,74022,401369,0,1164,5109,379,759,269,197,49915,A+,5741,5109,485619,39620,407151,71361,1900,149,512,2008,475391,475391,2520,475391,74,0
PR,4023,60422,0,107,5109,12,759,7,197,0,B,140,5109,61702,1952,59701,1313,63,77,88,0,64445,64445,88,64445,2,0
RI,15299,103136,0,189,1753,44,759,30,197,1311,A+,742,1753,173576,20639,152937,15299,1900,149,105,1624,118435,118435,1729,118435,10,10
SC,12651,210274,0,433,1789,379,759,180,197,6976,A+,518,1789,230687,20413,210274,12651,518,149,236,3912,222925,222925,4148,222925,17,0
SD,5162,43500,0,87,456,379,759,180,197,4084,B,62,456,485619,39620,407151,38775,1900,149,95,1721,48662,48662,1816,48662,0,13
TN,24822,445957,0,548,1829,379,759,180,197,16319,B,388,1829,485619,39620,407151,24822,388,149,447,8196,470779,470779,8643,470779,7,37
TX,68271,938497,0,1487,5109,379,759,180,197,45858,B,1734,5109,1006768,39620,407151,68271,1900,149,1703,18841,1006768,1006768,20544,1006768,36,0
UT,10497,213484,0,150,829,379,250,180,107,6501,B,117,829,485619,39620,407151,10497,1900,149,295,1895,223981,223981,2190,223981,4,28
VA,46905,295482,435,1311,7476,313,759,185,197,6165,A+,1428,7476,340197,39620,407151,44715,1322,106,666,12832,342822,342387,13498,342387,21,103
VI,70,1956,5,961,5109,379,759,180,197,62,C,6,5109,485619,39620,407151,38775,6,149,0,20,2031,2026,20,2026,0,0
VT,990,36205,0,10,5109,379,759,180,197,879,B,55,5109,485619,39620,407151,990,55,149,2,574,37195,37195,576,37195,0,0
WA,24385,331675,0,263,3543,379,759,89,197,0,B,1129,3543,485619,39620,407151,23812,1129,149,299,5029,356060,356060,5328,356060,5,26
WI,21661,279711,199,556,2700,130,606,180,197,12172,A+,616,2700,485619,39620,407151,19400,616,149,506,15968,301571,301372,16474,301372,9,57
WV,2071,101697,0,34,5109,13,759,4,197,1381,B,78,5109,485619,39620,407151,38775,1900,149,30,3195,103768,103768,3225,103768,1,0
WY,915,25713,0,4,87,379,759,180,197,714,C,17,87,26416,826,25016,703,1900,149,5,881,26628,26628,886,26628,0,1
AK,487,55716,0,10,5109,379,759,0,197,371,A,10,5109,56203,39620,407151,487,10,149,20,1993,56203,56203,2013,56203,0,0
AL,18642,205160,0,606,1879,379,591,180,355,9355,B,651,1879,485619,39620,407151,18354,649,2,279,0,223802,223802,279,223802,5,23
AR,7443,125793,0,121,718,379,759,26,124,5401,A,133,718,485619,39620,407151,7443,1900,149,0,0,133236,133236,0,133236,0,7
AS,0,174,0,961,5109,379,759,180,197,0,C,0,5109,485619,39620,407151,0,1900,149,0,0,174,174,0,174,0,0
AZ,21250,216583,0,1009,3520,380,759,235,197,4967,A+,941,3520,237833,39620,407151,38775,1900,149,1127,8636,237833,237833,9763,237833,24,75
CA,115310,1956281,0,4393,5109,1286,759,180,197,0,B,4286,5109,2071591,39620,407151,115310,1900,149,2304,56704,2071591,2071591,59008,2071591,35,0
CO,26577,163960,0,394,4372,379,759,180,197,3954,A,1185,4372,485619,39620,407151,24109,1900,149,199,3962,190537,190537,4161,190537,4,25
CT,42979,227631,0,434,13793,379,759,180,197,7511,B,3972,13793,274396,39620,407151,38775,3139,833,239,8981,270610,270610,9220,270610,8,0
DC,8886,38815,0,295,5109,106,759,74,197,1137,A+,470,5109,485619,39620,407151,38775,1900,149,29,409,47701,47701,438,47701,2,0
DE,9685,54377,0,157,5109,379,759,180,197,5442,A,471,5109,485619,39620,407151,38775,414,57,80,1535,64062,64062,1615,64062,0,0
FL,57447,992305,1206,961,10678,379,759,180,197,0,A,2613,10678,1210100,77387,1130070,57447,2613,149,617,8735,1050958,1049752,9352,1049752,70,184
GA,48207,426080,0,828,8334,379,1821,180,197,0,A,2102,8334,474287,43178,431109,48207,1900,149,589,2067,474287,474287,2656,474287,28,207
GU,177,6214,0,961,5109,379,759,180,197,148,B,5,5109,6354,39620,407151,167,1900,149,2,73,6391,6391,75,6391,0,0
HI,652,48269,0,961,83,379,759,180,197,608,D,17,83,55719,39620,407151,38775,1900,149,0,434,48921,48921,434,48921,0,0
IA,20016,143674,0,327,5109,114,759,76,197,11742,A+,561,5109,485619,39620,407151,20016,1900,149,319,4290,163690,163690,4609,163690,10,0
ID,2906,45227,0,34,247,4,98,180,197,2266,A,83,247,47870,39620,407151,2643,63,20,67,1369,48133,48133,1436,48133,1,5
IL,122848,811856,0,3238,5109,874,759,548,197,0,A,5525,5109,934704,39620,407151,122848,5525,149,1614,14817,934704,934704,16431,934704,113,0
IN,35237,236682,0,961,5902,358,1261,140,197,22623,A+,2197,5902,485619,39620,407151,38775,2022,175,407,5616,271919,271919,6023,271919,55,42
KS,10011,93301,0,961,862,379,290,180,127,555,A,217,862,485619,39620,407151,38775,1900,149,0,8071,103312,103312,8071,103312,0,20
KY,10185,217086,0,481,2307,85,941,180,197,3275,A,442,2307,485619,39620,407151,9970,441,1,139,11086,227271,227271,11225,227271,3,33
LA,40746,352387,0,639,5109,379,759,83,197,31728,B,2835,5109,485619,39620,407151,38775,2724,111,405,5358,393133,393133,5763,393133,34,0
MA,101163,508232,0,1657,10063,394,759,269,197,78108,A+,7085,10063,485619,39620,407151,97539,6944,141,358,5604,609395,609395,5962,609395,50,111
MD,54175,261640,0,1148,8957,481,759,180,197,3855,B,2646,8957,366331,39620,407151,54175,2525,121,848,6237,315815,315815,7085,315815,21,71
ME,2377,50591,0,48,287,16,759,10,197,1646,B,94,287,53536,2848,50591,2118,94,149,28,3307,52968,52968,3335,52968,5,3
MI,64103,597072,0,674,5109,346,759,240,197,38099,A+,5869,5109,675320,78248,597072,58760,5641,242,290,15648,661175,661175,15938,661175,26,0
MN,27376,267931,0,537,3134,248,1003,180,197,20381,A,1082,3134,295307,39620,407151,25508,1072,10,479,7192,295307,295307,7671,295307,22,48
MO,13575,191855,0,693,5109,379,759,81,197,0,B,783,5109,183650,14498,168871,13306,1900,149,248,5474,205430,205430,5722,205430,10,0
MP,23,6534,0,961,5109,379,759,180,197,16,D,2,5109,6557,39620,407151,23,2,149,1,222,6557,6557,223,6557,0,0
MS,16020,163478,0,584,2296,146,759,97,197,11203,A,767,2296,179388,39620,407151,15910,752,15,268,2976,179498,179498,3244,179498,28,0
MT,523,41689,0,1,67,379,759,180,197,462,C,17,67,485619,39620,407151,523,1900,149,4,1551,42212,42212,1555,42212,0,0
NC,29889,405032,0,716,5109,379,759,180,197,18860,A,921,5109,485619,39620,407151,29889,921,149,626,12387,434921,434921,13013,434921,23,0
ND,2646,70998,0,34,170,379,759,180,197,2127,C,54,170,98717,39620,407151,2646,51,3,21,322,73644,73644,343,73644,4,1
NE,14345,92073,0,961,5109,379,759,180,197,0,D,178,5109,485619,39620,407151,14345,1900,149,244,2509,106418,106418,2753,106418,8,0
NH,4685,69659,2183,98,456,379,142,180,197,2954,B,245,456,485619,39620,407151,4685,1900,149,34,1854,76527,74344,1888,74344,0,5
NJ,161545,656132,0,2370,17390,639,759,480,197,26815,A+,11770,17390,485619,39620,407151,161545,11770,149,627,21450,817677,817677,22077,817677,49,168
NM,7800,195315,0,191,1317,379,759,180,197,2888,C,362,1317,485619,39620,407151,7800,1900,149,111,3400,203115,203115,3511,203115,6,0
NV,8830,143261,0,365,5109,88,759,39,197,464,A+,452,5109,176032,39620,407151,8830,1900,149,142,5166,152091,152091,5308,152091,7,0
NY,373040,1794791,0,3121,89861,907,759,673,197,66262,A,24023,89861,485619,39620,407151,373040,1900,149,1329,52725,2167831,2167831,54054,2167831,64,158
OH,36350,373558,0,697,6176,295,1583,204,197,0,B,2258,6176,485619,39620,407151,33892,2041,217,366,11476,409908,409908,11842,409908,52,64
OK,6692,197965,0,124,994,60,759,180,197,5599,A+,339,994,206116,7628,197965,38775,1900,149,119,11265,204657,204657,11384,204657,5,8
OR,4335,129874,0,102,795,29,759,15,197,2164,A+,157,795,485619,39620,407151,4220,1900,149,33,2558,134209,134209,2591,134209,3,5
PA,73510,399361,0,1302,5109,379,759,283,197,48838,A+,5667,5109,485619,39620,407151,70864,1900,149,612,9930,472871,472871,10542,472871,100,0
PR,3935,60422,0,106,5109,17,759,10,197,0,B,138,5109,61702,1952,59701,1305,63,75,62,0,64357,64357,62,64357,2,0
RI,15194,101512,0,188,1743,48,759,31,197,1302,A+,732,1743,169876,20386,149490,15194,1900,149,107,1400,116706,116706,1507,116706,12,19
SC,12415,206362,0,425,1789,379,759,180,197,6976,A,501,1789,225047,18685,206362,12415,501,149,267,13822,218777,218777,14089,218777,1,155
SD,5067,41779,0,89,443,379,759,180,197,3990,B,62,443,485619,39620,407151,38775,1900,149,33,1152,46846,46846,1185,46846,0,8
TN,24375,437761,0,565,1792,379,759,180,197,15916,B,381,1792,485619,39620,407151,24375,381,149,821,12822,462136,462136,13643,462136,14,25
TX,66568,919656,0,1773,5109,379,759,180,197,44517,B,1698,5109,986224,39620,407151,66568,1900,149,1688,14505,986224,986224,16193,986224,20,0
UT,10202,211589,0,159,801,379,243,180,104,6319,B,113,801,485619,39620,407151,10202,1900,149,203,3476,221791,221791,3679,221791,0,12
VA,46239,282650,450,1362,7373,336,759,186,197,6011,A+,1407,7373,328889,39620,407151,44069,1300,107,841,3329,329339,328889,4170,328889,15,47
VI,70,1936,6,961,5109,379,759,180,197,62,C,6,5109,485619,39620,407151,38775,6,149,0,195,2012,2006,195,2006,0,0
VT,988,35631,0,10,5109,379,759,180,197,879,B,55,5109,485619,39620,407151,988,55,149,5,1288,36619,36619,1293,36619,0,0
WA,24086,326646,0,232,3517,379,759,48,197,0,B,1124,3517,485619,39620,407151,23463,1124,149,288,6119,350732,350732,6407,350732,6,16
WI,21155,263743,209,597,2643,139,593,180,197,12172,A+,607,2643,485619,39620,407151,18917,607,149,419,10148,285107,284898,10567,284898,12,40
WV,2041,98502,0,31,5109,11,759,4,197,1341,B,77,5109,485619,39620,407151,38775,1900,149,24,2424,100543,100543,2448,100543,2,0
WY,910,24832,0,7,86,379,759,180,197,667,C,17,86,25532,817,24714,700,1900,149,0,595,25742,25742,595,25742,0,0
AK,467,53723,0,10,5109,379,759,1,197,368,A,10,5109,54190,39620,407151,467,10,149,33,2462,54190,54190,2495,54190,0,0
AL,18363,205160,0,596,1856,379,591,180,355,9355,B,646,1856,485619,39620,407151,18075,644,2,460,5510,223523,223523,5970,223523,15,12
AR,7443,125793,0,115,711,379,759,27,123,5401,A,133,711,485619,39620,407151,7443,1900,149,190,3531,133236,133236,3721,133236,0,0
AS,0,174,0,961,5109,379,759,180,197,0,C,0,5109,485619,39620,407151,0,1900,149,0,0,174,174,0,174,0,0
AZ,20123,207947,0,968,3445,377,759,238,197,4869,A+,917,3445,228070,39620,407151,38775,1900,149,187,2677,228070,228070,2864,228070,11,66
CA,113006,1899577,0,4258,5109,1273,759,180,197,0,B,4251,5109,2012583,39620,407151,113006,1900,149,2423,65312,2012583,2012583,67735,2012583,38,0
CO,26378,159998,0,414,4347,379,759,180,197,3919,A,1181,4347,485619,39620,407151,23949,1900,149,280,5469,186376,186376,5749,186376,0,14
CT,42740,218650,0,454,13793,379,759,180,197,7511,B,3964,13793,268572,39620,407151,38775,3110,854,539,10805,261390,261390,11344,261390,20,1255
DC,8857,38406,0,302,5109,108,759,67,197,1126,A+,468,5109,485619,39620,407151,38775,1900,149,56,724,47263,47263,780,47263,2,0
DE,9605,52842,0,159,5109,379,759,180,197,5353,A,471,5109,485619,39620,407151,38775,414,57,107,1669,62447,62447,1776,62447,3,0
FL,56830,983570,1160,961,10494,379,759,180,197,0,A,2543,10494,1210100,77387,1130070,56830,2543,149,667,18384,1041560,1040400,19051,1040400,9,41
GA,47618,424013,0,841,8127,379,1800,180,197,0,A,2074,8127,471631,39620,407151,47618,1900,149,632,5474,471631,471631,6106,471631,32,181
GU,175,6141,0,961,5109,379,759,180,197,145,B,5,5109,6281,39620,407151,167,1900,149,2,212,6316,6316,214,6316,0,0
HI,652,47835,0,961,83,379,759,180,197,608,D,17,83,55336,39620,407151,38775,1900,149,1,-6134,48487,48487,-6133,48487,0,0
IA,19697,139384,0,339,5109,125,759,73,197,11440,A+,551,5109,485619,39620,407151,19697,1900,149,145,2640,159081,159081,2785,159081,17,0
ID,2839,43858,0,25,242,3,96,180,197,2248,A,82,242,46436,39620,407151,2578,62,20,0,0,46697,46697,0,46697,0,0
IL,121234,797039,0,3215,5109,902,759,547,197,0,A,5412,5109,918273,39620,407151,121234,5412,149,974,19040,918273,918273,20014,918273,22,0
IN,34830,231066,0,1041,5860,366,1255,148,197,22224,A+,2142,5860,485619,39620,407151,38775,1976,166,256,4094,265896,265896,4350,265896,8,575
KS,10011,85230,0,961,842,379,284,180,124,547,A,217,842,485619,39620,407151,38775,1900,149,292,0,95241,95241,292,95241,9,0
KY,10046,206000,0,457,2274,90,940,180,197,3232,A,439,2274,485619,39620,407151,9853,438,1,342,1951,216046,216046,2293,216046,8,2
LA,40341,347029,0,661,5109,379,759,86,197,31728,B,2801,5109,485619,39620,407151,38775,2690,111,425,11836,387370,387370,12261,387370,10,0
MA,100805,502628,0,1747,9952,404,759,289,197,78108,A,7035,9952,485619,39620,407151,97291,6894,141,3840,6740,603433,603433,10580,603433,189,129
MD,53327,255403,0,1174,8886,479,759,180,197,3782,B,2625,8886,357545,39620,407151,53327,2505,120,549,6300,308730,308730,6849,308730,29,148
ME,2349,47284,0,52,284,17,759,10,197,1586,B,89,284,50078,2710,47284,2093,89,149,24,0,49633,49633,24,49633,0,1
MI,63813,581424,0,674,5109,346,759,240,197,38099,A+,5843,5109,659153,77729,581424,58594,5627,242,245,14232,645237,645237,14477,645237,25,0
MN,26897,260739,0,549,3086,253,981,180,197,19441,A,1060,3086,287636,39620,407151,25208,1050,10,575,3606,287636,287636,4181,287636,10,39
MO,13327,186381,0,693,5109,379,759,78,197,0,B,773,5109,183650,14498,168871,13327,1900,149,180,5967,199708,199708,6147,199708,1,0
MP,22,6312,0,961,5109,379,759,180,197,16,D,2,5109,6334,39620,407151,22,2,149,0,161,6334,6334,161,6334,0,0
MS,15752,160502,0,584,2296,146,759,97,197,11203,A,739,2296,176254,39620,407151,15752,1900,149,251,4166,176254,176254,4417,176254,5,24
MT,519,40138,0,2,67,379,759,180,197,461,C,17,67,485619,39620,407151,519,1900,149,4,855,40657,40657,859,40657,0,0
NC,29263,392645,0,650,5109,379,759,180,197,18860,A,898,5109,485619,39620,407151,29263,898,149,674,4945,421908,421908,5619,421908,12,0
ND,2625,70676,0,35,169,379,759,180,197,2078,C,50,169,97111,39620,407151,2625,47,3,48,1213,73301,73301,1261,73301,2,2
NE,14101,89564,0,961,5109,379,759,180,197,0,D,170,5109,485619,39620,407151,14101,1900,149,196,2327,103665,103665,2523,103665,0,0
NH,4651,67805,1661,96,451,379,141,180,197,2948,B,245,451,485619,39620,407151,4651,1900,149,106,2070,74117,72456,2176,72456,3,2
NJ,160918,634682,0,2466,17222,646,759,459,197,26703,A+,11721,17222,485619,39620,407151,160918,11721,149,473,48982,795600,795600,49455,795600,23,25
NM,7689,191915,0,182,1317,379,759,180,197,2853,C,356,1317,485619,39620,407151,7689,1900,149,65,5092,199604,199604,5157,199604,5,0
NV,8688,138095,0,361,5109,87,759,40,197,459,A+,445,5109,169813,39620,407151,8688,1900,149,95,4128,146783,146783,4223,146783,1,0
NY,371711,1742066,0,3331,89703,999,759,746,197,66110,A,23959,89703,485619,39620,407151,371711,1900,149,941,49011,2113777,2113777,49952,2113777,54,113
OH,35984,362082,0,761,6112,324,1569,223,197,0,B,2206,6112,485619,39620,407151,33501,1993,213,471,6687,398066,398066,7158,398066,51,63
OK,6573,186700,0,154,986,65,759,180,197,5511,A+,334,986,194496,7291,186700,38775,1900,149,67,0,193273,193273,67,193273,0,1
OR,4302,127316,0,108,790,32,759,17,197,2164,A+,154,790,485619,39620,407151,4192,1900,149,59,2358,131618,131618,2417,131618,1,4
PA,72898,389431,0,1302,5109,379,759,287,197,48428,A+,5567,5109,485619,39620,407151,70278,1900,149,352,6320,462329,462329,6672,462329,12,0
PR,3873,60422,0,99,5109,9,759,4,197,0,B,136,5109,61702,1952,59701,1304,63,73,97,0,64295,64295,97,64295,0,0
RI,15087,100112,0,195,1724,46,759,29,197,1281,A+,720,1724,166628,20124,146504,15087,1900,149,99,1322,115199,115199,1421,115199,2,23
SC,12148,192540,0,450,1634,379,759,180,197,6459,A,500,1634,210826,18286,192540,12148,500,149,287,4185,204688,204688,4472,204688,6,0
SD,5034,40627,0,87,435,379,759,180,197,3903,B,62,435,485619,39620,407151,38775,1900,149,41,1492,45661,45661,1533,45661,0,3
TN,23554,424939,0,504,1767,379,759,180,197,15564,B,367,1767,485619,39620,407151,23554,367,149,548,11968,448493,448493,12516,448493,3,17
TX,64880,905151,0,1756,5109,379,759,180,197,43338,B,1678,5109,970031,39620,407151,64880,1900,149,593,17573,970031,970031,18166,970031,6,0
UT,9999,208113,0,134,789,379,242,180,102,6251,B,113,789,485619,39620,407151,9999,1900,149,202,3996,218112,218112,4198,218112,0,14
VA,45398,279321,419,1371,7326,347,759,188,197,5899,A+,1392,7326,322568,39620,407151,43247,1282,110,791,8537,325138,324719,9328,324719,17,0
VI,70,1741,4,961,5109,379,759,180,197,62,C,6,5109,485619,39620,407151,38775,6,149,1,108,1815,1811,109,1811,0,0
VT,983,34343,0,16,5109,379,759,180,197,880,B,55,5109,485619,39620,407151,983,55,149,2,1354,35326,35326,1356,35326,0,0
WA,23798,320527,0,245,3501,379,759,52,197,0,B,1118,3501,485619,39620,407151,23069,1118,149,342,5856,344325,344325,6198,344325,0,21
WI,20736,253595,211,613,2603,136,586,180,197,11838,A+,595,2603,485619,39620,407151,18543,595,149,172,3492,274542,274331,3664,274331,3,20
WV,2017,96078,0,31,5109,11,759,4,197,1313,B,75,5109,485619,39620,407151,38775,1900,149,7,466,98095,98095,473,98095,0,0
WY,910,24237,0,8,86,379,759,180,197,667,C,17,86,24937,788,22402,700,1900,149,7,747,25147,25147,754,25147,1,1
AK,434,51261,0,14,5109,379,759,2,197,368,A,10,5109,51695,39620,407151,434,10,149,0,0,51695,51695,0,51695,0,0
AL,17903,199650,0,527,1844,379,589,180,355,9355,B,631,1844,485619,39620,407151,17614,629,2,544,4808,217553,217553,5352,217553,13,18
AR,7253,122262,0,115,711,379,759,27,123,5275,A,133,711,485619,39620,407151,7253,1900,149,240,2778,129515,129515,3018,129515,0,9
AS,0,174,0,961,5109,379,759,180,197,0,C,0,5109,485619,39620,407151,0,1900,149,0,0,174,174,0,174,0,0
AZ,19936,205270,0,973,3379,376,759,239,197,4761,A+,906,3379,225206,39620,407151,38775,1900,149,681,7478,225206,225206,8159,225206,3,45
CA,110583,1834265,0,4331,5109,1324,759,180,197,0,B,4213,5109,1944848,39620,407151,110583,1900,149,3705,52548,1944848,1944848,56253,1944848,57,0
CO,26098,154529,0,414,4333,379,759,180,197,3919,A,1181,4333,485619,39620,407151,23667,1900,149,485,4401,180627,180627,4886,180627,0,26
CT,42201,207845,0,481,12538,379,759,180,197,7127,B,3944,12538,259320,39620,407151,38775,1900,149,179,2932,250046,250046,3111,250046,32,0
DC,8801,37682,0,295,5109,109,759,66,197,1116,A+,466,5109,485619,39620,407151,38775,1900,149,84,770,46483,46483,854,46483,4,0
DE,9498,51173,0,160,5109,379,759,180,197,5266,A,468,5109,485619,39620,407151,38775,411,57,76,1266,60671,60671,1342,60671,2,0
FL,56163,965186,1332,961,10453,379,759,180,197,0,A,2534,10453,1155650,75508,1077549,56163,2534,149,739,25642,1022681,1021349,26381,1021349,4,78
GA,46986,418539,0,853,7946,379,1794,180,197,0,A,2042,7946,465525,39620,407151,46986,1900,149,700,9987,465525,465525,10687,465525,39,25
GU,173,5929,0,961,5109,379,759,180,197,144,C,5,5109,6011,39620,407151,166,1900,149,0,0,6102,6102,0,6102,0,0
HI,651,53969,0,961,83,379,759,180,197,606,D,17,83,54620,39620,407151,38775,1900,149,2,604,54620,54620,606,54620,0,0
IA,19552,136744,0,341,5109,116,759,70,197,11147,A+,534,5109,485619,39620,407151,19552,1900,149,308,5565,156296,156296,5873,156296,3,0
ID,2839,43858,0,29,242,3,96,180,197,2248,A,82,242,46436,39620,407151,2578,62,20,36,1237,46697,46697,1273,46697,0,2
IL,120260,777999,0,3296,5109,941,759,550,197,0,A,5390,5109,898259,39620,407151,120260,5390,149,1343,19811,898259,898259,21154,898259,60,0
IN,34574,226972,0,1050,5285,372,1248,143,197,21704,A+,2134,5285,485619,39620,407151,38775,1967,167,363,4788,261546,261546,5151,261546,9,0
KS,9719,85230,0,961,842,379,284,180,124,547,A,208,842,485619,39620,407151,38775,1900,149,0,0,94949,94949,0,94949,0,0
KY,9704,204049,0,480,2272,87,940,180,197,3232,A,431,2272,485619,39620,407151,9537,430,1,240,5318,213753,213753,5558,213753,13,6
LA,39916,335193,0,678,5109,379,759,84,197,28700,B,2791,5109,485619,39620,407151,38775,2686,105,339,5951,375109,375109,6290,375109,6,0
MA,96965,495888,0,1824,9823,436,759,180,197,78108,A,6846,9823,485619,39620,407151,96965,6846,149,664,9670,592853,592853,10334,592853,78,34
MD,52778,249103,0,1183,8738,479,759,180,197,3764,B,2596,8738,348773,39620,407151,52778,2476,120,763,7172,301881,301881,7935,301881,34,119
ME,2325,47284,0,49,283,18,759,10,197,1552,B,89,283,50078,2710,47284,2067,89,149,43,0,49609,49609,43,49609,0,11
MI,63568,567192,0,774,5109,371,759,250,197,38099,A+,5818,5109,644519,77327,567192,58417,5601,240,247,12683,630760,630760,12930,630760,16,0
MN,26322,257133,0,555,3047,257,971,180,197,18695,A,1050,3047,283455,39620,407151,24850,1040,10,141,6741,283455,283455,6882,283455,14,36
MO,13147,180414,0,718,5109,379,759,83,197,0,B,772,5109,183650,14498,168871,12966,1900,149,185,7946,193561,193561,8131,193561,1,0
MP,22,6151,0,961,5109,379,759,180,197,15,D,2,5109,6173,39620,407151,22,2,149,0,165,6173,6173,165,6173,0,0
MS,15501,156336,0,570,2272,113,759,108,197,9401,A,734,2272,171837,39620,407151,15501,1900,149,272,5633,171837,171837,5905,171837,11,32
MT,515,39283,0,2,67,379,759,180,197,456,C,17,67,485619,39620,407151,515,1900,149,10,504,39798,39798,514,39798,0,0
NC,28589,387700,0,649,5109,379,759,180,197,14954,A,886,5109,485619,39620,407151,28589,886,149,916,11216,416289,416289,12132,416289,9,0
ND,2577,69463,0,36,167,379,759,180,197,1959,C,48,167,94711,39620,407151,2577,45,3,23,1036,72040,72040,1059,72040,0,2
NE,13905,87237,0,961,5109,379,759,180,197,0,D,170,5109,485619,39620,407151,13905,1900,149,251,1883,101142,101142,2134,101142,0,0
NH,4545,65735,1208,107,449,379,140,180,197,2940,B,242,449,485619,39620,407151,4545,1900,149,53,1267,71488,70280,1320,70280,4,9
NJ,160445,585700,0,2497,17197,522,759,378,197,26560,A+,11698,17197,485619,39620,407151,160445,11698,149,837,0,746145,746145,837,746145,64,76
NM,7624,186823,0,189,1317,379,759,180,197,2835,C,351,1317,485619,39620,407151,7624,1900,149,131,6055,194447,194447,6186,194447,7,0
NV,8593,133967,0,336,5109,71,759,41,197,428,A+,444,5109,165014,39620,407151,8593,1900,149,98,3930,142560,142560,4028,142560,5,0
NY,370770,1693055,0,3436,89590,1050,759,791,197,65934,A,23905,89590,485619,39620,407151,370770,1900,149,1110,57334,2063825,2063825,58444,2063825,57,190
OH,35513,355395,0,779,6049,310,1556,213,197,0,B,2155,6049,485619,39620,407151,33073,1944,211,479,8482,390908,390908,8961,390908,6,38
OK,6506,186700,0,154,985,65,759,180,197,5492,A+,334,985,194496,7291,186700,38775,1900,149,88,0,193206,193206,88,193206,0,3
OR,4243,124958,0,117,786,33,759,17,197,2152,A+,153,786,485619,39620,407151,4135,1900,149,58,2348,129201,129201,2406,129201,0,8
PA,72546,383111,0,1352,5109,379,759,296,197,48190,A,5555,5109,485619,39620,407151,69916,1900,149,515,7370,455657,455657,7885,455657,18,0
PR,3776,60422,0,99,5109,9,759,1,197,0,B,136,5109,61702,1952,59701,1304,63,73,58,0,64198,64198,58,64198,3,0
RI,14988,98790,0,206,1701,46,759,29,197,1252,A+,718,1701,163692,19922,143770,14988,1900,149,76,850,113778,113778,926,113778,7,19
SC,11861,188355,0,402,1634,379,759,180,197,6459,A,494,1634,206247,17892,188355,11861,494,149,467,10230,200216,200216,10697,200216,7,0
SD,4993,39135,0,86,432,379,759,180,197,3837,B,62,432,485619,39620,407151,38775,1900,149,33,1157,44128,44128,1190,44128,0,5
TN,23006,412971,0,463,1750,379,759,180,197,15300,B,364,1750,485619,39620,407151,23006,364,149,440,8491,435977,435977,8931,435977,0,18
TX,64287,887578,0,1684,5109,379,759,180,197,42423,B,1672,5109,951865,39620,407151,64287,1900,149,1949,21399,951865,951865,23348,951865,46,0
UT,9797,204117,0,142,775,379,242,180,102,6137,B,113,775,485619,39620,407151,9797,1900,149,264,3545,213914,213914,3809,213914,1,12
VA,44607,270784,500,1458,7326,371,759,196,197,5868,A+,1375,7326,313283,39620,407151,42499,1274,101,996,8883,315891,315391,9879,315391,5,110
VI,69,1633,19,961,5109,379,759,180,197,61,C,6,5109,485619,39620,407151,38775,6,149,0,0,1721,1702,0,1702,0,0
VT,981,32989,0,18,5109,379,759,180,197,873,B,55,5109,485619,39620,407151,981,55,149,4,1299,33970,33970,1303,33970,0,0
WA,23456,314671,0,266,3480,379,759,67,197,0,B,1118,3480,485619,39620,407151,22683,1118,149,181,2163,338127,338127,2344,338127,7,25
WI,20564,250103,211,625,2583,133,585,180,197,11646,A+,592,2583,485619,39620,407151,18403,592,149,182,7195,270878,270667,7377,270667,4,20
WV,2010,95612,0,33,5109,14,759,8,197,1303,B,75,5109,485619,39620,407151,38775,1900,149,36,1696,97622,97622,1732,97622,0,0
WY,903,23490,0,13,85,379,759,180,197,658,C,16,85,24183,788,22402,693,1900,149,5,305,24393,24393,310,24393,0,0
AK,434,51261,0,14,5109,379,759,2,197,368,A,10,5109,51695,39620,407151,434,10,149,4,2252,51695,51695,2256,51695,0,0
AL,17359,194842,0,536,1826,379,583,180,349,9355,B,618,1826,485619,39620,407151,17359,618,149,536,2782,212201,212201,3318,212201,13,26
AR,7013,119484,0,104,702,379,759,26,123,5166,A,133,702,485619,39620,407151,7013,1900,149,475,6254,126497,126497,6729,126497,8,35
AS,0,174,0,961,5109,379,759,180,197,0,C,0,5109,485619,39620,407151,0,1900,149,0,0,174,174,0,174,0,0
AZ,19255,197792,0,975,3334,386,759,241,197,4657,A+,903,3334,217047,39620,407151,38775,1900,149,790,6444,217047,217047,7234,217047,18,53
CA,106878,1781717,0,4215,5109,1273,759,180,197,0,B,4156,5109,1888595,39620,407151,106878,1900,149,2992,50125,1888595,1888595,53117,1888595,88,0
CO,25613,150128,0,421,4307,379,759,180,197,3859,A,1181,4307,485619,39620,407151,23172,1900,149,492,6290,175741,175741,6782,175741,13,53
CT,42022,204913,0,533,12538,379,759,180,197,7127,B,3912,12538,250046,39620,407151,38775,1900,149,260,5282,246935,246935,5542,246935,44,0
DC,8717,36912,0,317,5109,109,759,66,197,1100,A+,462,5109,485619,39620,407151,38775,1900,149,179,1592,45629,45629,1771,45629,2,0
DE,9422,49907,0,174,5109,379,759,180,197,5205,A,466,5109,485619,39620,407151,38775,409,57,186,1610,59329,59329,1796,59329,3,0
FL,55424,939544,0,961,10375,379,759,180,197,0,A,2530,10375,1155650,75508,1077549,55424,2530,149,927,10802,994968,994968,11729,994968,35,132
GA,46286,408552,0,850,7921,379,1790,180,197,0,A,2003,7921,454838,39620,407151,46286,1900,149,616,3951,454838,454838,4567,454838,29,69
GU,173,5929,0,961,5109,379,759,180,197,144,C,5,5109,6011,39620,407151,166,1900,149,1,6,6102,6102,7,6102,0,0
HI,649,53365,0,961,83,379,759,180,197,605,D,17,83,54014,39620,407151,38775,1900,149,2,1188,54014,54014,1190,54014,0,0
IA,19244,131179,0,368,5109,118,759,69,197,11019,A+,531,5109,485619,39620,407151,19244,1900,149,318,2785,150423,150423,3103,150423,9,0
ID,2803,42621,0,30,240,379,96,180,197,2225,A,82,240,45172,39620,407151,2551,62,20,34,629,45424,45424,663,45424,0,2
IL,118917,758188,0,3336,5109,925,759,661,197,0,A,5330,5109,877105,39620,407151,118917,5330,149,1462,23881,877105,877105,25343,877105,60,0
IN,34211,222184,0,1149,5285,412,1166,161,197,0,A+,2125,5285,485619,39620,407151,38775,1958,167,653,7029,256395,256395,7682,256395,15,0
KS,9719,85230,0,961,842,379,284,180,124,547,A,208,842,485619,39620,407151,38775,1900,149,0,0,94949,94949,0,94949,0,0
KY,9464,198731,0,499,2266,81,940,180,197,3231,A,418,2266,485619,39620,407151,9303,417,1,280,-13359,208195,208195,-13079,208195,9,86
LA,39577,329242,0,674,5109,379,759,84,197,28700,B,2785,5109,485619,39620,407151,38775,2680,105,775,13017,368819,368819,13792,368819,19,0
MA,96301,486218,0,1904,9789,453,759,180,197,78108,A,6768,9789,485619,39620,407151,96301,6768,149,789,9985,582519,582519,10774,582519,50,64
MD,52015,241931,0,1239,8619,492,759,180,197,3649,B,2562,8619,339361,39620,407151,52015,2444,118,1027,8401,293946,293946,9428,293946,24,140
ME,2282,47284,0,46,272,18,759,11,197,1505,B,89,272,50078,2710,47284,2025,89,149,56,3804,49566,49566,3860,49566,4,2
MI,63321,554509,0,774,5109,371,759,250,197,38099,A+,5802,5109,631367,76858,554509,58254,5578,240,205,15641,617830,617830,15846,617830,24,0
MN,26181,250392,0,589,3011,263,960,180,197,17864,A,1036,3011,276573,39620,407151,24190,1026,10,168,8268,276573,276573,8436,276573,30,75
MO,12962,172468,0,679,5109,379,759,85,197,0,B,771,5109,183650,14498,168871,12966,1900,149,167,7413,185430,185430,7580,185430,33,0
MP,22,5986,0,961,5109,379,759,180,197,15,D,2,5109,6008,39620,407151,22,2,149,0,324,6008,6008,324,6008,0,0
MS,15229,150703,0,593,2240,145,759,92,197,9401,A,723,2240,165932,39620,407151,15229,1900,149,439,-815,165932,165932,-376,165932,13,32
MT,505,38779,0,2,67,379,759,180,197,448,C,17,67,485619,39620,407151,493,1900,149,12,743,39284,39284,755,39284,0,0
NC,27673,376484,0,638,5109,379,759,180,197,14954,A,877,5109,485619,39620,407151,27673,877,149,1185,11741,404157,404157,12926,404157,18,0
ND,2554,68427,0,34,165,379,759,180,197,1943,C,48,165,92632,39620,407151,2554,45,3,34,1494,70981,70981,1528,70981,0,1
NE,13654,85354,0,961,5109,379,759,180,197,0,D,170,5109,485619,39620,407151,13654,1900,149,393,3812,99008,99008,4205,99008,6,0
NH,4492,64468,960,105,440,379,120,180,197,2802,B,238,440,485619,39620,407151,4492,1900,149,106,1992,69920,68960,2098,68960,6,2
NJ,159608,585700,0,2626,17121,672,759,499,197,26301,A+,11634,17121,485619,39620,407151,159608,11634,149,764,28133,745308,745308,28897,745308,103,161
NM,7493,180768,0,193,1317,379,759,180,197,2728,C,344,1317,485619,39620,407151,7493,1900,149,129,4588,188261,188261,4717,188261,9,0
NV,8495,130037,0,371,5109,92,759,42,197,428,A+,439,5109,160499,39620,407151,8495,1900,149,145,3971,138532,138532,4116,138532,4,0
NY,369660,1635721,0,3619,89400,1124,759,857,197,65609,A,23848,89400,485619,39620,407151,369660,1900,149,1376,59875,2005381,2005381,61251,2005381,68,206
OH,35034,346913,0,806,6011,339,1548,219,197,0,B,2149,6011,485619,39620,407151,32639,1938,211,468,11589,381947,381947,12057,381947,18,64
OK,6418,186700,0,154,982,65,759,180,197,5435,A+,334,982,194496,7291,186700,38775,1900,149,80,5640,193118,193118,5720,193118,5,0
OR,4185,122610,0,131,778,32,759,17,197,2137,A+,153,778,485619,39620,407151,4083,1900,149,54,4060,126795,126795,4114,126795,2,7
PA,72031,375741,0,1352,5109,379,759,295,197,47133,A,5537,5109,485619,39620,407151,69424,1900,149,692,8771,447772,447772,9463,447772,73,0
PR,3718,60422,0,106,5109,6,759,5,197,0,B,133,5109,61702,1952,59701,1300,62,71,71,0,64140,64140,71,64140,1,0
RI,14912,97940,0,219,1682,50,759,32,197,1225,A+,711,1682,161819,19776,142043,14912,1900,149,104,1828,112852,112852,1932,112852,18,22
SC,11394,178125,0,387,1634,379,759,180,197,6459,A,487,1634,199735,21610,178125,11394,487,149,263,999,189519,189519,1262,189519,4,0
SD,4960,37978,0,93,427,379,759,180,197,3805,B,62,427,485619,39620,407151,38775,1900,149,94,2162,42938,42938,2256,42938,3,9
TN,22566,404480,0,516,1732,379,759,180,197,15193,B,364,1732,485619,39620,407151,22566,364,149,481,4598,427046,427046,5079,427046,4,22
TX,62338,866179,0,1752,5109,379,759,180,197,40068,B,1626,5109,928517,39620,407151,62338,1900,149,1332,33910,928517,928517,35242,928517,0,0
UT,9533,200572,0,139,763,379,241,180,102,5995,B,112,763,485619,39620,407151,9533,1900,149,269,3981,210105,210105,4250,210105,5,10
VA,43611,261901,481,1471,7216,372,759,194,197,5745,A+,1370,7216,303430,39620,407151,41529,1269,101,1078,6057,305993,305512,7135,305512,12,44
VI,69,1633,19,961,5109,379,759,180,197,61,C,6,5109,485619,39620,407151,38775,6,149,0,0,1721,1702,0,1702,0,0
VT,977,31690,0,17,5109,379,759,180,197,865,B,55,5109,485619,39620,407151,977,55,149,2,780,32667,32667,782,32667,0,0
WA,23275,312508,0,319,3455,379,759,88,197,0,B,1111,3455,485619,39620,407151,22583,1111,149,228,3070,335783,335783,3298,335783,5,42
WI,20382,242908,208,617,2563,144,577,180,197,11338,A+,588,2563,485619,39620,407151,18230,588,149,539,9320,263498,263290,9859,263290,20,64
WV,1974,93916,0,33,5109,14,759,8,197,1290,B,75,5109,485619,39620,407151,38775,1900,149,23,2490,95890,95890,2513,95890,1,0
WY,898,23185,0,13,85,379,759,180,197,658,C,16,85,23900,788,22402,688,1900,149,7,807,24083,24083,814,24083,1,1
AK,430,49009,0,14,5109,379,759,1,197,367,A,10,5109,49439,39620,407151,430,10,149,5,1464,49439,49439,1469,49439,0,0
AL,16823,192060,0,590,1800,379,577,180,344,9355,B,605,1800,485619,39620,407151,16823,605,149,513,7889,208883,208883,8402,208883,15,35
AR,6538,113230,0,104,667,379,759,27,119,4583,A,125,667,485619,39620,407151,6538,1900,149,0,866,119768,119768,866,119768,5,27
AS,0,174,0,961,5109,379,759,180,197,0,C,0,5109,485619,39620,407151,0,1900,149,0,0,174,174,0,174,0,0
AZ,18465,191348,0,931,3281,378,759,238,197,4551,A+,885,3281,209813,39620,407151,38775,1900,149,702,6197,209813,209813,6899,209813,28,58
CA,103886,1731592,0,4414,5109,1328,759,180,197,0,B,4068,5109,1835478,39620,407151,103886,1900,149,2189,42730,1835478,1835478,44919,1835478,95,0
CO,25121,143838,0,464,4254,379,759,180,197,3838,A,1168,4254,485619,39620,407151,22758,1900,149,354,5482,168959,168959,5836,168959,33,58
CT,41762,199631,0,577,12538,379,759,180,197,7127,B,3868,12538,246935,39620,407151,38775,1900,149,203,5665,241393,241393,5868,241393,42,0
DC,8538,35320,0,338,5109,114,759,65,197,1089,A+,460,5109,485619,39620,407151,38775,1900,149,46,298,43858,43858,344,43858,7,0
DE,9236,48297,0,183,5109,379,759,180,197,5103,A,463,5109,485619,39620,407151,38775,406,57,65,667,57533,57533,732,57533,4,0
FL,54497,928742,1308,961,10243,379,759,180,197,0,A,2495,10243,1103658,72521,1028579,53285,2495,149,1212,30411,984547,983239,31623,983239,49,187
GA,45670,404601,0,889,7852,379,1780,180,197,0,A,1974,7852,450271,39620,407151,45670,1900,149,600,5025,450271,450271,5625,450271,12,85
GU,172,5923,0,961,5109,379,759,180,197,144,C,5,5109,6011,39620,407151,165,1900,149,0,133,6095,6095,133,6095,0,0
HI,647,52177,0,961,83,379,759,180,197,604,D,17,83,52824,39620,407151,38775,1900,149,3,982,52824,52824,985,52824,0,0
IA,18926,128394,0,376,5109,117,759,78,197,10753,A+,522,5109,485619,39620,407151,18926,1900,149,353,4034,147320,147320,4387,147320,18,0
ID,2769,41992,0,31,238,379,96,180,197,2195,A,82,238,44511,39620,407151,2519,62,20,38,848,44761,44761,886,44761,0,4
IL,117455,734307,0,3599,5109,980,759,593,197,0,A,5270,5109,851762,39620,407151,117455,5270,149,1622,20174,851762,851762,21796,851762,84,0
IN,33558,215155,0,1149,5285,412,1166,161,197,0,A+,2110,5285,485619,39620,407151,38775,1946,164,490,5936,248713,248713,6426,248713,42,0
KS,9719,85230,0,961,842,379,284,180,124,547,A,208,842,485619,39620,407151,38775,1900,149,382,10079,94949,94949,10461,94949,3,20
KY,9184,212090,0,494,2180,88,937,180,197,3181,A,409,2180,485619,39620,407151,9028,408,1,107,39066,221274,221274,39173,221274,9,38
LA,38802,316225,0,714,5109,379,759,90,197,28700,B,2766,5109,485619,39620,407151,38775,2661,105,0,0,355027,355027,0,355027,26,0
MA,95512,476233,0,1991,9725,485,759,180,197,78108,A,6718,9725,485619,39620,407151,95512,6718,149,617,8805,571745,571745,9422,571745,78,107
MD,50988,233530,0,1296,8479,507,759,180,197,3571,B,2538,8479,328516,39620,407151,50988,2421,117,1279,8381,284518,284518,9660,284518,37,87
ME,2226,43480,0,53,270,18,759,12,197,1458,B,85,270,46123,2563,43480,1971,85,149,37,0,45706,45706,37,45706,1,6
MI,63116,538868,0,774,5109,371,759,250,197,33168,A+,5778,5109,615138,76270,538868,58065,5562,240,319,16205,601984,601984,16524,601984,27,0
MN,26013,242124,0,592,2936,259,938,180,197,16930,A,1006,2936,268137,39620,407151,23531,996,10,454,9929,268137,268137,10383,268137,29,56
MO,12795,165055,0,650,5109,379,759,85,197,0,B,738,5109,183650,14498,168871,12616,1900,149,122,6661,177850,177850,6783,177850,31,0
MP,22,5662,0,961,5109,379,759,180,197,13,D,2,5109,5684,39620,407151,22,2,149,0,261,5684,5684,261,5684,0,0
MS,14790,151518,0,584,2208,121,759,77,197,9401,A,710,2208,158973,39620,407151,14790,1900,149,418,9393,166308,166308,9811,166308,17,61
MT,493,38036,0,2,67,379,759,180,197,448,C,17,67,485619,39620,407151,493,1900,149,8,1728,38529,38529,1736,38529,0,1
NC,26488,364743,0,680,5109,379,759,180,197,14954,A,859,5109,485619,39620,407151,26488,859,149,1076,14963,391231,391231,16039,391231,32,0
ND,2520,66933,0,36,164,379,759,180,197,1882,C,48,164,89599,39620,407151,2520,45,3,39,1160,69453,69453,1199,69453,0,3
NE,13261,81542,0,961,5109,379,759,180,197,0,D,164,5109,485619,39620,407151,13261,1900,149,285,1538,94803,94803,1823,94803,1,0
NH,4386,62476,891,110,438,379,120,180,197,2730,B,232,438,485619,39620,407151,4386,1900,149,100,1166,67753,66862,1266,66862,9,12
NJ,158844,557567,0,2707,16960,720,759,544,197,26084,A+,11531,16960,485619,39620,407151,158844,11531,149,1029,29525,716411,716411,30554,716411,130,182
NM,7364,176180,0,196,1317,379,759,180,197,2684,C,335,1317,485619,39620,407151,7364,1900,149,112,3889,183544,183544,4001,183544,6,35
NV,8350,126066,0,371,5109,92,759,42,197,428,A+,435,5109,155449,39620,407151,8350,1900,149,142,3084,134416,134416,3226,134416,10,0
NY,368284,1575846,0,3781,89194,1164,759,889,197,65289,A,23780,89194,485619,39620,407151,368284,1900,149,1551,65790,1944130,1944130,67341,1944130,58,152
OH,34566,335324,0,833,5947,326,1533,222,197,0,B,2131,5947,485619,39620,407151,32202,1921,210,651,9227,369890,369890,9878,369890,33,136
OK,6338,181060,0,160,982,68,759,180,197,5340,A+,329,982,188665,7114,181060,38775,1900,149,68,4924,187398,187398,4992,187398,3,7
OR,4131,118550,0,155,771,36,759,21,197,1981,A+,151,771,485619,39620,407151,4029,1900,149,45,2989,122681,122681,3034,122681,0,3
PA,71339,366970,0,1445,5109,379,759,313,197,46370,A,5464,5109,485619,39620,407151,68765,1900,149,1297,9166,438309,438309,10463,438309,91,0
PR,3647,60422,0,101,5109,12,759,5,197,0,B,132,5109,61702,1952,59701,1293,62,70,161,0,64069,64069,161,64069,1,0
RI,14808,96112,0,219,1660,47,759,33,197,1206,A+,693,1660,157650,19565,138085,14808,1900,149,178,1537,110920,110920,1715,110920,16,21
SC,11131,177126,0,399,1634,379,759,180,197,6459,A,483,1634,194047,16921,177126,11131,483,149,343,5665,188257,188257,6008,188257,13,16
SD,4866,35816,0,95,418,379,759,180,197,3744,B,59,418,485619,39620,407151,38775,1900,149,73,1583,40682,40682,1656,40682,5,12
TN,22085,399882,0,507,1710,379,759,180,197,14965,B,360,1710,485619,39620,407151,22085,360,149,406,5572,421967,421967,5978,421967,4,21
TX,61006,832269,0,1701,5109,379,759,180,197,40068,B,1626,5109,893275,39620,407151,61006,1900,149,1230,18827,893275,893275,20057,893275,25,0
UT,9264,196591,0,135,753,379,237,180,102,5813,B,107,753,485619,39620,407151,9264,1900,149,343,2005,205855,205855,2348,205855,1,19
VA,42533,255844,525,1524,7172,373,759,193,197,5648,A+,1358,7172,296321,39620,407151,40477,1258,100,1132,9964,298902,298377,11096,298377,20,198
VI,69,1633,19,961,5109,379,759,180,197,61,C,6,5109,485619,39620,407151,38775,6,149,0,16,1721,1702,16,1702,0,0
VT,975,30910,0,14,5109,379,759,180,197,859,B,55,5109,485619,39620,407151,975,55,149,1,732,31885,31885,733,31885,0,0
WA,23047,309438,0,317,3413,379,759,85,197,0,B,1106,3413,485619,39620,407151,22435,1106,149,294,5098,332485,332485,5392,332485,11,19
WI,19843,233588,235,658,2499,145,567,180,197,10880,A+,568,2499,485619,39620,407151,17707,568,149,766,12869,253666,253431,13635,253431,18,47
WV,1951,91426,0,33,5109,14,759,8,197,1241,B,74,5109,485619,39620,407151,38775,1900,149,45,3017,93377,93377,3062,93377,0,0
WY,891,22378,0,13,84,379,759,180,197,634,C,15,84,23060,767,21167,682,1900,149,17,92,23269,23269,109,23269,0,2
AK,425,47545,0,10,5109,379,759,180,197,366,B,10,5109,47970,39620,407151,425,10,149,13,1594,47970,47970,1607,47970,0,0
AL,16310,184171,0,527,1765,379,566,180,338,9355,B,590,1765,485619,39620,407151,16310,590,149,467,4220,200481,200481,4687,200481,9,46
AR,6538,112364,0,104,640,379,759,27,118,4583,A,120,640,485619,39620,407151,6538,1900,149,261,3045,118902,118902,3306,118902,0,13
AS,0,174,0,961,5109,379,759,180,197,0,C,0,5109,485619,39620,407151,0,1900,149,0,0,174,174,0,174,0,0
AZ,17763,185151,0,945,3223,374,759,222,197,4452,A+,857,3223,202914,39620,407151,38775,1900,149,501,6147,202914,202914,6648,202914,26,51
CA,101697,1688862,0,4529,5109,1325,759,180,197,0,B,3973,5109,1790559,39620,407151,101697,1900,149,2717,50948,1790559,1790559,53665,1790559,89,0
CO,24767,138356,0,464,4196,379,759,180,197,3783,A,1135,4196,485619,39620,407151,22440,1900,149,202,3501,163123,163123,3703,163123,21,36
CT,41559,193966,0,648,12538,379,759,180,197,7127,B,3826,12538,241393,39620,407151,38775,1900,149,271,6385,235525,235525,6656,235525,23,0
DC,8492,35022,0,343,5109,108,759,65,197,1082,A+,453,5109,485619,39620,407151,38775,1900,149,86,731,43514,43514,817,43514,8,0
DE,9171,47630,0,192,5109,379,759,180,197,5010,A,459,5109,485619,39620,407151,38775,402,57,75,1305,56801,56801,1380,56801,6,0
FL,53285,898331,1158,961,10056,379,759,180,197,0,A,2446,10056,1081512,71569,1007406,53285,2446,149,651,17394,952774,951616,18045,951616,46,157
GA,45070,399576,0,903,7767,379,1761,180,197,0,A,1962,7767,445186,39620,407151,45070,1900,149,649,3241,444646,444646,3890,444646,55,101
GU,172,5790,0,961,5109,379,759,180,197,143,C,5,5109,5894,39620,407151,164,1900,149,2,275,5962,5962,277,5962,0,0
HI,644,51195,0,961,83,379,759,180,197,600,D,17,83,51839,39620,407151,38775,1900,149,1,636,51839,51839,637,51839,0,0
IA,18573,124360,0,383,5109,112,759,67,197,10359,A+,504,5109,485619,39620,407151,18573,1900,149,213,3194,142933,142933,3407,142933,13,0
ID,2731,41144,0,30,234,379,95,180,197,2185,A,82,234,43629,39620,407151,2485,62,20,32,826,43875,43875,858,43875,1,3
IL,115833,714133,0,3649,5109,1009,759,576,197,0,A,5186,5109,829966,39620,407151,115833,5186,149,1527,24466,829966,829966,25993,829966,103,0
IN,33068,209219,0,1131,5285,411,1166,178,197,0,A+,2068,5285,485619,39620,407151,38775,1907,161,631,6323,242287,242287,6954,242287,38,0
KS,9337,75151,0,961,822,379,275,180,122,534,A,205,822,485619,39620,407151,38775,1900,149,0,0,84488,84488,0,84488,0,0
KY,9077,173024,0,512,2142,82,899,180,197,3124,A,400,2142,485619,39620,407151,8924,399,1,0,0,182101,182101,0,182101,0,6
LA,38802,316225,0,761,5109,379,759,100,197,28700,B,2740,5109,485619,39620,407151,38775,2635,105,305,7075,355027,355027,7380,355027,18,0
MA,94895,467428,0,2112,9618,529,759,180,197,78108,A,6640,9618,485619,39620,407151,94895,6640,149,675,9504,562323,562323,10179,562323,93,126
MD,49709,225149,0,1334,8392,511,759,180,197,3468,B,2501,8392,485619,39620,407151,49709,2386,115,1286,11517,274858,274858,12803,274858,43,111
ME,2189,43480,0,58,264,22,759,14,197,1402,B,84,264,46123,2563,43480,1951,84,149,52,0,45669,45669,52,45669,3,4
MI,62797,522663,0,860,5109,405,759,251,197,33168,A+,5751,5109,597828,75165,522663,57904,5538,240,336,17054,585460,585460,17390,585460,24,0
MN,25559,232195,0,606,2880,242,924,180,197,16655,A,977,2880,257754,39620,407151,22947,967,10,571,9374,257754,257754,9945,257754,35,84
MO,12673,158394,0,648,5109,379,759,88,197,0,B,707,5109,183650,14498,168871,12470,1900,149,181,5365,171067,171067,5546,171067,11,0
MP,22,5401,0,961,5109,379,759,180,197,13,D,2,5109,5423,39620,407151,22,2,149,0,223,5423,5423,223,5423,0,0
MS,14372,142125,0,594,2147,148,759,78,197,9401,A,693,2147,156497,39620,407151,14372,1900,149,328,8037,156497,156497,8365,156497,23,41
MT,485,36308,0,1,66,379,759,180,197,445,C,17,66,485619,39620,407151,485,1900,149,4,1146,36793,36793,1150,36793,0,0
NC,25412,349780,0,708,5109,379,759,180,197,14954,A,827,5109,485619,39620,407151,25412,827,149,784,10252,375192,375192,11036,375192,33,0
ND,2481,65773,0,35,161,379,759,180,197,1793,C,48,161,86728,39620,407151,2481,45,3,42,872,68254,68254,914,68254,4,0
NE,12976,80004,0,961,5109,379,759,180,197,0,D,163,5109,485619,39620,407151,12976,1900,149,357,2202,92980,92980,2559,92980,10,0
NH,4286,61310,0,105,426,379,120,180,197,2691,B,223,426,485619,39620,407151,4286,1900,149,55,1309,65596,65596,1364,65596,9,5
NJ,157815,528042,0,2797,16778,740,759,564,197,25804,A+,11401,16778,485619,39620,407151,157815,11401,149,1187,24345,685857,685857,25532,685857,62,181
NM,7252,172291,0,210,1282,379,759,180,197,2638,C,329,1282,485619,39620,407151,7252,1900,149,122,-1225,179543,179543,-1103,179543,4,0
NV,8208,122982,0,439,5109,123,759,55,197,406,A+,425,5109,151938,39620,407151,8208,1900,149,95,2536,131190,131190,2631,131190,9,0
NY,366733,1510056,0,4010,89042,1219,759,931,197,64954,A,23722,89042,485619,39620,407151,366733,1900,149,1768,63477,1876789,1876789,65245,1876789,79,176
OH,33915,326097,0,812,5811,285,1516,190,197,0,B,2098,5811,485619,39620,407151,31625,1888,210,476,9811,360012,360012,10287,360012,54,111
OK,6270,176136,0,181,975,80,759,180,197,5236,A+,326,975,183632,7006,176136,38775,1900,149,41,3727,182406,182406,3768,182406,4,34
OR,4086,115561,0,149,768,32,759,17,197,1981,A+,151,768,485619,39620,407151,3994,1900,149,48,2607,119647,119647,2655,119647,3,9
PA,70042,357804,0,1476,5109,379,759,321,197,44826,A,5373,5109,485619,39620,407151,68104,1900,149,625,7814,427846,427846,8439,427846,108,0
PR,3486,60422,0,120,5109,12,759,5,197,0,B,131,5109,61702,1952,59701,1280,61,70,89,19934,63908,63908,20023,63908,2,0
RI,14630,94575,0,222,1639,53,759,36,197,1186,A+,677,1639,153333,19150,134183,14630,1900,149,132,1071,109205,109205,1203,109205,22,15
SC,10788,171461,0,397,1618,379,759,180,197,6102,A,470,1618,187788,16327,171461,10788,470,149,165,6401,182249,182249,6566,182249,4,0
SD,4793,34233,0,105,406,379,759,180,197,3698,B,54,406,485619,39620,407151,38775,1900,149,83,937,39026,39026,1020,39026,0,15
TN,21679,394310,0,545,1689,379,759,180,197,14632,B,356,1689,485619,39620,407151,21679,356,149,373,5986,415989,415989,6359,415989,3,42
TX,59776,813442,0,1692,5109,379,759,180,197,38905,B,1601,5109,873218,39620,407151,59776,1900,149,1855,15689,873218,873218,17544,873218,39,0
UT,8921,194586,0,169,734,379,231,180,98,5623,B,106,734,485619,39620,407151,8921,1900,149,215,2666,203507,203507,2881,203507,1,18
VA,41401,245880,476,1502,6974,416,759,195,197,5472,A+,1338,6974,285273,39620,407151,39393,1236,102,1152,9082,287757,287281,10234,287281,57,148
VI,69,1617,22,961,5109,379,759,180,197,61,C,6,5109,485619,39620,407151,38775,6,149,0,175,1708,1686,175,1686,0,0
VT,974,30178,0,17,5109,379,759,180,197,855,B,55,5109,485619,39620,407151,974,55,149,3,150,31152,31152,153,31152,1,0
WA,22753,304340,0,325,3394,379,759,94,197,0,B,1095,3394,485619,39620,407151,22107,1095,149,270,4962,327093,327093,5232,327093,17,56
WI,19077,220719,250,659,2452,138,556,180,197,10384,A+,550,2452,485619,39620,407151,16974,550,149,564,10114,240046,239796,10678,239796,11,41
WV,1906,88409,0,35,5109,13,759,6,197,1211,B,74,5109,485619,39620,407151,38775,1900,149,39,1815,90315,90315,1854,90315,0,0
WY,874,22286,0,15,82,379,759,180,197,624,C,15,82,22591,767,21167,665,1900,149,24,1634,23160,23160,1658,23160,2,0
AK,412,45951,0,14,5109,379,759,180,197,364,C,10,5109,46363,39620,407151,412,10,149,1,1398,46363,46363,1399,46363,0,0
AL,15843,179951,0,607,1719,379,560,180,334,7951,B,581,1719,485619,39620,407151,15843,581,149,447,1588,195794,195794,2035,195794,6,48
AR,6277,109319,0,108,627,379,759,22,116,4424,A,120,627,485619,39620,407151,6277,1900,149,97,3726,115596,115596,3823,115596,1,10
AS,0,174,0,961,5109,379,759,180,197,0,C,0,5109,485619,39620,407151,0,1900,149,0,50,174,174,50,174,0,0
AZ,17262,179004,0,911,3172,375,759,237,197,4361,A+,831,3172,196266,39620,407151,38775,1900,149,479,5056,196266,196266,5535,196266,24,50
CA,98980,1637914,0,4544,5109,1407,759,180,197,0,B,3884,5109,1736894,39620,407151,98980,1900,149,2247,38251,1736894,1736894,40498,1736894,70,0
CO,24565,134855,0,484,4160,379,759,180,197,3741,A,1114,4160,485619,39620,407151,22208,1900,149,296,3113,159420,159420,3409,159420,26,32
CT,41288,187581,0,684,12538,379,759,180,197,7127,B,3803,12538,235525,39620,407151,38775,1900,149,-15,3522,228869,228869,3507,228869,34,0
DC,8406,34291,0,349,5109,113,759,76,197,1082,A+,445,5109,485619,39620,407151,38775,1900,149,72,570,42697,42697,642,42697,5,0
DE,9096,46325,0,196,5109,379,759,180,197,4909,A,453,5109,485619,39620,407151,38775,397,56,30,477,55421,55421,507,55421,9,0
FL,52634,880937,955,961,9899,379,759,180,197,0,A,2400,9899,1081512,71569,1007406,52634,2400,149,379,9968,934526,933571,10347,933571,62,159
GA,44421,396335,0,907,7666,379,1735,180,197,0,A,1907,7666,440756,39620,407151,44421,1900,149,691,-74880,440756,440756,-74189,440756,36,119
GU,170,5515,0,1,5109,379,759,180,197,143,C,5,5109,5749,39620,407151,163,1900,149,1,0,5685,5685,1,5685,0,0
HI,643,50559,0,961,83,379,759,180,197,593,D,17,83,51202,39620,407151,38775,1900,149,0,831,51202,51202,831,51202,0,-1
IA,18360,121166,0,393,5109,109,759,66,197,10016,A+,491,5109,485619,39620,407151,18360,1900,149,657,3865,139526,139526,4522,139526,13,0
ID,2699,40318,0,24,231,379,95,180,197,2100,A,81,231,42776,39620,407151,2458,61,20,73,1538,43017,43017,1611,43017,2,6
IL,114306,689667,0,3826,5109,1031,759,592,197,0,A,5083,5109,803973,39620,407151,114306,5083,149,1111,16068,803973,803973,17179,803973,160,0
IN,32437,202896,0,1122,5285,400,1166,182,197,0,A+,2030,5285,485619,39620,407151,38775,1871,159,359,4225,235333,235333,4584,235333,26,0
KS,9337,75151,0,961,822,379,275,180,122,534,A,205,822,485619,39620,407151,38775,1900,149,119,2970,84488,84488,3089,84488,17,22
KY,9077,173024,0,489,2136,78,897,180,197,3124,A,400,2136,485619,39620,407151,8924,399,1,506,11739,182101,182101,12245,182101,9,5
LA,38497,309150,0,798,5109,379,759,100,197,28700,B,2722,5109,485619,39620,407151,38775,2617,105,443,6178,347647,347647,6621,347647,21,0
MA,94220,457924,0,2106,9492,556,759,180,197,0,A,6547,9492,485619,39620,407151,93693,6473,149,527,6136,552144,552144,6663,552144,74,104
MD,48423,213632,0,1338,8281,520,759,180,197,3401,B,2458,8281,485619,39620,407151,48423,2343,115,736,6832,262055,262055,7568,262055,41,102
ME,2137,43480,0,59,260,25,759,14,197,1357,B,81,260,46123,2563,43480,1914,81,149,28,8030,45617,45617,8058,45617,2,2
MI,62461,505609,0,882,5109,388,759,272,197,33168,A+,5727,5109,579682,74073,505609,57695,5511,240,386,17703,568070,568070,18089,568070,24,0
MN,24988,222821,0,598,2796,260,902,180,197,16314,A,942,2796,247809,39620,407151,22464,932,10,680,8847,247809,247809,9527,247809,34,87
MO,12492,153029,0,644,5109,379,759,84,197,0,B,696,5109,183650,14498,168871,12275,1900,149,201,5022,165521,165521,5223,165521,10,0
MP,22,5178,0,961,5109,379,759,180,197,13,D,2,5109,5200,39620,407151,22,2,149,0,260,5200,5200,260,5200,0,0
MS,14044,134088,0,547,2106,127,759,73,197,9401,A,670,2106,147819,39620,407151,14044,1900,149,313,0,148132,148132,313,148132,18,36
MT,481,35162,0,2,66,379,759,180,197,444,C,17,66,485619,39620,407151,481,1900,149,2,1807,35643,35643,1809,35643,0,1
NC,24628,339528,0,702,5109,379,759,180,197,14954,A,794,5109,485619,39620,407151,24628,794,149,488,11337,364156,364156,11825,364156,28,0
ND,2439,64901,0,40,161,379,759,180,197,1762,C,44,161,86527,39620,407151,2439,41,3,17,469,67340,67340,486,67340,4,5
NE,12619,77802,0,961,5109,379,759,180,197,0,D,153,5109,485619,39620,407151,12619,1900,149,264,2115,90421,90421,2379,90421,3,0
NH,4231,60001,1370,91,421,379,120,180,197,2550,B,214,421,485619,39620,407151,4231,1900,149,34,1159,65602,64232,1193,64232,4,1
NJ,156628,503697,0,2761,16597,768,759,583,197,25552,A+,11339,16597,485619,39620,407151,156628,11339,149,864,23569,660325,660325,24433,660325,148,224
NM,7130,173516,0,211,1282,379,759,180,197,2564,C,325,1282,485619,39620,407151,7130,1900,149,104,3181,180646,180646,3285,180646,5,18
NV,8113,120446,0,435,5109,108,759,48,197,401,A+,416,5109,148525,39620,407151,8113,1900,149,116,5076,128559,128559,5192,128559,4,0
NY,364965,1446579,0,4208,88866,1261,759,988,197,64632,A,23643,88866,485619,39620,407151,364965,1900,149,1129,36287,1811544,1811544,37416,1811544,79,180
OH,33439,316286,0,885,5700,313,1492,217,197,0,B,2044,5700,485619,39620,407151,31191,1842,202,433,9892,349725,349725,10325,349725,42,121
OK,6229,172409,0,156,941,74,759,180,197,5135,A+,322,941,179842,6948,172409,38775,1900,149,92,18605,178638,178638,18697,178638,4,0
OR,4038,112954,0,146,759,35,759,16,197,1795,A+,148,759,485619,39620,407151,3947,1900,149,71,1383,116992,116992,1454,116992,0,7
PA,69417,349990,0,1493,5109,379,759,351,197,43038,A,5265,5109,485619,39620,407151,67515,1900,149,780,10155,419407,419407,10935,419407,113,0
PR,3397,40488,0,105,5109,8,759,4,197,0,B,129,5109,41701,1572,40095,1260,61,68,73,0,43885,43885,73,43885,0,0
RI,14498,93504,0,218,1624,49,759,35,197,1175,A+,655,1624,149715,18813,130902,14498,1900,149,133,1104,108002,108002,1237,108002,21,11
SC,10623,165060,0,398,1618,379,759,180,197,6102,A,466,1618,181154,16094,165060,10623,466,149,207,2742,175683,175683,2949,175683,20,0
SD,4710,33296,0,101,391,379,759,180,197,3619,B,54,391,485619,39620,407151,38775,1900,149,57,911,38006,38006,968,38006,4,13
TN,21306,388324,0,501,1647,379,759,180,197,13916,B,353,1647,485619,39620,407151,21306,353,149,341,5785,409630,409630,6126,409630,10,38
TX,57921,797753,0,1645,5109,379,759,180,197,37626,B,1562,5109,855674,39620,407151,57921,1900,149,1361,33080,855674,855674,34441,855674,26,0
UT,8706,191920,0,127,716,379,223,180,94,5499,B,105,716,485619,39620,407151,8706,1900,149,86,1948,200626,200626,2034,200626,4,20
VA,40249,236798,444,1459,6826,390,759,203,197,5367,A+,1281,6826,275074,39620,407151,38276,1202,79,907,8959,277491,277047,9866,277047,45,196
VI,69,1442,28,961,5109,379,759,180,197,61,C,6,5109,485619,39620,407151,38775,6,149,0,17,1539,1511,17,1511,0,0
VT,971,30028,0,21,5109,379,759,180,197,849,B,54,5109,485619,39620,407151,971,54,149,4,572,30999,30999,576,30999,0,0
WA,22483,299378,0,241,3338,379,759,53,197,0,B,1078,3338,485619,39620,407151,21820,1078,149,299,5444,321861,321861,5743,321861,8,48
WI,18513,210605,335,748,2411,139,550,180,197,9846,A+,539,2411,485619,39620,407151,16462,539,149,646,9731,229453,229118,10377,229118,22,49
WV,1867,86594,0,36,5109,13,759,6,197,1191,B,74,5109,485619,39620,407151,38775,1900,149,13,637,88461,88461,650,88461,0,0
WY,850,20652,0,12,82,379,759,180,197,607,C,13,82,21300,758,20900,648,1900,149,0,0,21502,21502,0,21502,0,0
AK,411,44553,0,12,5109,379,759,180,197,362,C,10,5109,44964,39620,407151,411,10,149,2,490,44964,44964,492,44964,0,0
AL,15396,178363,0,569,1671,379,551,180,327,7951,B,575,1671,485619,39620,407151,15396,575,149,666,2778,193759,193759,3444,193759,13,42
AR,6180,105593,0,107,617,379,759,18,114,4332,A,119,617,485619,39620,407151,6180,1900,149,151,0,111773,111773,151,111773,2,12
AS,0,124,0,961,5109,379,759,180,197,0,C,0,5109,485619,39620,407151,0,1900,149,0,0,124,124,0,124,0,0
AZ,16783,173948,0,818,3122,336,759,208,197,4297,A+,807,3122,190731,39620,407151,38775,1900,149,222,2727,190731,190731,2949,190731,1,45
CA,96733,1599663,0,4404,5109,1392,759,180,197,0,B,3814,5109,1696396,39620,407151,96733,1900,149,2175,50119,1696396,1696396,52294,1696396,19,0
CO,24269,131742,0,507,4128,379,759,180,197,3702,A,1088,4128,485619,39620,407151,21941,1900,149,95,5608,156011,156011,5703,156011,0,9
CT,41303,184059,0,694,12538,379,759,180,197,7127,B,3769,12538,229769,39620,407151,38775,1900,149,430,3206,225362,225362,3636,225362,27,0
DC,8334,33721,0,353,5109,113,759,76,197,1080,A+,440,5109,485619,39620,407151,38775,1900,149,109,1143,42055,42055,1252,42055,0,0
DE,9066,45848,0,201,5109,379,759,180,197,4802,B,444,5109,485619,39620,407151,38775,389,55,101,917,54914,54914,1018,54914,8,0
FL,52255,870969,901,961,9740,379,759,180,197,0,A,2338,9740,1068679,71039,995118,52255,2338,149,509,14480,924125,923224,14989,923224,7,59
GA,43730,471215,0,854,7547,379,1703,180,197,0,A,1871,7547,514945,39620,407151,43344,1900,149,386,1014,514945,514945,1400,514945,41,72
GU,169,5515,0,961,5109,379,759,180,197,139,C,5,5109,485619,39620,407151,161,1900,149,3,112,5684,5684,115,5684,0,0
HI,643,49728,0,961,84,379,759,180,197,592,C,17,84,50371,39620,407151,38775,1900,149,0,0,50371,50371,0,50371,0,0
IA,17703,117301,0,379,5109,115,759,65,197,9791,A+,478,5109,485619,39620,407151,17703,1900,149,126,2163,135004,135004,2289,135004,19,0
ID,2626,38780,0,19,225,379,94,180,197,1755,A,79,225,41167,39620,407151,2387,59,20,0,0,41406,41406,0,41406,0,0
IL,113195,673599,0,3788,5109,1035,759,590,197,0,A,4923,5109,786794,39620,407151,113195,4923,149,1178,16052,786794,786794,17230,786794,39,0
IN,32078,198671,0,1088,5285,365,1166,163,197,0,A+,2004,5285,485619,39620,407151,38775,1850,154,363,4135,230749,230749,4498,230749,28,0
KS,9218,72181,0,961,800,379,271,180,120,493,A+,188,800,485619,39620,407151,38775,1900,149,0,0,81399,81399,0,81399,0,0
KY,8571,161285,0,484,2131,89,897,180,197,3102,A,391,2131,485619,39620,407151,8451,390,1,0,0,169856,169856,0,169856,0,0
LA,38054,302972,0,831,5109,379,759,103,197,28700,B,2701,5109,485619,39620,407151,38775,2596,105,245,9883,341026,341026,10128,341026,11,0
MA,93693,451788,0,2108,9388,560,759,180,197,0,A,6473,9388,485619,39620,407151,93693,6473,149,422,4498,545481,545481,4920,545481,57,49
MD,47687,206800,0,1315,8179,520,759,180,197,3334,B,2417,8179,485619,39620,407151,47687,2302,115,535,4375,254487,254487,4910,254487,38,87
ME,2109,35450,0,60,258,26,759,13,197,1318,B,79,258,37725,2201,35450,1894,79,149,35,0,37559,37559,35,37559,1,1
MI,62075,487906,0,953,5109,449,759,319,197,33168,A+,5703,5109,561095,73189,487906,57477,5487,240,443,11581,549981,549981,12024,549981,25,0
MN,24308,213974,0,570,2709,258,886,180,197,15523,A,908,2709,238282,39620,407151,21960,899,9,784,6158,238282,238282,6942,238282,18,33
MO,12291,148007,0,500,5109,379,759,82,197,0,B,686,5109,183650,14498,168871,12106,1900,149,124,2789,160298,160298,2913,160298,1,0
MP,22,4918,0,961,5109,379,759,180,197,13,D,2,5109,4940,39620,407151,22,2,149,0,183,4940,4940,183,4940,0,0
MS,13731,134088,0,561,2070,134,759,81,197,9401,A,652,2070,147819,39620,407151,13731,1900,149,273,3629,147819,147819,3902,147819,17,24
MT,479,33355,0,2,65,379,759,180,197,441,C,17,65,485619,39620,407151,479,1900,149,0,152,33834,33834,152,33834,1,0
NC,24140,328191,0,621,5109,379,759,180,197,14954,A,766,5109,485619,39620,407151,24140,766,149,176,7465,352331,352331,7641,352331,12,0
ND,2422,64432,0,40,156,379,759,180,197,1701,C,40,156,85479,39620,407151,2422,40,149,-35,539,66854,66854,504,66854,1,2
NE,12355,75687,0,961,5109,379,759,180,197,0,D,150,5109,485619,39620,407151,12355,1900,149,221,2089,88042,88042,2310,88042,0,0
NH,4197,58842,0,91,420,379,120,180,197,2434,B,210,420,485619,39620,407151,4197,1900,149,48,1605,63039,63039,1653,63039,1,1
NJ,155764,480128,0,2723,16373,786,759,578,197,25384,A+,11191,16373,485619,39620,407151,155764,11191,149,672,11423,635892,635892,12095,635892,47,16373
NM,7026,170335,0,216,1264,379,759,180,197,2522,C,320,1264,485619,39620,407151,7026,1900,149,83,3797,177361,177361,3880,177361,3,21
NV,7997,115370,0,390,5109,91,759,46,197,374,A+,412,5109,142833,39620,407151,7997,1900,149,118,8518,123367,123367,8636,123367,2,0
NY,363836,1410292,0,4265,88686,1273,759,1002,197,64443,A,23564,88686,485619,39620,407151,363836,1900,149,1072,33607,1774128,1774128,34679,1774128,76,132
OH,33006,306394,0,937,5579,351,1450,232,197,0,B,2002,5579,485619,39620,407151,30827,1803,199,529,8537,339400,339400,9066,339400,15,68
OK,6137,153804,0,174,941,78,759,180,197,4823,A+,318,941,160903,6696,153804,38775,1900,149,47,-1139,159941,159941,-1092,159941,5,3
OR,3967,111571,0,149,752,40,759,17,197,1795,A+,148,752,485619,39620,407151,3879,1900,149,18,1662,115538,115538,1680,115538,0,5
PA,68637,339835,0,1493,5109,379,759,334,197,41868,A,5152,5109,485619,39620,407151,66779,1900,149,451,4907,408472,408472,5358,408472,13,0
PR,3324,40488,0,104,5109,14,759,4,197,0,B,129,5109,41701,1572,40095,1241,61,68,64,0,43812,43812,64,43812,0,0
RI,14365,92400,0,226,1613,50,759,36,197,1158,A+,634,1613,147388,18541,128847,14365,1900,149,154,1726,106765,106765,1880,106765,26,33
SC,10416,162318,0,433,1618,379,759,180,197,6102,A+,446,1618,178119,15801,162318,10416,446,149,238,6476,172734,172734,6714,172734,6,84
SD,4653,32385,0,106,378,379,759,180,197,3528,C,50,378,485619,39620,407151,38775,1900,149,67,1688,37038,37038,1755,37038,0,8
TN,20965,382539,0,582,1609,379,759,180,197,13344,B,343,1609,485619,39620,407151,20965,343,149,358,6927,403504,403504,7285,403504,5,15
TX,56560,764673,0,1534,5109,379,759,180,197,36375,B,1536,5109,821233,39620,407151,56560,1900,149,589,14990,821233,821233,15579,821233,9,0
UT,8620,189972,0,134,696,379,217,180,89,5346,B,101,696,485619,39620,407151,8620,1900,149,99,2025,198592,198592,2124,198592,3,4
VA,39342,227839,412,1403,6630,366,759,190,197,5227,A+,1236,6630,265279,39620,407151,37440,1175,61,1615,6816,267593,267181,8431,267181,28,109
VI,69,1425,18,961,5109,379,759,180,197,61,C,6,5109,485619,39620,407151,38775,6,149,0,82,1512,1494,82,1494,0,0
VT,967,29456,0,25,5109,379,759,180,197,848,B,54,5109,485619,39620,407151,967,54,149,5,749,30423,30423,754,30423,0,0
WA,22184,293934,0,267,3290,379,759,51,197,0,B,1070,3290,485619,39620,407151,21479,1070,149,275,6620,316118,316118,6895,316118,9,3
WI,17867,200874,218,640,2362,135,544,180,197,9405,A+,517,2362,485619,39620,407151,15863,517,149,296,7495,218959,218741,7791,218741,3,23
WV,1854,85957,0,35,5109,9,759,7,197,1180,B,74,5109,485619,39620,407151,38775,1900,149,80,1406,87811,87811,1486,87811,2,0
WY,850,20652,0,14,82,379,759,180,197,607,C,13,82,21300,705,18895,648,1900,149,12,1101,21502,21502,1113,21502,1,3
AK,409,44063,0,10,5109,379,759,180,197,361,C,10,5109,44472,39620,407151,409,10,149,1,964,44472,44472,965,44472,0,0
AL,14730,175585,0,450,1629,379,543,180,323,7951,B,562,1629,485619,39620,407151,14730,562,149,403,4113,190315,190315,4516,190315,11,17
AR,6029,105593,0,92,605,379,759,17,111,4249,A,117,605,485619,39620,407151,6029,1900,149,107,2934,111622,111622,3041,111622,1,7
AS,0,124,0,961,5109,379,759,180,197,0,C,0,5109,485619,39620,407151,0,1900,149,0,0,124,124,0,124,0,0
AZ,16561,171221,0,833,3077,334,759,212,197,4204,A+,806,3077,187782,39620,407151,38775,1900,149,222,3919,187782,187782,4141,187782,6,51
CA,94558,1549544,0,4306,5109,1301,759,180,197,0,B,3795,5109,1644102,39620,407151,94558,1900,149,1848,59509,1644102,1644102,61357,1644102,21,0
CO,24174,126134,0,560,4119,379,759,180,197,3666,A,1088,4119,485619,39620,407151,21857,1900,149,210,47,150308,150308,257,150308,0,14
CT,40873,180853,0,706,12538,379,759,180,197,7127,B,3742,12538,225362,39620,407151,38775,1900,149,405,7185,221726,221726,7590,221726,49,0
DC,8225,32578,0,331,5109,106,759,70,197,1080,A+,440,5109,485619,39620,407151,38775,1900,149,259,-11447,40803,40803,-11188,40803,13,0
DE,8965,44931,0,205,5109,379,759,180,197,4693,B,436,5109,485619,39620,407151,38775,382,54,156,1870,53896,53896,2026,53896,5,0
FL,51746,856489,988,961,9681,379,759,180,197,0,A,2331,9681,1050247,70360,977392,51746,2331,149,879,36121,909223,908235,37000,908235,15,43
GA,43344,470201,0,892,7475,379,1686,180,197,0,A,1830,7475,513545,39620,407151,43344,1900,149,506,31085,513545,513545,31591,513545,6,36
GU,166,5403,0,961,5109,379,759,180,197,138,C,5,5109,485619,39620,407151,161,1900,149,0,0,5569,5569,0,5569,0,0
HI,643,49728,0,961,84,379,759,180,197,591,C,17,84,50371,39620,407151,38775,1900,149,0,799,50371,50371,799,50371,0,0
IA,17577,115138,0,377,5109,118,759,66,197,9377,A+,459,5109,485619,39620,407151,17252,1900,149,325,4634,132715,132715,4959,132715,5,0
ID,2626,38780,0,15,225,379,94,180,197,1755,A,79,225,41167,39620,407151,2387,59,20,0,0,41406,41406,0,41406,0,0
IL,112017,657547,0,3762,5109,1025,759,605,197,0,A,4884,5109,769564,39620,407151,112017,4884,149,1713,19930,769564,769564,21643,769564,28,0
IN,31715,194536,0,1102,5285,365,1166,169,197,0,A+,1976,5285,485619,39620,407151,38775,1832,152,339,5111,226251,226251,5450,226251,0,0
KS,9218,72181,0,961,800,379,271,180,120,493,A+,188,800,485619,39620,407151,38775,1900,149,260,4705,81399,81399,4965,81399,3,13
KY,8571,161285,0,484,2131,89,897,180,197,3102,A,391,2131,485619,39620,407151,8451,390,1,0,0,169856,169856,0,169856,0,0
LA,37809,293089,0,847,5109,379,759,102,197,28700,B,2690,5109,485619,39620,407151,38775,2585,105,640,14222,330898,330898,14862,330898,0,0
MA,93271,447290,0,2132,9339,576,759,180,197,0,A,6416,9339,485619,39620,407151,93271,6416,149,596,7592,540561,540561,8188,540561,44,31
MD,47152,202425,0,1279,8092,517,759,180,197,3329,B,2379,8092,485619,39620,407151,47152,2267,112,839,8376,249577,249577,9215,249577,38,153
ME,2074,35450,0,59,257,27,759,13,197,1290,B,78,257,37725,2201,35450,1858,78,149,19,0,37524,37524,19,37524,0,5
MI,61632,476325,0,953,5109,449,759,319,197,33168,A+,5678,5109,549107,72782,476325,57205,5463,238,175,9238,537957,537957,9413,537957,38,0
MN,23524,207816,0,605,2676,248,869,180,197,14816,A,890,2676,231340,39620,407151,21315,881,9,403,6250,231340,231340,6653,231340,12,88
MO,12167,145218,0,729,5109,379,759,93,197,0,B,685,5109,180120,14273,165572,11913,1900,149,179,5587,157385,157385,5766,157385,4,0
MP,22,4735,0,961,5109,379,759,180,197,13,D,2,5109,4757,39620,407151,22,2,149,0,0,4757,4757,0,4757,0,0
MS,13458,130459,0,566,2046,152,759,94,197,9401,A,635,2046,143917,39620,407151,13458,1900,149,206,5809,143917,143917,6015,143917,10,23
MT,479,33203,0,3,65,379,759,180,197,441,C,16,65,485619,39620,407151,479,1900,149,0,301,33682,33682,301,33682,0,0
NC,23964,320726,0,627,5109,379,759,180,197,14954,A,754,5109,485619,39620,407151,23964,754,149,742,7292,344690,344690,8034,344690,10,0
ND,2457,63893,0,41,154,379,759,180,197,1551,C,39,154,485619,39620,407151,2457,39,149,39,823,66350,66350,862,66350,0,2
NE,12134,73598,0,961,5109,379,759,180,197,0,D,150,5109,485619,39620,407151,12134,1900,149,145,2382,85732,85732,2527,85732,3,0
NH,4149,57237,1714,92,419,379,120,180,197,2204,B,209,419,485619,39620,407151,4149,1900,149,60,1787,63100,61386,1847,61386,1,0
NJ,155092,468705,0,2755,5109,719,759,540,197,25253,A+,11144,5109,485619,39620,407151,155092,11144,149,938,19052,623797,623797,19990,623797,11,0
NM,6943,166538,0,213,1243,379,759,180,197,2464,C,317,1243,485619,39620,407151,6943,1900,149,148,4214,173481,173481,4362,173481,9,104
NV,7879,106852,0,380,5109,91,759,45,197,359,A+,410,5109,133508,39620,407151,7879,1900,149,109,4341,114731,114731,4450,114731,2,0
NY,362764,1376685,0,4348,88554,1366,759,1058,197,64280,A,23488,88554,485619,39620,407151,362764,1900,149,1249,38374,1739449,1739449,39623,1739449,97,230
OH,32477,297857,0,872,5511,323,1443,211,197,0,B,1987,5511,485619,39620,407151,30305,1788,199,566,5215,330334,330334,5781,330334,18,35
OK,6090,154943,0,961,938,78,759,180,197,4714,A+,313,938,160903,6696,154207,38775,1900,149,53,0,161033,161033,53,161033,2,0
OR,3949,109909,0,125,747,35,759,23,197,1376,A+,148,747,485619,39620,407151,3861,1900,149,22,1641,113858,113858,1663,113858,0,5
PA,68186,334928,0,1628,5109,379,759,324,197,40911,A,5139,5109,485619,39620,407151,68186,1900,149,473,6546,403114,403114,7019,403114,15,0
PR,3260,40488,0,112,5109,16,759,8,197,0,B,129,5109,41701,1572,40095,1240,61,68,71,0,43748,43748,71,43748,2,0
RI,14211,90674,0,240,1580,49,759,32,197,1119,A+,608,1580,144570,18268,126302,14211,1900,149,70,750,104885,104885,820,104885,0,0
SC,10178,155842,0,407,1534,379,759,180,197,6063,A+,440,1534,171034,15192,155842,10178,440,149,82,1991,166020,166020,2073,166020,5,0
SD,4586,30697,0,99,370,379,759,180,197,3415,C,50,370,485619,39620,407151,38775,1900,149,23,355,35283,35283,378,35283,0,6
TN,20607,375612,0,517,1594,379,759,180,197,13073,B,338,1594,485619,39620,407151,20607,338,149,462,12181,396219,396219,12643,396219,2,11
TX,55971,749683,0,1511,5109,379,759,180,197,35292,B,1527,5109,805654,39620,407151,55971,1900,149,623,41486,805654,805654,42109,805654,21,0
UT,8521,187947,0,131,692,379,215,180,88,5218,B,98,692,485619,39620,407151,8521,1900,149,129,1906,196468,196468,2035,196468,1,4
VA,37727,221023,414,1376,6521,349,759,182,197,5145,A+,1208,6521,256913,39620,407151,35890,1158,50,1483,13182,259164,258750,14665,258750,37,68
VI,69,1343,45,961,5109,379,759,180,197,61,C,6,5109,485619,39620,407151,38775,6,149,0,0,1457,1412,0,1412,0,0
VT,962,28707,0,19,5109,379,759,180,197,843,B,54,5109,485619,39620,407151,962,54,149,6,1073,29669,29669,1079,29669,0,0
WA,21909,287314,0,207,3287,379,759,47,197,0,B,1061,3287,485619,39620,407151,21101,1061,149,257,2226,309223,309223,2483,309223,6,31
WI,17571,193379,207,606,2339,126,543,180,197,9207,A+,514,2339,485619,39620,407151,15584,514,149,318,7173,211157,210950,7491,210950,4,24
WV,1774,84551,0,36,5109,13,759,7,197,1135,B,72,5109,485619,39620,407151,38775,1900,149,15,616,86325,86325,631,86325,0,0
WY,838,19551,0,10,79,379,759,180,197,575,C,12,79,20189,705,18895,638,1900,149,25,330,20389,20389,355,20389,0,1
AK,408,43099,0,10,5109,379,759,180,197,358,C,10,5109,43507,39620,407151,408,10,149,0,1156,43507,43507,1156,43507,0,0
AL,14327,171472,0,440,1612,379,537,180,320,7951,B,551,1612,485619,39620,407151,14327,551,149,389,2734,185799,185799,3123,185799,5,23
AR,5922,102659,0,86,598,379,759,17,111,4148,A,116,598,485619,39620,407151,5922,1900,149,310,5224,108581,108581,5534,108581,3,8
AS,0,124,0,961,5109,379,759,180,197,0,C,0,5109,485619,39620,407151,0,1900,149,0,0,124,124,0,124,0,0
AZ,16339,167302,0,804,3026,322,759,201,197,4132,A+,800,3026,183641,39620,407151,38775,1900,149,300,2902,183641,183641,3202,183641,1,42
CA,92710,1490035,0,4300,5109,1315,759,180,197,0,B,3774,5109,1582745,39620,407151,92710,1900,149,2079,65360,1582745,1582745,67439,1582745,66,0
CO,23964,126087,0,538,4105,379,759,180,197,3640,A,1088,4105,485619,39620,407151,21657,1900,149,477,4622,150051,150051,5099,150051,0,23
CT,40468,173668,0,701,12538,379,759,180,197,7127,B,3693,12538,221726,39620,407151,38775,1900,149,446,5323,214136,214136,5769,214136,18,0
DC,7966,44025,0,324,5109,110,759,73,197,1075,A+,427,5109,485619,39620,407151,38775,1900,149,0,0,51991,51991,0,51991,0,0
DE,8809,43061,0,211,5109,379,759,180,197,4598,B,431,5109,485619,39620,407151,38775,377,54,119,1217,51870,51870,1336,51870,6,0
FL,50867,820368,1337,961,9638,379,759,180,197,0,A,2316,9638,1008670,69459,936730,50867,2316,149,740,14058,872572,871235,14798,871235,4,71
GA,42838,439116,0,848,7439,379,1683,180,197,0,A,1824,7439,481954,39620,407151,42838,1900,149,706,27711,481954,481954,28417,481954,13,28
GU,166,5403,0,961,5109,379,759,180,197,138,C,5,5109,5704,161,5403,161,1900,149,1,209,5569,5569,210,5569,0,0
HI,643,48929,0,961,84,379,759,180,197,589,C,17,84,49572,39620,407151,38775,1900,149,1,750,49572,49572,751,49572,0,0
IA,17252,110504,0,363,5109,114,759,61,197,9318,A+,454,5109,485619,39620,407151,17252,1900,149,359,3456,127756,127756,3815,127756,10,0
ID,2626,38780,0,23,225,379,94,180,197,1755,A,79,225,41167,39620,407151,2387,59,20,31,766,41406,41406,797,41406,0,0
IL,110304,637617,0,3667,5109,1007,759,632,197,0,A,4856,5109,485619,39620,407151,110304,4856,149,2508,23166,747921,747921,25674,747921,66,0
IN,31376,189425,0,1112,5285,396,1166,173,197,0,A+,1976,5285,485619,39620,407151,38775,1824,152,475,5393,220801,220801,5868,220801,33,0
KS,8958,67476,0,961,787,379,269,180,120,485,A+,185,787,485619,39620,407151,38775,1900,149,0,0,76434,76434,0,76434,0,0
KY,8571,161285,0,484,2131,89,897,180,197,3102,A,391,2131,485619,39620,407151,8451,390,1,145,-1748,169856,169856,-1603,169856,0,55
LA,37169,278867,0,813,5109,379,759,102,197,26249,B,2690,5109,485619,39620,407151,38775,2567,123,129,1460,316036,316036,1589,316036,22,0
MA,92675,439698,0,2169,9308,558,759,180,197,0,A,6372,9308,485619,39620,407151,92675,6372,149,1013,10374,532373,532373,11387,532373,68,48
MD,46313,194049,0,1290,7939,503,759,180,197,3319,B,2341,7939,485619,39620,407151,46313,2229,112,818,7217,240362,240362,8035,240362,35,114
ME,2055,35450,0,59,252,27,759,13,197,1263,B,78,252,37725,2201,35450,1845,78,149,42,0,37505,37505,42,37505,1,9
MI,61457,467087,0,953,5109,449,759,319,197,33168,A+,5640,5109,539550,72463,467087,56892,5440,238,164,11531,528544,528544,11695,528544,28,0
MN,23121,201566,0,553,2588,207,841,180,197,14115,A,878,2588,224687,39620,407151,20573,869,9,356,6625,224687,224687,6981,224687,17,54
MO,11988,139631,0,742,5109,379,759,94,197,0,B,681,5109,169732,14137,155323,11988,1900,149,236,3079,151619,151619,3315,151619,5,0
MP,22,4735,0,961,5109,379,759,180,197,13,D,2,5109,4757,39620,407151,22,2,149,0,439,4757,4757,439,4757,0,0
MS,13252,124650,0,512,2023,150,759,73,197,7681,A,625,2023,137902,39620,407151,13252,1900,149,247,3435,137902,137902,3682,137902,9,27
MT,479,32902,0,3,65,379,759,180,197,441,C,16,65,485619,39620,407151,479,1900,149,0,729,33381,33381,729,33381,0,0
NC,23222,313434,0,587,5109,379,759,180,197,11637,A,744,5109,485619,39620,407151,23222,744,149,497,6577,336656,336656,7074,336656,7,0
ND,2418,63070,0,40,152,379,759,180,197,1496,C,39,152,485619,39620,407151,2418,39,149,53,1287,65488,65488,1340,65488,0,2
NE,11989,71216,0,961,5109,379,759,180,197,0,D,147,5109,485619,39620,407151,11989,1900,149,327,2896,83205,83205,3223,83205,0,0
NH,4089,55450,1844,93,419,379,120,180,197,2197,B,208,419,485619,39620,407151,4089,1900,149,0,0,61383,59539,0,59539,0,0
NJ,154154,449653,0,2857,5109,760,759,639,197,25040,A+,11133,5109,485619,39620,407151,154154,11133,149,1050,24022,603807,603807,25072,603807,52,0
NM,6795,162324,0,208,1139,379,759,180,197,2357,C,308,1139,485619,39620,407151,6795,1900,149,170,10566,169119,169119,10736,169119,6,0
NV,7770,102511,0,373,5109,92,759,51,197,359,A+,408,5109,128803,39620,407151,7770,1900,149,74,3160,110281,110281,3234,110281,4,0
NY,361515,1338311,0,4393,88324,1406,759,1067,197,64080,A,23391,88324,485619,39620,407151,361515,1900,149,1589,46176,1699826,1699826,47765,1699826,109,241
OH,31911,292642,0,864,5476,317,1438,205,197,0,B,1969,5476,485619,39620,407151,29777,1769,200,503,7556,324553,324553,8059,324553,13,39
OK,6037,154943,0,174,938,78,759,180,197,4688,A+,311,938,160903,6696,154207,38775,1900,149,77,0,160980,160980,77,160980,0,12
OR,3927,108268,0,117,742,35,759,18,197,1376,A+,148,742,485619,39620,407151,3842,1900,149,39,1949,112195,112195,1988,112195,1,2
PA,67713,328382,0,1533,5109,379,759,336,197,40627,A,5124,5109,485619,39620,407151,65906,1900,149,730,6913,396095,396095,7643,396095,28,0
PR,3189,40488,0,106,5109,13,759,7,197,0,B,127,5109,41701,1572,40095,1230,61,66,89,0,43677,43677,89,43677,0,0
RI,14141,89924,0,240,1580,49,759,32,197,1119,A+,608,1580,143070,18134,124936,14141,1900,149,84,757,104065,104065,841,104065,11,23
SC,10096,153851,0,461,1534,379,759,180,197,5743,A+,435,1534,168908,15057,153851,10096,435,149,201,4836,163947,163947,5037,163947,10,0
SD,4563,30342,0,85,364,379,759,180,197,3371,C,50,364,485619,39620,407151,38775,1900,149,95,1282,34905,34905,1377,34905,0,6
TN,20145,363431,0,526,1583,379,759,180,197,12837,B,336,1583,485619,39620,407151,20145,336,149,356,9462,383576,383576,9818,383576,7,10
TX,55348,708197,0,1572,5109,379,759,180,197,33385,B,1506,5109,762706,39620,407151,55348,1900,149,839,0,763545,763545,839,763545,0,0
UT,8392,186041,0,128,688,379,215,180,88,5081,B,97,688,485619,39620,407151,8392,1900,149,132,3522,194433,194433,3654,194433,0,12
VA,36244,207841,411,1351,6453,354,759,192,197,5102,A+,1171,6453,242292,39620,407151,34451,1135,36,495,11120,244496,244085,11615,244085,12,22
VI,69,1343,45,961,5109,379,759,180,197,61,C,6,5109,485619,39620,407151,38775,6,149,0,0,1457,1412,0,1412,0,0
VT,956,27634,0,25,5109,379,759,180,197,839,B,54,5109,485619,39620,407151,956,54,149,2,1164,28590,28590,1166,28590,0,0
WA,21652,285088,0,313,3256,379,759,74,197,0,B,1055,3256,485619,39620,407151,20956,1055,149,160,2182,306740,306740,2342,306740,5,26
WI,17253,186206,223,611,2315,128,541,180,197,8999,A+,510,2315,485619,39620,407151,15277,510,149,410,6877,203682,203459,7287,203459,3,23
WV,1759,83935,0,23,5109,8,759,4,197,1121,B,72,5109,485619,39620,407151,38775,1900,149,42,1908,85694,85694,1950,85694,0,0
WY,813,19221,0,10,78,379,759,180,197,556,C,12,78,19836,705,18895,615,1900,149,0,0,20034,20034,0,20034,0,1
AK,408,41943,0,10,5109,379,759,180,197,358,C,10,5109,42351,39620,407151,408,10,149,4,901,42351,42351,905,42351,0,0
AL,13938,168738,0,446,1589,379,538,180,319,7951,B,546,1589,485619,39620,407151,13938,546,149,375,4533,182676,182676,4908,182676,9,28
AR,5612,97435,0,81,590,379,759,14,111,4029,A,113,590,485619,39620,407151,5612,1900,149,0,0,103047,103047,0,103047,0,6
AS,0,124,0,961,5109,379,759,180,197,0,C,0,5109,485619,39620,407151,0,1900,149,0,0,124,124,0,124,0,0
AZ,16039,164400,0,784,2984,309,759,193,197,4033,A+,799,2984,180439,12089,407151,38775,1900,149,431,4005,180439,180439,4436,180439,24,41
CA,90631,1424675,0,4342,5109,1312,759,180,197,0,B,3708,5109,1515306,39620,407151,90631,1900,149,2187,46346,1515306,1515306,48533,1515306,78,0
CO,23487,121465,0,571,4082,379,759,180,197,3612,A,1088,4082,485619,39620,407151,21202,1900,149,296,2431,144952,144952,2727,144952,26,45
CT,40022,168345,0,724,12538,379,759,180,197,7127,B,3675,12538,214136,39620,407151,38775,1900,149,382,5657,208367,208367,6039,208367,38,0
DC,7966,44025,0,324,5109,110,759,73,197,1075,A+,427,5109,485619,39620,407151,38775,1900,149,73,8925,51991,51991,8998,51991,9,0
DE,8690,41844,0,210,5109,379,759,180,197,4454,B,425,5109,485619,39620,407151,38775,371,54,161,1387,50534,50534,1548,50534,5,0
FL,50127,806310,1563,961,9567,379,759,180,197,0,A,2312,9567,990300,68322,919519,50127,2312,149,676,20265,858000,856437,20941,856437,44,195
GA,42132,411405,0,848,7411,379,1678,180,197,0,A,1811,7411,453537,39620,407151,42132,1900,149,914,25374,453537,453537,26288,453537,26,98
GU,165,5194,0,961,5109,379,759,180,197,134,C,5,5109,5487,39620,5190,160,1900,149,0,80,5359,5359,80,5359,0,0
HI,642,48179,0,961,84,379,759,180,197,585,C,17,84,48821,39620,407151,38775,1900,149,-5,841,48821,48821,836,48821,0,1
IA,16893,107048,0,362,5109,111,759,70,197,9254,A+,444,5109,485619,39620,407151,16893,1900,149,389,3302,123941,123941,3691,123941,19,0
ID,2595,38014,0,19,225,379,94,180,197,1735,A,79,225,40370,39620,407151,2356,59,20,61,953,40609,40609,1014,40609,2,2
IL,107796,614451,0,3753,5109,1027,759,607,197,0,A,4790,5109,485619,39620,407151,107796,4790,149,2352,22762,722247,722247,25114,722247,75,0
IN,30901,184032,0,1138,5285,403,1166,173,197,0,A+,1943,5285,485619,39620,407151,38775,1812,152,492,5880,214933,214933,6372,214933,2,0
KS,8958,67476,0,961,787,379,269,180,120,485,A+,185,787,485619,39620,407151,38775,1900,149,0,0,76434,76434,0,76434,0,0
KY,8426,163033,0,477,2076,90,889,180,197,3069,A,391,2076,485619,39620,407151,8305,390,1,140,5079,171459,171459,5219,171459,5,35
LA,37040,277407,0,836,5109,379,759,112,197,26249,B,2668,5109,485619,39620,407151,38775,2560,123,115,2524,314447,314447,2639,314447,0,0
MA,91662,429324,0,2237,9260,610,759,180,197,0,A,6304,9260,485619,39620,407151,91662,6304,149,773,8569,520986,520986,9342,520986,76,98
MD,45495,186832,0,1320,7825,524,759,180,197,3283,B,2306,7825,485619,39620,407151,45495,2197,109,1071,3354,232327,232327,4425,232327,32,191
ME,2013,35450,0,50,243,26,759,11,197,1232,B,77,243,37725,2201,35450,1804,77,149,65,0,37463,37463,65,37463,2,3
MI,61293,455556,0,953,5109,449,759,319,197,33168,A+,5612,5109,527621,72065,455556,56741,5402,237,218,14274,516849,516849,14492,516849,26,0
MN,22765,194941,0,568,2534,215,832,180,197,13485,A,861,2534,217706,39620,407151,19845,852,9,391,8505,217706,217706,8896,217706,10,102
MO,11752,136552,0,742,5109,379,759,94,197,0,B,676,5109,169050,14135,154644,11751,1900,149,194,-24836,148304,148304,-24642,148304,5,0
MP,22,4296,0,961,5109,379,759,180,197,13,D,2,5109,4318,39620,407151,22,2,149,0,0,4318,4318,0,4318,0,0
MS,13005,121215,0,590,1996,154,759,93,197,7681,A,616,1996,134220,39620,407151,13005,1900,149,381,-4134,134220,134220,-3753,134220,20,30
MT,479,32173,0,3,65,379,759,180,197,441,C,16,65,485619,39620,407151,479,1900,149,0,795,32652,32652,795,32652,0,0
NC,22725,306857,0,589,5109,379,759,180,197,11637,A,737,5109,485619,39620,407151,22725,737,149,1107,25251,329582,329582,26358,329582,9,0
ND,2365,61783,0,39,150,379,759,180,197,1451,C,39,150,485619,39620,407151,2365,39,149,48,1270,64148,64148,1318,64148,0,3
NE,11662,68320,0,961,5109,379,759,180,197,0,D,147,5109,485619,39620,407151,11662,1900,149,237,1326,79982,79982,1563,79982,4,0
NH,4089,55450,1844,93,419,379,120,180,197,2197,B,208,419,485619,39620,407151,4089,1900,149,154,4285,61383,59539,4439,59539,9,26
NJ,153104,425631,0,2974,5109,806,759,611,197,24762,A+,11081,5109,485619,39620,407151,153104,11081,149,385,23036,578735,578735,23421,578735,96,0
NM,6625,151758,0,206,1139,379,759,180,197,2149,C,302,1139,485619,39620,407151,6625,1900,149,153,5463,158383,158383,5616,158383,8,0
NV,7696,99351,0,402,5109,99,759,53,197,359,A+,404,5109,125394,39620,407151,7696,1900,149,295,6811,107047,107047,7106,107047,4,0
NY,359926,1292135,0,4642,88083,1502,759,1254,197,63292,A,23282,88083,485619,39620,407151,359926,1900,149,1772,49496,1652061,1652061,51268,1652061,87,240
OH,31408,285086,0,858,5437,333,1429,223,197,0,B,1956,5437,485619,39620,407151,29288,1756,200,614,8080,316494,316494,8694,316494,84,58
OK,5960,154943,0,174,926,78,759,180,197,4645,A+,311,926,160903,6696,154207,38775,1900,149,111,7625,160903,160903,7736,160903,4,0
OR,3888,106319,0,102,740,41,759,15,197,1376,A+,147,740,485619,39620,407151,3779,1900,149,24,2344,110207,110207,2368,110207,0,3
PA,66983,321469,0,1560,5109,379,759,348,197,39519,A,5096,5109,485619,39620,407151,65209,1900,149,725,8726,388452,388452,9451,388452,112,0
PR,3100,40488,0,106,5109,14,759,5,197,0,B,127,5109,41701,1572,40095,1870,61,66,70,0,43588,43588,70,43588,1,0
RI,14057,89167,0,233,1557,51,759,34,197,1106,A+,597,1557,141567,17983,123584,14057,1900,149,108,1317,103224,103224,1425,103224,18,20
SC,9895,149015,0,430,1534,379,759,180,197,5743,A+,425,1534,163818,14803,149015,9895,425,149,257,8630,158910,158910,8887,158910,6,0
SD,4468,29060,0,90,358,379,759,180,197,3336,C,50,358,485619,39620,407151,38775,1900,149,112,1072,33528,33528,1184,33528,0,7
TN,19789,353969,0,478,1573,379,759,180,197,12745,B,329,1573,485619,39620,407151,19789,329,149,395,5193,373758,373758,5588,373758,14,13
TX,54509,708197,0,1688,5109,379,759,180,197,32277,B,1506,5109,762706,39620,407151,54509,1900,149,1060,20284,762706,762706,21344,762706,26,0
UT,8260,182519,0,165,676,379,213,180,88,4898,B,97,676,485619,39620,407151,8260,1900,149,203,3742,190779,190779,3945,190779,4,16
VA,35749,196721,409,1384,6431,330,759,213,197,5047,A+,1159,6431,230683,39620,407151,33962,1123,36,799,6496,232879,232470,7295,232470,23,9
VI,69,1343,45,961,5109,379,759,180,197,61,C,6,5109,485619,39620,407151,38775,6,149,0,0,1457,1412,0,1412,0,0
VT,954,26470,0,21,5109,379,759,180,197,837,B,54,5109,485619,39620,407151,954,54,149,2,1689,27424,27424,1691,27424,0,0
WA,21492,282906,0,332,3230,379,759,96,197,0,B,1050,3230,485619,39620,407151,20858,1050,149,209,2462,304398,304398,2671,304398,6,74
WI,16843,179329,223,611,2292,128,542,180,197,8688,A+,507,2292,485619,39620,407151,14877,507,149,503,6626,196395,196172,7129,196172,11,33
WV,1717,82027,0,39,5109,11,759,9,197,1110,B,72,5109,485619,39620,407151,38775,1900,149,101,-1186,83744,83744,-1085,83744,1,0
WY,813,19221,0,10,77,379,759,180,197,551,C,12,77,19836,705,18895,615,1900,149,10,600,20034,20034,610,20034,0,1
AK,404,41042,0,15,5109,379,759,180,197,356,C,10,5109,41446,39620,407151,404,10,149,2,1899,41446,41446,1901,41446,0,0
AL,13563,164205,0,598,1561,379,531,180,315,7951,B,537,1561,485619,39620,407151,13563,537,149,444,6585,177768,177768,7029,177768,8,33
AR,5612,97435,0,86,584,379,759,14,110,4029,A,113,584,485619,39620,407151,5612,1900,149,154,3617,103047,103047,3771,103047,3,49
AS,0,124,0,961,5109,379,759,180,197,0,C,0,5109,485619,39620,407151,0,1900,149,0,0,124,124,0,124,0,0
AZ,15608,160395,0,796,2943,311,759,203,197,3949,A+,775,2943,176003,39620,407151,38775,1900,149,293,4083,176003,176003,4376,176003,12,58
CA,88444,1378329,0,4762,5109,1317,759,180,197,0,B,3630,5109,1466773,39620,407151,88444,1900,149,2247,43399,1466773,1466773,45646,1466773,88,0
CO,23191,119034,0,620,4037,379,759,180,197,3580,A,1062,4037,485619,39620,407151,20903,1900,149,394,6220,142225,142225,6614,142225,61,47
CT,39640,162688,0,740,12538,379,759,180,197,7127,B,3637,12538,208367,39620,407151,38775,1900,149,432,5449,202328,202328,5881,202328,55,1592
DC,7893,35100,0,342,5109,112,759,74,197,1069,A+,418,5109,485619,39620,407151,38775,1900,149,105,1132,42993,42993,1237,42993,6,0
DE,8529,40457,0,221,5109,379,759,180,197,4296,B,420,5109,485619,39620,407151,38775,367,53,143,1301,48986,48986,1444,48986,3,0
FL,49451,786045,1487,961,9372,379,759,180,197,0,A,2268,9372,940758,66424,871876,49451,2268,149,776,20791,836983,835496,21567,835496,46,172
GA,41218,386031,0,889,7313,379,1658,180,197,0,A,1785,7313,427249,39620,407151,41218,1900,149,813,18705,427249,427249,19518,427249,31,78
GU,165,5114,0,961,5109,379,759,180,197,125,C,5,5109,5331,39620,5037,160,1900,149,0,215,5279,5279,215,5279,0,0
HI,647,47338,0,961,83,379,759,180,197,579,C,17,83,485619,39620,407151,38775,1900,149,4,832,47985,47985,836,47985,0,1
IA,16504,103746,0,362,5109,123,759,79,197,9079,A+,425,5109,485619,39620,407151,16504,1900,149,334,3351,120250,120250,3685,120250,19,0
ID,2534,37061,0,19,223,379,92,180,197,1720,A,77,223,39362,39620,407151,2301,1900,149,28,679,39595,39595,707,39595,0,2
IL,105444,591689,0,3928,5109,1060,759,589,197,0,A,4715,5109,485619,39620,407151,105444,4715,149,2758,22355,697133,697133,25113,697133,108,0
IN,30409,178152,0,1203,5285,416,1166,173,197,0,A+,1941,5285,485619,39620,407151,38775,1791,150,473,5093,208561,208561,5566,208561,28,896
KS,8958,67476,0,961,787,379,269,180,120,485,A+,185,787,485619,39620,407151,38775,1900,149,419,4812,76434,76434,5231,76434,7,27
KY,8286,157954,0,475,2041,92,886,180,197,3008,A,386,2041,485619,39620,407151,8175,385,1,119,7449,166240,166240,7568,166240,10,25
LA,36925,274883,0,867,5109,379,759,104,197,26249,B,2668,5109,485619,39620,407151,38775,2545,123,421,6006,311808,311808,6427,311808,39,0
MA,90889,420755,0,2323,9162,628,759,180,197,0,A,6228,9162,485619,39620,407151,90889,6228,149,805,9353,511644,511644,10158,511644,80,122
MD,44424,183478,0,1329,7634,506,759,180,197,3243,B,2274,7634,485619,39620,407151,44424,2169,105,893,6776,227902,227902,7669,227902,53,149
ME,1948,35450,0,45,240,21,759,12,197,1192,B,75,240,37725,2201,35450,1749,75,149,71,0,37398,37398,71,37398,2,5
MI,61075,441282,0,955,5109,470,759,348,197,28234,A+,5586,5109,512752,71470,441282,56612,5375,237,465,19494,502357,502357,19959,502357,31,0
MN,22374,186436,0,534,2432,233,806,180,197,12696,A,851,2432,208810,39620,407151,19005,842,9,792,8930,208810,208810,9722,208810,33,52
MO,11558,161388,0,711,5109,379,759,93,197,0,B,671,5109,167199,14046,152883,11558,1900,149,218,10636,172946,172946,10854,172946,10,0
MP,22,4296,0,961,5109,379,759,180,197,13,D,2,5109,4318,39620,407151,22,2,149,0,229,4318,4318,229,4318,0,0
MS,12624,125349,0,557,1966,159,759,85,197,7681,A,596,1966,137973,39620,407151,12624,1900,149,402,11601,137973,137973,12003,137973,16,34
MT,479,31378,0,3,65,379,759,180,197,441,C,16,65,485619,39620,407151,479,1900,149,0,1333,31857,31857,1333,31857,0,0
NC,21618,281606,0,568,5109,379,759,180,197,11637,A,728,5109,485619,39620,407151,21618,728,149,758,11821,303224,303224,12579,303224,12,0
ND,2317,60513,0,39,147,379,759,180,197,1405,C,39,147,485619,39620,407151,2317,39,149,88,1463,62830,62830,1551,62830,1,3
NE,11425,66994,0,961,5109,379,759,180,197,0,D,143,5109,485619,39620,407151,11425,1900,149,303,2476,78419,78419,2779,78419,5,0
NH,3935,51165,1526,97,393,379,120,180,197,1767,B,199,393,485619,39620,407151,3935,1900,149,67,2203,56626,55100,2270,55100,9,8
NJ,152719,402595,0,3049,5109,846,759,674,197,24491,A+,10985,5109,485619,39620,407151,152719,10985,149,1247,9793,555314,555314,11040,555314,142,0
NM,6472,146295,0,205,1139,379,759,180,197,2041,C,294,1139,485619,39620,407151,6472,1900,149,155,5268,152767,152767,5423,152767,11,0
NV,7401,92540,0,404,5109,90,759,51,197,339,A+,400,5109,117606,39620,407151,7401,1900,149,146,5413,99941,99941,5559,99941,3,0
NY,358154,1242639,0,4844,87843,1581,759,1254,197,63292,A,23195,87843,485619,39620,407151,358154,1900,149,1696,44042,1600793,1600793,45738,1600793,112,205
OH,30794,277006,0,879,5379,362,1416,232,197,0,B,1872,5379,485619,39620,407151,28758,1691,181,627,8095,307800,307800,8722,307800,36,84
OK,5849,147318,0,190,926,94,759,180,197,4533,A+,307,926,152998,6589,146409,38775,1900,149,169,3403,153167,153167,3572,153167,3,9
OR,3864,103975,0,146,737,47,759,16,197,1376,A+,147,737,485619,39620,407151,3770,1900,149,47,2568,107839,107839,2615,107839,2,5
PA,66258,312743,0,1580,5109,379,759,368,197,37767,A,4984,5109,485619,39620,407151,38775,1900,149,866,9229,379001,379001,10095,379001,115,0
PR,3030,40488,0,96,5109,12,759,6,197,0,B,126,5109,41701,1572,40095,1221,60,66,117,0,43518,43518,117,43518,0,0
RI,13949,87850,0,242,1537,56,759,40,197,1084,A+,579,1537,138609,17749,120860,13949,1900,149,201,1451,101799,101799,1652,101799,23,31
SC,9638,140385,0,429,1534,379,759,180,197,5743,A+,419,1534,154746,14361,140385,9638,419,149,463,11322,150023,150023,11785,150023,12,90
SD,4356,27988,0,83,351,379,759,180,197,3267,C,50,351,485619,39620,407151,38775,1900,149,106,937,32344,32344,1043,32344,2,9
TN,19394,348776,0,570,1560,379,759,180,197,12566,B,315,1560,485619,39620,407151,19394,315,149,433,7154,368170,368170,7587,368170,2,21
TX,53449,687913,0,1578,5109,379,759,180,197,31223,B,1480,5109,740181,39620,407151,53449,1900,149,1181,0,741362,741362,1181,741362,40,0
UT,8057,178777,0,163,660,379,210,180,88,4748,B,93,660,485619,39620,407151,8057,1900,149,183,3777,186834,186834,3960,186834,1,13
VA,34950,190225,464,1459,6422,366,759,207,197,4963,A+,1136,6422,223433,39620,407151,33208,1100,36,813,5763,225639,225175,6576,225175,37,153
VI,69,1343,45,961,5109,379,759,180,197,61,C,6,5109,485619,39620,407151,38775,6,149,0,29,1457,1412,29,1412,0,0
VT,952,24781,0,16,5109,379,759,180,197,834,B,54,5109,485619,39620,407151,952,54,149,2,30,25733,25733,32,25733,0,0
WA,21283,280444,0,332,3156,379,759,85,197,0,B,1044,3156,485619,39620,407151,20711,1044,149,295,4273,301727,301727,4568,301727,7,31
WI,16340,172703,187,583,2259,133,535,180,197,8362,A+,496,2259,485619,39620,407151,14396,496,149,548,9465,189230,189043,10013,189043,9,41
WV,1616,83213,0,47,5109,13,759,9,197,983,B,71,5109,485619,39620,407151,38775,1900,149,23,1665,84829,84829,1688,84829,1,0
WY,803,18621,0,10,76,379,759,180,197,551,C,12,76,19424,699,18724,608,1900,149,16,568,19424,19424,584,19424,1,1
AK,402,39143,0,19,5109,379,759,180,197,356,C,10,5109,39545,39620,407151,402,10,149,0,2500,39545,39545,2500,39545,0,0
AL,13119,157620,0,574,1528,379,526,180,311,0,B,529,1528,485619,39620,407151,13119,529,149,375,5914,170739,170739,6289,170739,12,35
AR,5458,93818,0,78,535,379,759,14,101,3915,A,110,535,485619,39620,407151,5458,1900,149,455,2563,99276,99276,3018,99276,3,0
AS,0,124,0,961,5109,379,759,180,197,0,D,0,5109,485619,39620,407151,0,1900,149,0,0,124,124,0,124,0,0
AZ,15315,156312,0,812,2885,299,759,197,197,3872,A+,763,2885,171627,39620,407151,38775,1900,149,418,5774,171627,171627,6192,171627,16,49
CA,86197,1334930,0,4735,5109,1310,759,180,197,0,B,3542,5109,1421127,39620,407151,86197,1900,149,2140,38867,1421127,1421127,41007,1421127,106,0
CO,22797,112814,0,613,3990,379,759,180,197,3532,A,1001,3990,485619,39620,407151,20595,1900,149,315,3459,135611,135611,3774,135611,33,35
CT,39208,157239,0,816,10946,379,759,180,197,6264,B,3582,10946,202328,39620,407151,38775,1900,149,191,5538,196447,196447,5729,196447,53,0
DC,7788,33968,0,336,5109,379,759,74,197,1061,A,412,5109,485619,39620,407151,38775,1900,149,237,1100,41756,41756,1337,41756,5,0
DE,8386,39156,0,220,5109,379,759,180,197,4130,B,417,5109,485619,39620,407151,38775,364,53,192,1938,47542,47542,2130,47542,3,0
FL,48675,765254,1471,961,9200,379,759,180,197,0,A,2222,9200,940758,66424,871876,48675,2222,149,1204,41377,815400,813929,42581,813929,49,266
GA,40405,367326,0,919,7235,379,1642,180,197,0,A,1754,7235,407731,39620,407151,40405,1900,149,758,4033,407731,407731,4791,407731,67,128
GU,165,4899,0,961,5109,379,759,180,197,125,C,5,5109,5167,160,4875,160,1900,149,0,92,5064,5064,92,5064,0,0
HI,643,46506,0,961,82,379,759,180,197,578,C,17,82,485619,39620,407151,38775,1900,149,2,843,47149,47149,845,47149,0,0
IA,16170,100395,0,376,5109,125,759,80,197,8672,A+,406,5109,485619,39620,407151,16170,1900,149,556,5261,116565,116565,5817,116565,18,0
ID,2506,36382,0,27,221,379,91,180,197,1688,B,77,221,38660,39620,407151,2278,1900,149,30,291,38888,38888,321,38888,0,6
IL,102686,569334,0,4107,5109,1088,759,609,197,0,A,4607,5109,485619,39620,407151,102686,4607,149,2268,27039,672020,672020,29307,672020,82,0
IN,29936,173059,0,1166,4389,409,990,175,197,0,A+,1913,4389,485619,39620,407151,38775,1764,149,662,6595,202995,202995,7257,202995,49,0
KS,8539,62664,0,961,760,379,258,180,116,473,A+,178,760,485619,39620,407151,38775,1900,149,0,0,71203,71203,0,71203,0,0
KY,8167,150505,0,474,2016,98,879,180,197,2919,A,376,2016,485619,39620,407151,8059,375,1,98,4588,158672,158672,4686,158672,10,6
LA,36504,268877,0,884,5109,379,759,107,197,26249,B,2629,5109,485619,39620,407151,38775,2506,123,1188,18223,305381,305381,19411,305381,21,0
MA,90084,411402,0,2396,9040,647,759,180,197,0,A,6148,9040,485619,39620,407151,90084,6148,149,1114,10419,501486,501486,11533,501486,82,143
MD,43531,176702,0,1374,7485,526,759,180,197,3099,B,2221,7485,485619,39620,407151,43531,2116,105,1208,3695,220233,220233,4903,220233,23,92
ME,1877,35450,0,41,235,21,759,12,197,1145,B,73,235,37725,2201,35450,1678,73,149,58,0,37327,37327,58,37327,0,4
MI,60610,421788,0,1054,5109,472,759,361,197,28234,A+,5555,5109,492412,70624,421788,56445,5349,237,459,15940,482398,482398,16399,482398,41,0
MN,21582,177506,0,566,2380,229,787,180,197,12488,A,818,2380,199088,39620,407151,18200,809,9,973,7307,199088,199088,8280,199088,32,72
MO,11340,150752,0,697,5109,379,759,99,197,0,B,661,5109,163684,13853,149562,11340,1900,149,108,0,162092,162092,108,162092,30,0
MP,22,4067,0,961,5109,379,759,180,197,13,D,2,5109,4089,39620,407151,22,2,149,1,271,4089,4089,272,4089,0,0
MS,12222,113748,0,638,1932,158,759,92,197,7681,A,580,1932,125970,39620,407151,12222,1900,149,255,5035,125970,125970,5290,125970,10,31
MT,479,30045,0,3,65,379,759,180,197,440,C,16,65,485619,39620,407151,479,1900,149,1,797,30524,30524,798,30524,0,0
NC,20860,269785,0,578,5109,379,759,180,197,11637,A,716,5109,485619,39620,407151,20860,716,149,738,12304,290645,290645,13042,290645,14,0
ND,2229,59050,0,39,144,379,759,180,197,1340,C,38,144,485619,39620,407151,2229,38,149,134,1945,61279,61279,2079,61279,1,2
NE,11122,64518,0,961,5109,379,759,180,197,0,D,138,5109,485619,39620,407151,11122,1900,149,276,3229,75640,75640,3505,75640,6,0
NH,3868,48962,1434,103,385,379,109,180,197,1388,B,190,385,485619,39620,407151,3868,1900,149,147,1795,54264,52830,1942,52830,8,2
NJ,151472,392802,0,3208,5109,896,759,700,197,24236,A+,10843,5109,485619,39620,407151,151472,10843,149,1073,11858,544274,544274,12931,544274,96,0
NM,6317,141027,0,206,1139,379,759,180,197,1985,C,283,1139,485619,39620,407151,6317,1900,149,125,4973,147344,147344,5098,147344,7,0
NV,7255,87127,0,410,5109,92,759,52,197,339,A+,397,5109,111323,39620,407151,7255,1900,149,89,3122,94382,94382,3211,94382,4,0
NY,356458,1198597,0,5187,87638,1695,759,1345,197,62826,A,23083,87638,485619,39620,407151,356458,1900,149,2088,47131,1555055,1555055,49219,1555055,107,179
OH,30167,268911,0,892,5295,349,1397,258,197,0,B,1836,5295,485619,39620,407151,28174,1653,183,731,8819,299078,299078,9550,299078,55,97
OK,5680,143915,0,201,917,78,759,180,197,4361,A+,304,917,149447,6464,142983,38775,1900,149,148,5076,149595,149595,5224,149595,5,12
OR,3817,101407,0,140,732,40,759,14,197,1406,A+,145,732,485619,39620,407151,3725,1900,149,16,3059,105224,105224,3075,105224,1,9
PA,65392,303514,0,1654,5109,379,759,361,197,0,B,4869,5109,485619,39620,407151,38775,1900,149,1726,17480,368906,368906,19206,368906,245,0
PR,2913,40488,0,114,5109,13,759,7,197,0,C,126,5109,41701,1572,40095,1213,60,66,47,40488,43401,43401,40535,43401,1,0
RI,13748,86399,0,254,1506,56,759,41,197,1047,A+,556,1506,135291,17405,117886,13748,1900,149,169,1939,100147,100147,2108,100147,18,20
SC,9175,129063,0,414,1444,379,759,180,197,5451,A+,407,1444,485619,39620,407151,9175,407,149,119,3056,138238,138238,3175,138238,8,0
SD,4250,27051,0,91,342,379,759,180,197,3145,C,48,342,485619,39620,407151,38775,1900,149,73,839,31301,31301,912,31301,2,9
TN,18961,341622,0,601,1539,379,759,180,197,12191,B,313,1539,485619,39620,407151,18961,313,149,429,6141,360583,360583,6570,360583,4,24
TX,52268,687913,0,1680,5109,379,759,180,197,30341,B,1440,5109,740181,39620,407151,52268,1900,149,945,18308,740181,740181,19253,740181,21,0
UT,7874,175000,0,169,647,379,207,180,88,4596,B,92,647,485619,39620,407151,7874,1900,149,164,3046,182874,182874,3210,182874,2,16
VA,34137,184462,490,1491,6269,351,759,191,197,4778,A+,1099,6269,216890,39620,407151,32428,1064,35,1229,4744,219089,218599,5973,218599,25,210
VI,69,1314,26,961,5109,379,759,180,197,61,C,6,5109,485619,39620,407151,38775,6,149,0,0,1409,1383,0,1383,0,0
VT,950,24751,0,14,5109,379,759,180,197,827,B,54,5109,485619,39620,407151,950,54,149,6,637,25701,25701,643,25701,0,0
WA,20988,276171,0,242,3125,379,759,70,197,0,B,1037,3125,485619,39620,407151,20403,1037,149,204,4468,297159,297159,4672,297159,6,3125
WI,15792,163238,220,524,2218,126,526,180,197,8012,A+,487,2218,485619,39620,407151,13885,487,149,523,8938,179250,179030,9461,179030,6,57
WV,1593,81548,0,46,5109,12,759,9,197,983,B,70,5109,485619,39620,407151,1593,1900,149,48,2452,83141,83141,2500,83141,1,0
WY,787,18053,0,8,75,379,759,180,197,534,C,11,75,18649,672,17495,596,1900,149,0,0,18840,18840,0,18840,0,1
AK,402,36643,0,16,5109,379,759,180,197,352,C,10,5109,37045,39620,407151,402,10,149,3,662,37045,37045,665,37045,0,0
AL,12744,151706,0,560,1493,379,524,180,309,0,B,517,1493,485619,39620,407151,12744,517,149,368,6516,164450,164450,6884,164450,13,40
AR,5003,91255,0,78,535,379,759,14,101,3852,A,107,535,485619,39620,407151,5003,1900,149,80,2477,96258,96258,2557,96258,5,0
AS,0,124,0,961,5109,379,759,180,197,0,D,0,5109,485619,39620,407151,0,1900,149,0,0,124,124,0,124,0,0
AZ,14897,150538,0,810,2836,298,759,208,197,3773,A+,747,2836,165435,39620,407151,38775,1900,149,331,3533,165435,165435,3864,165435,43,36
CA,84057,1296063,0,4681,5109,1345,759,180,197,0,B,3436,5109,1380120,39620,407151,84057,1900,149,2262,38542,1380120,1380120,40804,1380120,102,0
CO,22482,109355,0,626,3955,379,759,180,197,3478,A,968,3955,485619,39620,407151,20304,1900,149,280,224,131837,131837,504,131837,47,56
CT,39017,151701,0,887,10946,379,759,180,197,6264,B,3529,10946,196447,39620,407151,38775,1900,149,587,4611,190718,190718,5198,190718,57,0
DC,7551,32868,0,336,5109,379,759,74,197,1059,A,407,5109,485619,39620,407151,38775,1900,149,117,928,40419,40419,1045,40419,7,0
DE,8194,37218,0,220,5109,379,759,180,197,3965,B,414,5109,485619,39620,407151,38775,362,52,157,1123,45412,45412,1280,45412,6,0
FL,47471,723877,1357,961,8934,379,759,180,197,0,A+,2173,8934,887380,64172,821168,47471,2173,149,527,54966,772705,771348,55493,771348,44,190
GA,39647,363293,0,959,7107,379,1617,180,197,0,A,1687,7107,402940,39620,407151,39647,1900,149,926,23858,402940,402940,24784,402940,23,80
GU,165,4807,0,961,5109,379,759,180,197,125,C,5,5109,5035,149,4754,160,1900,149,11,134,4972,4972,145,4972,0,0
HI,641,45663,0,961,82,379,759,180,197,578,C,17,82,485619,39620,407151,38775,1900,149,1,1280,46304,46304,1281,46304,0,0
IA,15614,95134,0,381,5109,126,759,84,197,8362,A+,388,5109,485619,39620,407151,15614,1900,149,265,2835,110748,110748,3100,110748,16,0
ID,2476,36091,0,28,215,379,89,180,197,1668,B,77,215,38344,39620,407151,2253,1900,149,21,477,38567,38567,498,38567,3,2
IL,100418,542295,0,3914,5109,1005,759,554,197,0,A,4525,5109,485619,39620,407151,100418,4525,149,2388,18641,642713,642713,21029,642713,146,0
IN,29274,166464,0,1288,4389,431,990,197,197,0,A+,1864,4389,485619,39620,407151,38775,1716,148,569,5839,195738,195738,6408,195738,40,0
KS,8539,62664,0,961,760,379,258,180,116,473,A+,178,760,485619,39620,407151,38775,1900,149,199,4014,71203,71203,4213,71203,5,20
KY,8069,145917,0,443,2010,269,875,180,197,2826,A,366,2010,485619,39620,407151,7979,365,1,0,0,153986,153986,0,153986,0,30
LA,35316,250654,0,931,5109,379,759,110,197,26249,B,2608,5109,485619,39620,407151,38775,2485,123,278,7619,285970,285970,7897,285970,27,0
MA,88970,400983,0,2518,8897,675,759,180,197,0,A,6066,8897,485619,39620,407151,88970,6066,149,1045,11968,489953,489953,13013,489953,128,131
MD,42323,173007,0,1410,7393,539,759,180,197,2993,B,2198,7393,485619,39620,407151,42323,2093,105,777,5895,215330,215330,6672,215330,34,194
ME,1819,35450,0,43,231,24,759,12,197,1100,B,73,231,37725,2201,35450,1632,73,149,78,13358,37269,37269,13436,37269,0,6
MI,60151,405848,0,1066,5109,492,759,332,197,28234,A+,5514,5109,475714,69866,405848,56132,5318,236,575,13640,465999,465999,14215,465999,44,0
MN,20609,170199,0,550,2308,212,773,180,197,12227,A,786,2308,190808,39620,407151,17670,777,9,767,6190,190808,190808,6957,190808,29,87
MO,11232,150752,0,546,5109,379,759,103,197,0,B,631,5109,159636,13629,145742,11232,1900,149,152,7722,161984,161984,7874,161984,15,0
MP,21,3796,0,961,5109,379,759,180,197,13,D,2,5109,3817,39620,407151,21,2,149,0,0,3817,3817,0,3817,0,0
MS,11967,108713,0,644,1901,157,759,89,197,7681,A,570,1901,120680,39620,407151,11967,1900,149,263,2657,120680,120680,2920,120680,16,61
MT,478,29248,0,3,65,379,759,180,197,440,C,16,65,485619,39620,407151,478,1900,149,7,769,29726,29726,776,29726,0,0
NC,20122,257481,0,554,5109,379,759,180,197,11637,A,702,5109,485619,39620,407151,20122,702,149,422,12173,277603,277603,12595,277603,11,0
ND,2095,57105,0,38,142,379,759,180,197,1302,C,37,142,485619,39620,407151,2095,37,149,101,1368,59200,59200,1469,59200,0,7
NE,10846,61289,0,961,5109,379,759,180,197,0,D,132,5109,485619,39620,407151,10846,1900,149,221,1930,72135,72135,2151,72135,7,0
NH,3721,47167,861,105,383,379,109,180,197,1275,B,182,383,485619,39620,407151,3721,1900,149,69,1345,51749,50888,1414,50888,10,15
NJ,150399,380944,0,3405,5109,969,759,750,197,23945,A+,10747,5109,485619,39620,407151,150399,10747,149,1386,9775,531343,531343,11161,531343,161,0
NM,6192,136054,0,204,1139,379,759,180,197,1882,C,276,1139,485619,39620,407151,6192,1900,149,96,4530,142246,142246,4626,142246,6,253
NV,7166,84005,0,437,5109,107,759,60,197,336,A,393,5109,107666,39620,407151,7046,1900,149,120,3496,91171,91171,3616,91171,3,0
NY,354370,1151466,0,5570,87459,1761,759,1421,197,61886,A,22976,87459,485619,39620,407151,354370,1900,149,1525,36572,1505836,1505836,38097,1505836,133,290
OH,29436,260092,0,902,5198,333,1369,248,197,0,B,1781,5198,485619,39620,407151,27517,1603,178,484,11442,289528,289528,11926,289528,61,81
OK,5532,138839,0,209,905,92,759,180,197,4266,A+,299,905,145218,6379,138839,38775,1900,149,43,5181,144371,144371,5224,144371,5,8
OR,3801,98348,0,152,723,42,759,17,197,1406,A+,144,723,485619,39620,407151,3701,1900,149,75,2354,102149,102149,2429,102149,4,9
PA,63666,286034,0,1818,5109,379,759,377,197,0,B,4624,5109,485619,39620,407151,38775,1900,149,0,0,349700,349700,0,349700,0,0
PR,2866,,0,110,5109,20,759,5,197,0,C,125,5109,485619,39620,407151,1206,66,149,61,0,2866,2866,61,2866,1,0
RI,13579,84460,0,257,1486,58,759,45,197,1030,A+,538,1486,131182,17041,114141,13579,1900,149,187,1525,98039,98039,1712,98039,6,22
SC,9056,126007,0,961,1444,379,759,180,197,5451,A+,399,1444,485619,39620,407151,9056,399,149,0,0,135063,135063,0,135063,0,0
SD,4177,26212,0,81,333,379,759,180,197,3023,C,46,333,485619,39620,407151,38775,1900,149,92,588,30389,30389,680,30389,0,6
TN,18532,335481,0,652,1515,379,759,180,197,11783,B,309,1515,485619,39620,407151,18532,309,149,154,7736,354013,354013,7890,354013,4,17
TX,51323,669605,0,1791,5109,379,759,180,197,30341,B,1419,5109,720928,39620,407151,51323,1900,149,1411,19371,720928,720928,20782,720928,50,0
UT,7710,171954,0,144,631,379,200,180,87,4423,B,90,631,485619,39620,407151,7710,1900,149,192,2161,179664,179664,2353,179664,2,12
VA,32908,179718,518,1536,6059,370,759,202,197,4523,A+,1074,6059,210965,39620,407151,31247,1040,34,763,9074,213144,212626,9837,212626,33,291
VI,69,1314,26,961,5109,379,759,180,197,61,C,6,5109,485619,39620,407151,38775,6,149,0,16,1409,1383,16,1383,0,0
VT,944,24114,0,15,5109,379,759,180,197,824,B,54,5109,485619,39620,407151,944,54,149,0,0,25058,25058,0,25058,0,0
WA,20784,271703,0,168,5109,52,759,180,197,0,B,1031,5109,485619,39620,407151,20112,1031,149,249,5389,292487,292487,5638,292487,29,0
WI,15269,154300,211,609,2161,129,515,180,197,7728,A+,481,2161,485619,39620,407151,13413,481,149,577,6063,169780,169569,6640,169569,14,51
WV,1545,79096,0,58,5109,16,759,9,197,950,B,69,5109,485619,39620,407151,1545,1900,149,36,2304,80641,80641,2340,80641,1,0
WY,787,18053,0,9,74,379,759,180,197,528,C,11,74,18649,672,17495,596,1900,149,21,969,18840,18840,990,18840,1,1
AK,399,35981,0,16,5109,379,759,180,197,348,B,10,5109,36380,39620,407151,399,10,149,0,769,36380,36380,769,36380,0,0
AL,12376,145190,0,489,1453,379,517,180,306,0,B,504,1453,485619,39620,407151,12376,504,149,290,153,157566,157566,443,157566,15,37
AR,4923,88778,0,78,535,379,759,14,101,3739,A,102,535,485619,39620,407151,4923,1900,149,110,8352,93701,93701,8462,93701,2,5
AS,0,124,0,961,5109,379,759,180,197,0,C,0,5109,485619,39620,407151,0,1900,149,0,19,124,124,19,124,0,0
AZ,14566,147005,0,792,2800,318,759,201,197,3693,A+,704,2800,161571,39620,407151,38775,1900,149,396,4702,161571,161571,5098,161571,18,43
CA,81795,1257521,0,4363,5109,1307,759,180,197,0,B,3334,5109,1339316,39620,407151,81795,1900,149,1365,45279,1339316,1339316,46644,1339316,32,0
CO,22202,109131,0,626,3899,379,759,180,197,3431,A,921,3899,485619,39620,407151,20028,1900,149,264,2574,131333,131333,2838,131333,43,27
CT,38430,147090,0,914,10946,379,759,180,197,6264,B,3472,10946,190718,39620,407151,38775,1900,149,314,7527,185520,185520,7841,185520,23,0
DC,7434,31940,0,375,5109,379,759,77,197,1040,A,400,5109,485619,39620,407151,38775,1900,149,164,1385,39374,39374,1549,39374,8,0
DE,8037,36095,0,236,5109,379,759,180,197,3760,B,408,5109,485619,39620,407151,38775,357,51,168,1506,44132,44132,1674,44132,9,0
FL,46944,668911,1369,961,8744,379,759,180,197,0,A+,2129,8744,819927,63148,754767,46442,2129,149,502,38941,717224,715855,39443,715855,56,191
GA,38721,339435,0,986,7027,379,1589,180,197,0,A+,1664,7027,378156,39620,407151,38721,1900,149,640,13227,378156,378156,13867,378156,22,111
GU,154,4673,0,961,5109,379,759,180,197,126,C,5,5109,4920,149,4645,149,1900,149,0,104,4827,4827,104,4827,0,0
HI,640,44383,0,961,82,379,759,180,197,574,B,17,82,485619,39620,407151,38775,1900,149,0,2978,45023,45023,2978,45023,0,0
IA,15349,92299,0,383,5109,126,759,83,197,8130,A+,372,5109,485619,39620,407151,15349,1900,149,394,4106,107648,107648,4500,107648,17,0
ID,2455,35614,0,28,213,379,89,180,197,1649,B,74,213,37847,39620,407151,2233,1900,149,36,1361,38069,38069,1397,38069,1,0
IL,98030,523654,0,4002,5109,993,759,576,197,0,A,4379,5109,485619,39620,407151,98030,4379,149,1545,16898,621684,621684,18443,621684,145,0
IN,28705,160625,0,1268,4389,421,990,206,197,0,A+,1824,4389,485619,39620,407151,38775,1678,146,450,4968,189330,189330,5418,189330,59,0
KS,8340,58650,0,961,740,379,250,180,115,465,A,173,740,485619,39620,407151,38775,1900,149,0,0,66990,66990,0,66990,0,0
KY,8069,145917,0,447,1980,277,866,180,197,2826,A+,366,1980,485619,39620,407151,7883,345,1,381,23920,153986,153986,24301,153986,32,84
LA,35038,243035,0,1004,5109,379,759,112,197,26249,B,2581,5109,485619,39620,407151,38775,2458,123,329,7996,278073,278073,8325,278073,18,0
MA,87925,389015,0,2472,8766,672,759,180,197,0,A+,5938,8766,485619,39620,407151,87925,5938,149,873,6868,476940,476940,7741,476940,76,145
MD,41546,167112,0,1421,7199,537,759,180,197,2868,B,2164,7199,485619,39620,407151,41546,2061,103,1784,5368,208658,208658,7152,208658,42,113
ME,1741,22092,0,44,225,19,759,11,197,1088,B,73,225,33035,39620,407151,1561,73,149,28,0,23833,23833,28,23833,2,2
MI,59576,392208,0,1079,5109,486,759,351,197,28234,A+,5470,5109,461365,69157,392208,55838,5278,233,764,16093,451784,451784,16857,451784,43,0
MN,19842,164009,0,545,2221,229,750,180,197,11540,A+,757,2221,183851,39620,407151,17029,748,9,855,5522,183851,183851,6377,183851,17,93
MO,11080,143030,0,721,5109,379,759,103,197,0,B,616,5109,154773,13393,141119,11080,1900,149,135,2637,154110,154110,2772,154110,11,0
MP,21,3796,0,961,5109,379,759,180,197,13,D,2,5109,3817,39620,407151,21,2,149,0,397,3817,3817,397,3817,0,0
MS,11704,106056,0,611,1840,153,759,87,197,7681,A,554,1840,117760,39620,407151,11704,1900,149,272,1721,117760,117760,1993,117760,26,35
MT,471,28479,0,5,65,379,759,180,197,437,B,16,65,485619,39620,407151,471,1900,149,1,782,28950,28950,783,28950,0,1
NC,19700,245308,0,585,5109,379,759,180,197,11637,A,691,5109,485619,39620,407151,19700,691,149,677,8576,265008,265008,9253,265008,30,0
ND,1994,55737,0,32,135,379,759,180,197,1269,C,37,135,485619,39620,407151,1994,37,149,63,1107,57731,57731,1170,57731,0,2
NE,10625,59359,0,961,5109,379,759,180,197,0,C,125,5109,485619,39620,407151,10625,1900,149,277,2206,69984,69984,2483,69984,2,0
NH,3652,45822,874,109,368,379,109,180,197,1269,B,172,368,485619,39620,407151,3652,1900,149,56,4540,50348,49474,4596,49474,0,9
NJ,149013,371169,0,3481,5109,977,759,789,197,23657,A+,10586,5109,485619,39620,407151,149013,10586,149,974,13639,520182,520182,14613,520182,151,0
NM,6096,131524,0,213,886,379,759,180,197,1796,C,270,886,485619,39620,407151,6096,1900,149,158,4209,137620,137620,4367,137620,5,0
NV,7046,80509,0,405,5109,106,759,54,197,334,B,390,5109,103703,39620,407151,7046,1900,149,140,5583,87555,87555,5723,87555,7,0
NY,352845,1114894,0,5818,87169,1836,759,1481,197,61886,A,22843,87169,485619,39620,407151,352845,1900,149,1474,26708,1467739,1467739,28182,1467739,114,268
OH,28952,248650,0,913,5117,365,1357,234,197,0,B,1720,5117,485619,39620,407151,27106,1556,164,498,5255,277602,277602,5753,277602,63,119
OK,5489,133658,0,167,897,77,759,180,197,4135,A+,294,897,140262,6221,133658,38775,1900,149,91,15496,139147,139147,15587,139147,6,12
OR,3726,95994,0,137,714,43,759,13,197,1406,A+,140,714,485619,39620,407151,3636,1900,149,39,2366,99720,99720,2405,99720,2,6
PA,63666,286034,0,1861,5109,379,759,380,197,0,B,4624,5109,485619,39620,407151,38775,1900,149,610,8481,349700,349700,9091,349700,119,0
PR,2805,,0,121,5109,20,759,8,197,0,C,124,5109,485619,39620,407151,1207,60,149,95,0,2805,2805,95,2805,0,0
RI,13392,82935,0,247,1464,59,759,44,197,1023,A+,532,1464,128104,16721,111383,13392,1900,149,215,1878,96327,96327,2093,96327,26,26
SC,9056,126007,0,961,1444,379,759,180,197,5451,A,399,1444,485619,39620,407151,9056,399,149,114,3390,135063,135063,3504,135063,8,23
SD,4085,25624,0,75,327,379,759,180,197,2914,B,46,327,485619,39620,407151,38775,1900,149,58,606,29709,29709,664,29709,2,11
TN,18378,327745,0,615,1498,379,759,180,197,10969,A,305,1498,485619,39620,407151,18378,305,149,367,8328,346123,346123,8695,346123,4,9
TX,49912,650234,0,1732,5109,379,759,180,197,29359,A,1369,5109,700146,39620,407151,49912,1900,149,1219,19082,700146,700146,20301,700146,22,0
UT,7518,169793,0,96,619,379,197,180,84,4275,B,88,619,485619,39620,407151,7384,1900,149,134,3155,177311,177311,3289,177311,8,24
VA,32145,170644,473,1497,5768,377,759,199,197,4271,A+,1041,5768,201183,39620,407151,30539,1007,34,1005,5558,203262,202789,6563,202789,27,159
VI,69,1298,17,961,5109,379,759,180,197,61,C,6,5109,485619,39620,407151,38775,6,149,0,20,1384,1367,20,1367,0,0
VT,944,24114,0,24,5109,379,759,180,197,820,B,54,5109,485619,39620,407151,944,54,149,0,567,25058,25058,567,25058,0,0
WA,20535,266314,0,168,5109,52,759,180,197,0,A,1002,5109,485619,39620,407151,19871,1002,149,249,6847,286849,286849,7096,286849,1,0
WI,14692,148237,211,609,2110,129,503,180,197,7371,A+,467,2110,485619,39620,407151,12885,467,149,250,3735,163140,162929,3985,162929,8,42
WV,1509,76792,0,54,5109,18,759,9,197,922,B,68,5109,485619,39620,407151,1509,1900,149,18,2248,78301,78301,2266,78301,1,0
WY,766,17084,0,8,73,379,759,180,197,504,B,10,73,17661,653,17007,577,1900,149,12,753,17850,17850,765,17850,2,0
AK,399,35212,0,9,5109,379,759,180,197,345,B,10,5109,35611,39620,407151,399,10,149,3,957,35611,35611,960,35611,0,0
AL,12086,145037,0,536,1416,379,512,180,302,0,B,489,1416,485619,39620,407151,12086,489,149,315,458,157123,157123,773,157123,1,24
AR,4813,80426,0,77,530,379,759,12,101,3645,A,100,530,485619,39620,407151,4813,1900,149,54,0,85239,85239,54,85239,2,10
AS,0,105,0,961,5109,379,759,180,197,0,C,0,5109,485619,39620,407151,0,1900,149,0,0,105,105,0,105,0,0
AZ,14170,142303,0,820,2757,329,759,200,197,3570,A+,686,2757,156473,39620,407151,38775,1900,149,233,4479,156473,156473,4712,156473,6,54
CA,80430,1212242,0,4391,5109,1325,759,180,197,0,B,3302,5109,1292672,39620,407151,80430,1900,149,1591,55838,1292672,1292672,57429,1292672,41,0
CO,21938,106557,0,650,3872,379,759,180,197,3346,A,878,3872,485619,39620,407151,19773,1900,149,305,2642,128495,128495,2947,128495,0,6
CT,38116,139563,0,920,10946,379,759,180,197,6264,B,3449,10946,185520,39620,407151,38775,1900,149,697,6375,177679,177679,7072,177679,41,0
DC,7270,30555,0,374,5109,379,759,70,197,1028,A,392,5109,485619,39620,407151,38775,1900,149,147,1152,37825,37825,1299,37825,9,0
DE,7869,34589,0,240,5109,379,759,180,197,3545,B,399,5109,485619,39620,407151,38775,351,48,199,1394,42458,42458,1593,42458,7,0
FL,46442,629970,1346,961,8553,379,759,180,197,0,A+,2073,8553,746124,60938,683219,46442,2073,149,854,23766,677758,676412,24620,676412,24,75
GA,38081,326208,0,1025,6916,379,1565,180,197,0,A+,1642,6916,364289,39620,407151,38081,1900,149,380,12734,364289,364289,13114,364289,36,126
GU,154,4569,0,961,5109,379,759,180,197,126,C,5,5109,485619,39620,407151,149,1900,149,0,119,4723,4723,119,4723,0,0
HI,640,41405,0,961,82,379,759,180,197,573,B,17,82,485619,39620,407151,38775,1900,149,1,370,42045,42045,371,42045,0,0
IA,14955,88193,0,382,5109,121,759,85,197,7324,A+,355,5109,485619,39620,407151,14955,1900,149,304,2603,103148,103148,2907,103148,4,0
ID,2419,34253,0,30,213,379,89,180,197,1612,B,73,213,36456,39620,407151,2203,1900,149,0,0,36672,36672,0,36672,0,0
IL,96485,506756,0,4120,5109,1096,759,636,197,0,A,4234,5109,485619,39620,407151,96485,4234,149,2294,19003,603241,603241,21297,603241,57,0
IN,28255,155657,0,1244,4389,426,990,212,197,0,A+,1765,4389,485619,39620,407151,38775,1621,144,477,6192,183912,183912,6669,183912,14,0
KS,8340,58650,0,961,740,379,250,180,115,465,A,173,740,485619,39620,407151,38775,1900,149,454,4944,66990,66990,5398,66990,1,16
KY,7688,121997,0,381,1896,218,797,180,197,2768,A+,334,1896,485619,39620,407151,7408,334,149,0,0,129685,129685,0,129685,0,0
LA,34709,235039,0,1031,5109,379,759,118,197,26249,B,2563,5109,485619,39620,407151,38775,2440,123,277,4301,269748,269748,4578,269748,72,0
MA,87052,382147,0,2533,8621,674,759,180,197,0,A+,5862,8621,485619,39620,407151,87052,5862,149,1042,7331,469199,469199,8373,469199,65,82
MD,39762,161744,0,1447,7086,555,759,180,197,2817,B,2122,7086,485619,39620,407151,39762,2020,102,958,5622,201506,201506,6580,201506,32,93
ME,1713,22092,0,42,223,16,759,10,197,1053,B,71,223,33035,39620,407151,1533,71,149,26,0,23805,23805,26,23805,1,7
MI,58812,376115,0,1075,5109,473,759,418,197,28234,A+,5427,5109,444305,68190,376115,55461,5237,233,534,12567,434927,434927,13101,434927,31,0
MN,18987,158487,0,488,2128,229,731,180,197,10764,A+,740,2128,177474,39620,407151,16372,731,9,971,5418,177474,177474,6389,177474,9,38
MO,10945,140393,0,570,5109,379,759,91,197,0,B,605,5109,152320,13283,138777,10945,1900,149,156,4927,151338,151338,5083,151338,11,0
MP,21,3399,0,961,5109,379,759,180,197,12,D,2,5109,3420,39620,407151,21,2,149,0,81,3420,3420,81,3420,0,0
MS,11432,104335,0,559,1805,141,759,75,197,7681,A,528,1805,115767,39620,407151,11432,1900,149,136,2505,115767,115767,2641,115767,7,32
MT,470,27697,0,4,64,379,759,180,197,434,B,16,64,485619,39620,407151,470,1900,149,2,1280,28167,28167,1282,28167,0,1
NC,19023,236732,0,511,5109,379,759,180,197,11637,A,661,5109,485619,39620,407151,19023,661,149,511,6300,255755,255755,6811,255755,2,0
ND,1931,54630,0,32,133,379,759,180,197,1219,C,37,133,485619,39620,407151,1931,37,149,31,1309,56561,56561,1340,56561,2,3
NE,10348,57153,0,961,5109,379,759,180,197,0,C,123,5109,485619,39620,407151,10348,1900,149,128,1733,67501,67501,1861,67501,0,0
NH,3596,41282,1481,114,359,379,109,180,197,1268,B,172,359,485619,39620,407151,3596,1900,149,40,86,46359,44878,126,44878,1,12
NJ,148039,357530,0,3509,5109,1053,759,819,197,23496,A+,10435,5109,485619,39620,407151,148039,10435,149,1705,16299,505569,505569,18004,505569,79,0
NM,5938,127315,0,211,886,379,759,180,197,1755,C,265,886,485619,39620,407151,5938,1900,149,81,4588,133253,133253,4669,133253,6,0
NV,6906,74926,0,423,5109,105,759,65,197,355,B,383,5109,97094,39620,407151,6906,1900,149,49,1146,81832,81832,1195,81832,8,0
NY,351371,1088186,0,5840,86901,1908,759,1538,197,61681,A,22729,86901,485619,39620,407151,351371,1900,149,1250,24911,1439557,1439557,26161,1439557,110,326
OH,28454,243395,0,912,4998,367,1328,247,197,0,B,1657,4998,485619,39620,407151,26646,1504,153,531,6856,271849,271849,7387,271849,32,77
OK,5398,118162,0,76,885,45,759,180,197,4008,A+,288,885,123954,5792,118162,38775,1900,149,88,0,123560,123560,88,123560,0,5
OR,3687,93628,0,137,708,43,759,13,197,1406,A+,138,708,485619,39620,407151,3604,1900,149,64,2895,97315,97315,2959,97315,1,5
PA,63056,277553,0,1885,5109,379,759,397,197,0,C,4505,5109,485619,39620,407151,38775,1900,149,822,6883,340609,340609,7705,340609,87,0
PR,2710,,0,147,5109,17,759,4,197,0,C,124,5109,485619,39620,407151,2710,60,149,64,0,2710,2710,64,2710,1,0
RI,13177,81057,0,236,1438,62,759,46,197,1012,A+,506,1438,124622,16319,108303,13177,1900,149,137,1289,94234,94234,1426,94234,7,20
SC,8942,122617,0,961,1421,379,759,180,197,5076,A,391,1421,485619,39620,407151,8942,391,149,126,10947,131559,131559,11073,131559,11,0
SD,4027,25018,0,77,316,379,759,180,197,2784,B,44,316,485619,39620,407151,38775,1900,149,40,446,29045,29045,486,29045,0,4
TN,18011,319417,0,638,1489,379,759,180,197,9886,A,301,1489,485619,39620,407151,18011,301,149,623,11525,337428,337428,12148,337428,3,7
TX,48693,631152,0,1551,5109,379,759,180,197,28371,A,1347,5109,679845,39620,407151,48693,1900,149,909,28581,679845,679845,29490,679845,11,0
UT,7384,166638,0,179,595,379,197,180,84,4183,B,80,595,485619,39620,407151,7384,1900,149,146,3124,174022,174022,3270,174022,0,9
VA,31140,165086,530,1502,5609,361,759,194,197,4107,A+,1014,5609,194677,39620,407151,29591,980,34,752,5113,196756,196226,5865,196226,5,92
VI,69,1278,45,961,5109,379,759,180,197,61,C,6,5109,485619,39620,407151,38775,6,149,0,0,1392,1347,0,1347,0,0
VT,944,23547,0,22,5109,379,759,180,197,815,B,54,5109,485619,39620,407151,940,54,149,4,573,24491,24491,577,24491,0,0
WA,20286,259467,0,168,5109,52,759,180,197,0,A,1001,5109,485619,39620,407151,19581,1001,149,295,6687,279753,279753,6982,279753,1,0
WI,14442,144502,194,574,2068,128,496,180,197,6786,A+,459,2068,485619,39620,407151,12687,459,149,185,4828,159138,158944,5013,158944,6,30
WV,1491,74544,0,48,5109,11,759,7,197,919,B,67,5109,485619,39620,407151,1491,1900,149,1,544,76035,76035,545,76035,0,0
WY,754,16331,0,8,73,379,759,180,197,498,B,8,73,16897,616,15602,566,1900,149,0,0,17085,17085,0,17085,0,3
AK,396,34255,0,13,5109,379,759,180,197,344,B,10,5109,34651,39620,407151,396,10,149,4,1366,34651,34651,1370,34651,0,0
AL,11771,144579,0,460,1392,379,504,180,296,0,B,488,1392,485619,39620,407151,11771,488,149,248,2608,156350,156350,2856,156350,3,5
AR,4759,80426,0,65,520,379,759,9,101,3590,A,98,520,485619,39620,407151,4759,1900,149,181,3360,85185,85185,3541,85185,0,0
AS,0,105,0,961,5109,379,759,180,197,0,C,0,5109,485619,39620,407151,0,1900,149,0,0,105,105,0,105,0,0
AZ,13937,137824,0,796,2703,337,759,201,197,3450,A+,680,2703,151761,39620,407151,38775,1900,149,306,4667,151761,151761,4973,151761,1,30
CA,78839,1156404,0,4291,5109,1293,759,180,197,0,B,3261,5109,1235243,39620,407151,78839,1900,149,2046,54071,1235243,1235243,56117,1235243,57,0
CO,21633,103915,0,650,3866,379,759,180,197,3346,A,878,3866,485619,39620,407151,19507,1900,149,401,3307,125548,125548,3708,125548,0,24
CT,37419,133188,0,937,10946,379,759,180,197,6264,B,3408,10946,177679,39620,407151,38775,1900,149,716,5136,170607,170607,5852,170607,69,0
DC,7123,29403,0,369,5109,379,759,74,197,1023,A,383,5109,485619,39620,407151,38775,1900,149,81,913,36526,36526,994,36526,8,0
DE,7670,33195,0,229,5109,379,759,180,197,3478,B,392,5109,485619,39620,407151,38775,345,47,123,984,40865,40865,1107,40865,9,0
FL,45588,606204,1479,961,8478,379,759,180,197,0,A+,2049,8478,653081,60938,683219,45588,2049,149,777,20968,653271,651792,21745,651792,9,85
GA,37701,313474,0,1010,6790,379,1557,180,197,0,A+,1606,6790,351175,39620,407151,37701,1900,149,554,29552,351175,351175,30106,351175,14,55
GU,154,4450,0,961,5109,379,759,180,197,126,C,5,5109,485619,39620,407151,149,1900,149,0,85,4604,4604,85,4604,0,0
HI,639,41035,0,961,82,379,759,180,197,572,B,17,82,485619,39620,407151,38775,1900,149,1,790,41674,41674,791,41674,0,1
IA,14651,85590,0,376,5109,124,759,85,197,7154,A+,351,5109,100241,39620,407151,14651,1900,149,323,3618,100241,100241,3941,100241,5,0
ID,2419,34253,0,26,213,379,89,180,197,1612,B,73,213,36456,39620,407151,2203,1900,149,30,954,36672,36672,984,36672,0,0
IL,94191,487753,0,4190,5109,1144,759,735,197,0,A,4177,5109,581944,39620,407151,94191,4177,149,1734,18561,581944,581944,20295,581944,48,0
IN,27778,149465,0,1246,4389,441,990,205,197,0,A+,1751,4389,485619,39620,407151,38775,1607,144,498,5387,177243,177243,5885,177243,10,0
KS,7886,53706,0,961,724,379,246,180,112,443,A,172,724,485619,39620,407151,38775,1900,149,0,0,61592,61592,0,61592,0,0
KY,7688,121997,0,381,1896,218,797,180,197,2768,A+,334,1896,485619,39620,407151,7408,334,149,244,1707,129685,129685,1951,129685,2,0
LA,34432,230738,0,1019,5109,379,759,111,197,22608,B,2491,5109,485619,39620,407151,38775,2425,66,315,5113,265170,265170,5428,265170,12,0
MA,86010,374816,0,2597,8539,702,759,180,197,0,A+,5797,8539,485619,39620,407151,86010,5797,149,1077,11660,460826,460826,12737,460826,92,83
MD,38804,156122,0,1460,6993,562,759,180,197,2816,B,2090,6993,485619,39620,407151,38804,1989,101,836,3915,194926,194926,4751,194926,50,238
ME,1687,22092,0,37,216,16,759,11,197,1028,B,70,216,485619,39620,407151,1511,70,149,39,0,23779,23779,39,23779,0,2
MI,58278,363548,0,1114,5109,488,759,434,197,28234,A+,5396,5109,430802,67254,363548,54872,5194,233,255,10392,421826,421826,10647,421826,39,0
MN,18016,153069,0,487,2090,221,716,180,197,10175,A+,731,2090,171077,39620,407151,15668,722,9,311,5670,171085,171085,5981,171085,22,51
MO,10789,135466,0,775,5109,379,759,116,197,0,B,594,5109,485619,13191,135466,10789,1900,149,114,6801,146255,146255,6915,146255,5,0
MP,21,3318,0,961,5109,379,759,180,197,12,D,2,5109,485619,39620,407151,21,2,149,0,0,3339,3339,0,3339,0,0
MS,11296,101830,0,608,1773,158,759,81,197,6268,A,521,1773,485619,39620,407151,11296,1900,149,173,4477,113126,113126,4650,113126,11,25
MT,468,26417,0,3,63,379,759,180,197,431,B,16,63,485619,39620,407151,468,1900,149,0,794,26885,26885,794,26885,0,0
NC,18512,230432,0,493,5109,379,759,180,197,9115,A,659,5109,485619,39620,407151,18512,659,149,530,9828,248944,248944,10358,248944,7,0
ND,1900,53321,0,30,130,379,759,180,197,1178,C,35,130,485619,39620,407151,1900,35,149,52,1682,55221,55221,1734,55221,0,0
NE,10220,55420,0,961,5109,379,759,180,197,0,C,123,5109,65774,39620,407151,10220,1900,149,448,5214,65640,65640,5662,65640,4,0
NH,3556,41196,1216,115,347,379,109,180,197,1258,B,171,347,485619,39620,407151,3556,1900,149,92,1984,45968,44752,2076,44752,12,12
NJ,146334,341231,0,3411,5109,1030,759,819,197,23299,A+,10356,5109,485619,39620,407151,146334,10356,149,1245,11096,487565,487565,12341,487565,107,0
NM,5857,122727,0,208,886,379,759,180,197,1739,C,259,886,485619,39620,407151,5847,1900,149,195,3931,128584,128584,4126,128584,6,0
NV,6857,73780,0,423,5109,105,759,65,197,272,B,375,5109,95954,39620,407151,6857,1900,149,195,6778,80637,80637,6973,80637,6,0
NY,350121,1063275,0,5897,86575,1981,759,1601,197,61381,A,22619,86575,485619,39620,407151,350121,1900,149,1889,32790,1413396,1413396,34679,1413396,141,368
OH,27923,236539,0,914,4921,343,1305,230,197,0,B,1625,4921,262759,39620,407151,26220,1472,153,449,17311,264462,264462,17760,264462,15,51
OK,5310,118162,0,180,880,73,759,180,197,3983,A+,288,880,485619,5792,118162,38775,1900,149,73,0,123472,123472,73,123472,0,2
OR,3623,90733,0,156,703,37,759,16,197,1406,A+,137,703,485619,39620,407151,3542,1900,149,11,2146,94356,94356,2157,94356,0,4
PA,62234,270670,0,1821,5109,379,759,422,197,0,C,4418,5109,485619,39620,407151,38775,1900,149,623,4445,332904,332904,5068,332904,15,0
PR,2646,,0,150,5109,24,759,5,197,0,C,123,5109,485619,39620,407151,1147,60,149,57,0,2646,2646,57,2646,1,0
RI,13040,79768,0,260,1418,64,759,45,197,972,A+,499,1418,122492,16095,106397,13040,1900,149,125,1537,92808,92808,1662,92808,10,15
SC,8816,111670,0,961,1421,379,759,180,197,5076,A,380,1421,120331,39620,407151,38775,380,149,409,10461,120486,120486,10870,120486,0,0
SD,3987,24572,0,77,312,379,759,180,197,2724,B,44,312,28559,39620,407151,38775,1900,149,28,355,28559,28559,383,28559,0,8
TN,17388,307892,0,513,1482,379,759,180,197,9652,A,298,1482,325280,39620,407151,17388,298,149,100,4979,325280,325280,5079,325280,3,8
TX,47784,602571,0,1512,5109,379,759,180,197,27570,A,1336,5109,650355,39620,407151,47784,1900,149,785,10831,650355,650355,11616,650355,31,0
UT,7238,163514,0,181,586,379,196,180,84,4075,B,80,586,485619,39620,407151,7238,1900,149,170,3808,170752,170752,3978,170752,2,8
VA,30388,159973,527,1524,5517,379,759,195,197,3993,A+,1009,5517,188874,39620,407151,28901,975,34,705,4088,190888,190361,4793,190361,7,103
VI,69,1278,45,961,5109,379,759,180,197,61,C,6,5109,485619,39620,407151,38775,6,149,0,84,1392,1347,84,1347,0,0
VT,940,22974,0,14,5109,379,759,180,197,810,B,54,5109,485619,39620,407151,940,54,149,0,777,23914,23914,777,23914,1,0
WA,19991,252780,0,168,5109,52,759,180,197,0,A,1000,5109,485619,39620,407151,19265,1000,149,153,1817,272771,272771,1970,272771,8,0
WI,14257,139674,182,543,2038,129,494,180,197,6542,A+,453,2038,152217,39620,407151,12543,453,149,379,5468,154113,153931,5847,153931,0,20
WV,1490,74000,0,48,5109,11,759,7,197,919,B,67,5109,485619,39620,407151,1490,1900,149,33,2064,75490,75490,2097,75490,3,0
WY,754,16331,0,8,70,379,759,180,197,498,B,8,70,16709,616,15602,566,1900,149,38,653,17085,17085,691,17085,1,1
AK,392,32889,0,10,5109,379,759,180,197,344,B,10,5109,33281,39620,407151,392,10,149,4,859,33281,33281,863,33281,0,0
AL,11523,141971,0,455,1387,379,501,180,295,0,B,485,1387,485619,39620,407151,11523,485,149,307,7124,153494,153494,7431,153494,9,10
AR,4578,77066,0,65,520,379,759,10,101,3472,A,98,520,485619,39620,407151,4578,1900,149,115,0,81644,81644,115,81644,0,0
AS,0,105,0,961,5109,379,759,180,197,0,C,0,5109,485619,39620,407151,0,1900,149,0,0,105,105,0,105,0,0
AZ,13631,133157,0,791,2673,344,759,210,197,3357,A+,679,2673,146788,39620,407151,38775,1900,149,462,4325,146788,146788,4787,146788,28,37
CA,76793,1102333,0,4424,5109,1313,759,180,197,0,B,3204,5109,1179126,39620,407151,76793,1900,149,1857,43363,1179126,1179126,45220,1179126,96,0
CO,21232,100608,0,671,3842,379,759,180,197,3312,A,878,3842,485619,39620,407151,19151,1900,149,394,3416,121840,121840,3810,121840,-213,53
CT,36703,128052,0,994,10946,379,759,180,197,6264,B,3339,10946,170607,39620,407151,38775,1900,149,618,8229,164755,164755,8847,164755,54,0
DC,7042,28490,0,382,5109,379,759,79,197,998,A,375,5109,485619,39620,407151,38775,1900,149,171,1022,35532,35532,1193,35532,7,0
DE,7547,32211,0,250,5109,379,759,180,197,3367,B,383,5109,485619,39620,407151,38775,336,47,174,1306,39758,39758,1480,39758,10,0
FL,44811,585236,1676,961,8393,379,759,180,197,0,A+,2040,8393,485619,39620,407151,44811,2040,149,1601,19609,631723,630047,21210,630047,49,400
GA,37147,283922,0,1005,6735,379,1554,180,197,0,A+,1592,6735,321069,39620,407151,37147,1900,149,466,18729,321069,321069,19195,321069,35,297
GU,154,4365,0,961,5109,379,759,180,197,126,C,5,5109,485619,39620,407151,149,1900,149,0,4,4519,4519,4,4519,0,0
HI,638,40245,0,961,81,379,759,180,197,565,B,17,81,485619,39620,407151,38775,1900,149,1,2106,40883,40883,2107,40883,0,0
IA,14328,81972,0,387,5109,128,759,83,197,6927,A+,346,5109,485619,39620,407151,14328,1900,149,279,2455,96300,96300,2734,96300,10,0
ID,2389,33299,0,19,213,379,89,180,197,1588,B,73,213,35485,39620,407151,2186,1900,149,38,905,35688,35688,943,35688,1,1
IL,92457,469192,0,4306,5109,1135,759,653,197,0,A,4129,5109,485619,39620,407151,92457,4129,149,2088,20959,561649,561649,23047,561649,71,0
IN,27280,144078,0,1274,4389,426,990,199,197,0,A+,1741,4389,485619,39620,407151,38775,1596,145,625,5285,171358,171358,5910,171358,50,0
KS,7886,53706,0,961,724,379,246,180,112,443,A,172,724,485619,39620,407151,38775,1900,149,0,0,61592,61592,0,61592,0,0
KY,7444,120290,0,381,1896,218,797,180,197,2739,A+,332,1896,485619,39620,407151,7408,332,149,219,6237,127734,127734,6456,127734,4,9
LA,34117,225625,0,1028,5109,379,759,123,197,22608,B,2479,5109,485619,39620,407151,38775,2413,66,280,6273,259742,259742,6553,259742,31,0
MA,84933,363156,0,2692,8456,747,759,180,197,0,A+,5705,8456,485619,39620,407151,84933,5705,149,1512,10898,448089,448089,12410,448089,113,142
MD,37968,152207,0,1500,6755,598,759,180,197,2806,B,2040,6755,485619,39620,407151,37968,1943,97,982,6367,190175,190175,7349,190175,49,76
ME,1648,22092,0,37,214,19,759,10,197,1012,B,70,214,33035,39620,407151,1477,70,149,45,0,23740,23740,45,23740,1,3
MI,58023,353156,0,1256,5109,532,759,440,197,28234,A+,5357,5109,419366,66210,353156,54457,5163,233,336,11329,411179,411179,11665,411179,32,0
MN,17705,147399,0,493,2039,225,700,180,197,9571,A+,709,2039,165104,39620,407151,14969,700,9,342,7626,165104,165104,7968,165104,17,54
MO,10675,128665,0,775,5109,379,759,116,197,0,B,589,5109,143966,12943,130771,10675,1900,149,219,4663,139340,139340,4882,139340,13,0
MP,21,3318,0,961,5109,379,759,180,197,12,D,2,5109,3339,39620,407151,21,2,149,2,12,3339,3339,14,3339,0,0
MS,11123,97353,0,641,1748,170,759,81,197,6268,A,510,1748,108476,39620,407151,11123,1900,149,322,1331,108476,108476,1653,108476,17,36
MT,468,25623,0,3,63,379,759,180,197,431,B,16,63,485619,39620,407151,468,1900,149,2,671,26091,26091,673,26091,0,0
NC,17982,220604,0,481,5109,379,759,180,197,9115,A,652,5109,485619,39620,407151,17982,652,149,853,6186,238586,238586,7039,238586,11,0
ND,1848,51639,0,33,130,379,759,180,197,1111,C,35,130,485619,39620,407151,1848,35,149,87,1685,53487,53487,1772,53487,0,0
NE,9772,50206,0,961,5109,379,759,180,197,0,C,119,5109,485619,39620,407151,9772,1900,149,356,2407,59978,59978,2763,59978,6,0
NH,3464,39212,1401,110,335,379,109,180,197,1254,B,159,335,485619,39620,407151,3464,1900,149,0,64,44077,42676,64,42676,0,0
NJ,145089,330135,0,3564,5109,1061,759,846,197,22939,A+,10249,5109,485619,39620,407151,145089,10249,149,1184,11068,475224,475224,12252,475224,111,0
NM,5662,118796,0,223,886,379,759,180,197,1671,C,253,886,485619,39620,407151,5662,1900,149,159,4698,124458,124458,4857,124458,11,0
NV,6662,67002,0,423,5109,105,759,65,197,272,B,369,5109,87454,39620,407151,6662,1900,149,48,1470,73664,73664,1518,73664,1,0
NY,348232,1030485,0,6220,86207,2077,759,1674,197,60796,A,22478,86207,485619,39620,407151,348232,1900,149,2419,38250,1378717,1378717,40669,1378717,174,425
OH,27474,219228,0,866,4870,366,1277,251,197,0,B,1610,4870,485619,39620,407151,25836,1457,153,520,0,246702,246702,520,246702,29,79
OK,5237,118162,0,180,878,73,759,180,197,3945,A+,288,878,123954,5792,118162,38775,1900,149,151,5056,123399,123399,5207,123399,3,15
OR,3612,88587,0,153,699,48,759,16,197,1406,A+,137,699,485619,39620,407151,3534,1900,149,71,2622,92199,92199,2693,92199,0,8
PA,61611,266225,0,1873,5109,379,759,429,197,0,C,4403,5109,485619,39620,407151,38775,1900,149,989,7015,327836,327836,8004,327836,61,0
PR,2589,,0,144,5109,15,759,5,197,0,B,122,5109,485619,39620,407151,1114,59,149,47,0,2589,2589,47,2589,0,0
RI,12915,78231,0,273,1403,66,759,44,197,947,A+,489,1403,119564,15872,103692,12915,1900,149,252,1764,91146,91146,2016,91146,10,31
SC,8407,101209,0,961,1421,379,759,180,197,5076,A,380,1421,485619,39620,407151,38775,380,149,0,0,109616,109616,0,109616,0,0
SD,3959,24217,0,75,304,379,759,180,197,2673,B,44,304,485619,39620,407151,38775,1900,149,72,690,28176,28176,762,28176,0,8
TN,17288,302913,0,515,1474,379,759,180,197,9529,A,295,1474,485619,39620,407151,17288,295,149,318,10127,320201,320201,10445,320201,5,20
TX,46999,591740,0,1791,5109,379,759,180,197,26601,A,1305,5109,638739,39620,407151,46999,1900,149,1801,27308,638739,638739,29109,638739,33,0
UT,7068,159706,0,168,578,379,194,180,84,3896,B,78,578,485619,39620,407151,7068,1900,149,155,3401,166774,166774,3556,166774,1,12
VA,29683,155885,485,1505,5414,381,759,189,197,3909,A+,1002,5414,184118,39620,407151,28233,968,34,1011,6543,186053,185568,7554,185568,25,98
VI,69,1194,37,961,5109,379,759,180,197,61,C,6,5109,485619,39620,407151,38775,6,149,0,0,1300,1263,0,1263,0,0
VT,940,22197,0,20,5109,379,759,180,197,804,B,53,5109,485619,39620,407151,934,53,149,8,960,23137,23137,968,23137,0,0
WA,19838,250963,0,331,5109,90,759,180,197,0,A,992,5109,485619,39620,407151,19202,992,149,188,2641,270801,270801,2829,270801,9,0
WI,13878,134206,189,546,2018,127,488,180,197,6542,A+,453,2018,485619,39620,407151,12187,453,149,534,5549,148273,148084,6083,148084,8,41
WV,1457,71936,0,55,5109,13,759,6,197,889,B,64,5109,485619,39620,407151,1457,1900,149,16,2441,73393,73393,2457,73393,2,0
WY,716,15678,0,8,69,379,759,180,197,496,B,7,69,16219,616,15602,541,1900,149,1,371,16394,16394,372,16394,0,1
AK,388,32030,0,8,5109,379,759,180,197,343,B,10,5109,32418,39620,407151,388,10,149,1,655,32418,32418,656,32418,0,0
AL,11216,134847,0,519,1377,379,497,180,293,0,B,476,1377,485619,39620,407151,11216,476,149,248,3830,146063,146063,4078,146063,9,27
AR,4463,77066,0,65,520,379,759,9,101,3390,A,98,520,485619,39620,407151,4463,1900,149,227,5484,81529,81529,5711,81529,1,11
AS,0,105,0,961,5109,379,759,180,197,0,C,0,5109,485619,39620,407151,0,1900,149,0,0,105,105,0,105,0,0
AZ,13169,128832,0,808,2636,313,759,222,197,3145,A+,651,2636,142001,39620,407151,38775,1900,149,495,7168,142001,142001,7663,142001,27,41
CA,74936,1058970,0,4519,5109,1324,759,180,197,0,B,3108,5109,1133906,39620,407151,74936,1900,149,1772,27483,1133906,1133906,29255,1133906,76,0
CO,20838,97192,0,685,3789,379,759,180,197,3217,A,1091,3789,485619,39620,407151,18804,1900,149,363,3148,118030,118030,3511,118030,29,54
CT,36085,119823,0,1033,10946,379,759,180,197,6264,B,3285,10946,164755,39620,407151,38775,1900,149,621,5725,155908,155908,6346,155908,66,0
DC,6871,27468,0,393,5109,379,759,90,197,975,A,368,5109,485619,39620,407151,38775,1900,149,135,1205,34339,34339,1340,34339,10,0
DE,7373,30905,0,269,5109,379,759,180,197,3210,B,373,5109,485619,39620,407151,38775,327,46,150,1271,38278,38278,1421,38278,11,0
FL,43210,565627,1228,961,7993,379,759,180,197,0,A+,1991,7993,485619,39620,407151,43210,1991,149,0,0,610065,608837,0,608837,43,0
GA,36681,265193,0,1029,6438,379,1534,180,197,0,A+,1557,6438,301874,39620,407151,36681,1900,149,823,15170,301874,301874,15993,301874,30,93
GU,154,4361,0,961,5109,379,759,180,197,124,C,5,5109,485619,39620,407151,150,1900,149,1,135,4515,4515,136,4515,0,0
HI,637,38139,0,961,81,379,759,180,197,564,B,17,81,485619,39620,407151,38775,1900,149,-1,-104,38776,38776,-105,38776,0,0
IA,14049,79517,0,387,5109,130,759,87,197,6561,A+,336,5109,485619,39620,407151,14049,1900,149,374,3898,93566,93566,4272,93566,18,0
ID,2351,32394,0,26,212,379,89,180,197,1573,B,72,212,34546,39620,407151,2152,1900,149,27,964,34745,34745,991,34745,3,0
IL,90369,448233,0,4367,5109,1129,759,675,197,0,A,4058,5109,485619,39620,407151,90369,4058,149,2432,24133,538602,538602,26565,538602,130,0
IN,26655,138793,0,1294,4389,492,990,213,197,0,A+,1691,4389,485619,39620,407151,38775,1550,138,602,4607,165448,165448,5209,165448,45,0
KS,7886,53706,0,961,724,379,246,180,112,443,A,172,724,485619,39620,407151,38775,1900,149,418,3546,61592,61592,3964,61592,8,20
KY,7225,114053,0,385,1887,220,794,180,197,2712,A+,328,1887,485619,39620,407151,7193,328,149,145,3738,121278,121278,3883,121278,2,52
LA,33837,219352,0,1091,5109,379,759,132,197,22608,B,2448,5109,485619,39620,407151,38775,2382,66,348,5253,253189,253189,5601,253189,31,0
MA,83421,352258,0,2767,8314,749,759,180,197,0,A+,5592,8314,485619,39620,407151,83421,5592,149,1239,10079,435679,435679,11318,435679,110,107
MD,36986,145840,0,1496,6679,598,759,180,197,2685,B,1991,6679,485619,39620,407151,36986,1896,95,1083,3289,182826,182826,4372,182826,56,126
ME,1603,22092,0,35,211,16,759,8,197,993,B,69,211,33035,39620,407151,1437,69,149,38,0,23695,23695,38,23695,0,4
MI,57687,341827,0,1256,5109,532,759,440,197,22686,A+,5325,5109,407180,65353,341827,54246,5124,233,651,15170,399514,399514,15821,399514,47,0
MN,17363,139773,0,498,1985,200,679,180,197,8820,A+,692,1985,157136,39620,407151,14240,683,9,798,8330,157136,157136,9128,157136,29,70
MO,10456,124002,0,812,5109,379,759,120,197,0,B,576,5109,139740,12685,126806,10456,1900,149,139,7209,134458,134458,7348,134458,14,0
MP,19,3306,0,961,5109,379,759,180,197,12,D,2,5109,3325,39620,407151,19,2,149,0,0,3325,3325,0,3325,0,0
MS,10801,96022,0,573,1712,172,759,81,197,6268,A,493,1712,106823,39620,407151,10801,1900,149,318,1179,106823,106823,1497,106823,13,45
MT,466,24952,0,3,63,379,759,180,197,431,B,16,63,485619,39620,407151,466,1900,149,4,865,25418,25418,869,25418,0,0
NC,17129,214418,0,492,5109,379,759,180,197,9115,A,641,5109,485619,39620,407151,17129,641,149,622,11657,231547,231547,12279,231547,26,0
ND,1761,49954,0,35,130,379,759,180,197,1071,C,35,130,485619,39620,407151,1761,35,149,114,1355,51715,51715,1469,51715,4,1
NE,9416,47799,0,961,5109,379,759,180,197,0,C,113,5109,485619,39620,407151,9416,1900,149,341,3533,57215,57215,3874,57215,6,0
NH,3464,39148,543,115,335,379,109,180,197,1247,B,159,335,485619,39620,407151,3158,1900,149,165,3272,43155,42612,3437,42612,9,9
NJ,143905,319067,0,3823,5109,1127,759,865,197,15642,A+,10138,5109,485619,39620,407151,143905,10138,149,1201,10075,462972,462972,11276,462972,192,0
NM,5503,114098,0,209,886,379,759,180,197,1576,C,242,886,485619,39620,407151,5503,1900,149,139,4451,119601,119601,4590,119601,11,0
NV,6614,65532,0,425,5109,115,759,73,197,272,B,368,5109,85791,39620,407151,6614,1900,149,115,2547,72146,72146,2662,72146,10,0
NY,345813,992235,0,6394,85782,2156,759,1774,197,60302,A,22304,85782,485619,39620,407151,345813,1900,149,2762,36529,1338048,1338048,39291,1338048,134,328
OH,26954,219228,0,944,4791,370,1277,260,197,0,B,1581,4791,485619,39620,407151,25349,1431,150,597,12233,246182,246182,12830,246182,47,73
OK,5086,113106,0,215,863,98,759,180,197,3801,A+,285,863,118751,5645,113106,38775,1900,149,124,5885,118192,118192,6009,118192,1,5
OR,3541,85965,0,161,691,46,759,19,197,1406,A+,137,691,485619,39620,407151,3470,1900,149,62,5394,89506,89506,5456,89506,0,6
PA,60622,259210,0,1934,5109,379,759,431,197,0,C,4342,5109,485619,39620,407151,38775,1900,149,986,7651,319832,319832,8637,319832,124,0
PR,2542,,0,147,5109,18,759,3,197,0,B,122,5109,485619,39620,407151,1088,63,149,115,0,2542,2542,115,2542,5,0
RI,12663,76467,0,272,1372,63,759,41,197,919,A+,479,1372,115270,15453,99817,12663,1900,149,232,1700,89130,89130,1932,89130,11,21
SC,8407,101209,0,961,1421,379,759,180,197,5076,A,380,1421,485619,39620,407151,38775,380,149,218,6863,109616,109616,7081,109616,9,83
SD,3887,23527,0,80,296,379,759,180,197,2574,B,44,296,485619,39620,407151,38775,1900,149,95,846,27414,27414,941,27414,1,6
TN,16970,292786,0,535,1454,379,759,180,197,9280,A,290,1454,485619,39620,407151,16970,290,149,271,7168,309756,309756,7439,309756,3,19
TX,45198,564432,0,1716,5109,379,759,180,197,25454,A,1272,5109,609630,39620,407151,45198,1900,149,1347,20970,609630,609630,22317,609630,56,0
UT,6913,156305,0,161,566,379,190,180,83,3719,B,77,566,485619,39620,407151,6913,1900,149,164,2935,163218,163218,3099,163218,2,8
VA,28672,149342,458,1511,5316,362,759,195,197,3805,A+,977,5316,176635,39620,407151,27293,944,33,859,10325,178472,178014,11184,178014,22,105
VI,69,1194,37,961,5109,379,759,180,197,61,C,6,5109,485619,39620,407151,38775,6,149,0,30,1300,1263,30,1263,0,0
VT,932,21237,0,17,5109,379,759,180,197,796,B,53,5109,485619,39620,407151,933,53,149,1,740,22169,22169,741,22169,0,0
WA,19650,248322,0,374,5109,114,759,180,197,0,A,983,5109,485619,39620,407151,19082,983,149,226,5178,267972,267972,5404,267972,8,0
WI,13344,128657,191,548,1977,113,485,180,197,6250,A+,445,1977,485619,39620,407151,11685,445,149,475,6059,142192,142001,6534,142001,11,38
WV,1441,69495,0,57,5109,15,759,8,197,870,B,62,5109,485619,39620,407151,1441,1900,149,14,2209,70936,70936,2223,70936,2,0
WY,715,15307,0,8,68,379,759,180,197,487,B,7,68,15848,607,14957,541,1900,149,14,578,16022,16022,592,16022,0,1
AK,387,31375,0,12,5109,379,759,180,197,339,B,10,5109,31762,39620,407151,387,10,149,4,1109,31762,31762,1113,31762,0,0
AL,10968,131017,0,509,1350,379,489,180,291,0,B,467,1350,485619,39620,407151,10968,467,149,351,5262,141985,141985,5613,141985,18,33
AR,4236,71582,0,64,509,379,759,13,100,3277,A,97,509,485619,39620,407151,4236,1900,149,72,2531,75818,75818,2603,75818,2,12
AS,0,105,0,961,5109,379,759,180,197,0,C,0,5109,485619,39620,407151,0,1900,149,0,0,105,105,0,105,0,0
AZ,12674,121664,0,781,2595,323,759,201,197,3074,A+,624,2595,134338,39620,407151,38775,1900,149,498,6090,134338,134338,6588,134338,30,52
CA,73164,1031487,0,4655,5109,1324,759,180,197,0,B,3032,5109,1104651,39620,407151,73164,1900,149,2023,37036,1104651,1104651,39059,1104651,98,0
CO,20475,94044,0,685,3735,379,759,180,197,3217,A,1062,3735,485619,39620,407151,18461,1900,149,318,2951,114519,114519,3269,114519,53,40
CT,35464,114098,0,1103,10946,379,759,180,197,6264,B,3219,10946,155908,39620,407151,38775,1900,149,609,6010,149562,149562,6619,149562,94,1557
DC,6736,26263,0,397,5109,379,759,90,197,966,A,358,5109,485619,39620,407151,38775,1900,149,152,1189,32999,32999,1341,32999,8,0
DE,7223,29634,0,273,5109,379,759,180,197,3080,B,362,5109,485619,39620,407151,38775,318,44,271,1833,36857,36857,2104,36857,11,0
FL,43210,565627,1228,961,7993,379,759,180,197,0,A+,1948,7993,485619,39620,407151,43210,1948,149,808,13266,610065,608837,14074,608837,50,158
GA,35858,250023,0,1060,6345,379,1513,180,197,0,A+,1527,6345,285881,39620,407151,35858,1900,149,526,11451,285881,285881,11977,285881,22,86
GU,153,4226,0,961,5109,379,759,180,197,124,C,5,5109,485619,39620,407151,149,1900,149,1,116,4379,4379,117,4379,0,0
HI,638,38243,0,961,81,379,759,180,197,563,B,17,81,485619,39620,407151,38775,1900,149,3,513,38881,38881,516,38881,0,0
IA,13675,75619,0,405,5109,134,759,93,197,6231,A+,318,5109,485619,39620,407151,13675,1900,149,386,3189,89294,89294,3575,89294,12,0
ID,2324,31430,0,19,212,379,88,180,197,1557,B,69,212,33556,39620,407151,2126,1900,149,31,595,33754,33754,626,33754,0,-2
IL,87937,424100,0,4473,5109,1132,759,689,197,0,A,3928,5109,485619,39620,407151,87937,3928,149,3239,19439,512037,512037,22678,512037,136,0
IN,26053,134186,0,1381,4389,488,990,217,197,0,A+,1646,4389,485619,39620,407151,38775,1508,138,580,5576,160239,160239,6156,160239,27,0
KS,7468,50160,0,961,704,379,238,180,108,422,A,164,704,485619,39620,407151,38775,1900,149,0,0,57628,57628,0,57628,0,0
KY,7080,110315,0,377,1835,215,784,180,197,2649,A+,326,1835,485619,39620,407151,7049,326,149,227,6534,117395,117395,6761,117395,5,10
LA,33489,214099,0,1193,5109,379,759,140,197,22608,B,2417,5109,485619,39620,407151,38775,2351,66,827,8857,247588,247588,9684,247588,36,0
MA,82182,342179,0,2859,8207,781,759,180,197,0,A+,5482,8207,485619,39620,407151,82182,5382,149,1685,12644,424361,424361,14329,424361,167,175
MD,35903,142551,0,1538,6553,569,759,180,197,2569,B,1935,6553,485619,39620,407151,35903,1840,95,1091,3789,178454,178454,4880,178454,54,149
ME,1565,22092,0,37,207,18,759,7,197,958,B,69,207,33035,39620,407151,1405,69,149,50,0,23657,23657,50,23657,3,3
MI,57036,326657,0,1330,5109,653,759,515,197,22686,A+,5278,5109,391176,64519,326657,53956,5092,232,578,16415,383693,383693,16993,383693,46,0
MN,16565,131443,0,498,1915,203,663,180,197,8473,A+,663,1915,148008,39620,407151,13435,663,9,793,5941,148008,148008,6734,148008,25,64
MO,10317,116793,0,796,5109,379,759,115,197,0,B,562,5109,134975,12346,122388,10317,1900,149,175,2793,127110,127110,2968,127110,20,0
MP,19,3306,0,961,5109,379,759,180,197,12,D,2,5109,3325,39620,407151,19,2,149,0,285,3325,3325,285,3325,0,0
MS,10483,94843,0,589,1667,131,759,72,197,6268,A,480,1667,105326,39620,407151,105326,1900,149,393,4885,105326,105326,5278,105326,15,51
MT,462,24087,0,3,63,379,759,180,197,431,B,16,63,485619,39620,407151,462,1900,149,0,697,24549,24549,697,24549,0,0
NC,16507,202761,0,507,5109,379,759,180,197,9115,A,615,5109,485619,39620,407151,16507,615,149,691,8120,219268,219268,8811,219268,18,0
ND,1647,48599,0,38,129,379,759,180,197,1007,C,31,129,485619,39620,407151,1712,31,149,0,1301,50246,50246,1301,50246,2,2
NE,9075,44266,0,961,5109,379,759,180,197,0,C,107,5109,485619,39620,407151,9075,1900,149,383,3233,53341,53341,3616,53341,4,0
NH,3299,35876,735,126,326,379,97,180,197,1236,B,150,326,485619,39620,407151,2588,1900,149,60,1899,39910,39175,1959,39175,8,7
NJ,142704,308992,0,3958,5109,1157,759,898,197,15642,A+,9946,5109,485619,39620,407151,142704,9946,149,1144,9102,451696,451696,10246,451696,244,0
NM,5364,109647,0,200,886,379,759,180,197,1515,C,231,886,485619,39620,407151,5364,1900,149,152,4570,115011,115011,4722,115011,12,0
NV,6499,62985,0,515,5109,126,759,75,197,244,B,358,5109,82993,39620,407151,6499,1900,149,105,2707,69484,69484,2812,69484,3,0
NY,343051,955706,0,6706,85454,2223,759,1846,197,59758,A,22170,85454,485619,39620,407151,343051,1900,149,2390,37460,1298757,1298757,39850,1298757,157,446
OH,26357,206995,0,953,4718,360,1268,253,197,0,B,1534,4718,485619,39620,407151,24800,1388,146,636,6862,233352,233352,7498,233352,51,100
OK,4962,107221,0,217,858,102,759,180,197,3660,A+,284,858,112647,5426,107221,38775,1900,149,110,2946,112183,112183,3056,112183,6,10
OR,3479,80571,0,163,685,38,759,17,197,1406,A+,137,685,485619,39620,407151,3407,1900,149,63,0,84050,84050,63,84050,3,7
PA,59636,251559,0,1983,5109,379,759,446,197,0,C,4218,5109,485619,39620,407151,38775,1900,149,938,7388,311195,311195,8326,311195,275,0
PR,2427,,0,159,5109,18,759,5,197,0,B,117,5109,485619,39620,407151,1073,58,149,98,0,2427,2427,98,2427,2,0
RI,12431,74767,0,271,1351,65,759,42,197,903,A+,468,1351,111593,15089,96504,12431,1900,149,228,1927,87198,87198,2155,87198,6,23
SC,8189,94346,0,961,1338,379,759,180,197,4914,A,371,1338,485619,39620,407151,38775,371,149,262,9133,102535,102535,9395,102535,16,0
SD,3792,22681,0,85,290,379,759,180,197,2437,B,43,290,485619,39620,407151,38775,1900,149,60,569,26473,26473,629,26473,4,9
TN,16699,285618,0,599,1435,379,759,180,197,8881,A,287,1435,485619,39620,407151,16699,287,149,329,9071,302317,302317,9400,302317,14,47
TX,43851,543462,0,1648,5109,379,759,180,197,24487,A,1216,5109,587313,39620,407151,43851,1900,149,1448,29089,587313,587313,30537,587313,58,0
UT,6749,153370,0,142,558,379,187,180,83,3566,B,75,558,485619,39620,407151,6749,1900,149,129,3204,160119,160119,3333,160119,0,5
VA,27813,139017,496,1533,5211,355,759,201,197,3678,A+,955,5211,185551,39620,407151,26469,927,28,1067,4371,167326,166830,5438,166830,28,131
VI,69,1164,45,961,5109,379,759,180,197,61,C,6,5109,485619,39620,407151,38775,6,149,0,36,1278,1233,36,1233,0,0
VT,931,20497,0,18,5109,379,759,180,197,792,B,53,5109,485619,39620,407151,932,53,149,1,789,21428,21428,790,21428,0,0
WA,19424,243144,0,365,5109,111,759,180,197,0,A,975,5109,485619,39620,407151,18823,975,149,245,4760,262568,262568,5005,262568,13,0
WI,12869,122598,169,507,1939,121,478,180,197,5994,A+,434,1939,485619,39620,407151,11275,434,149,420,5487,135636,135467,5907,135467,13,31
WV,1427,67286,0,52,5109,9,759,5,197,870,B,60,5109,485619,39620,407151,1427,1900,149,29,2004,68713,68713,2033,68713,2,0
WY,701,14729,0,8,67,379,759,180,197,480,B,7,67,15417,39620,407151,529,1900,149,26,345,15430,15430,371,15430,0,0
AK,383,30266,0,12,5109,379,759,180,197,338,B,10,5109,30649,39620,407151,383,10,149,0,688,30649,30649,688,30649,0,0
AL,10617,125755,0,524,1317,379,477,180,284,0,B,449,1317,485619,39620,407151,10617,449,149,307,2847,136372,136372,3154,136372,20,30
AR,4164,69051,0,59,497,379,759,12,99,3220,A,95,497,485619,39620,407151,4164,1900,149,0,2771,73215,73215,2771,73215,0,12
AS,0,105,0,961,5109,379,759,180,197,0,C,0,5109,485619,39620,407151,0,1900,149,0,0,105,105,0,105,0,0
AZ,12176,115574,0,755,2543,292,759,191,197,2979,A+,594,2543,165810,39620,407151,38775,1900,149,440,4468,127750,127750,4908,127750,32,39
CA,71141,994451,0,4545,5109,1314,759,180,197,0,B,2934,5109,1065592,39620,407151,71141,1900,149,1759,30463,1065592,1065592,32222,1065592,87,0
CO,20157,91093,0,688,3695,379,759,180,197,3171,A,1009,3695,485619,39620,407151,18211,1900,149,278,2315,111250,111250,2593,111250,22,32
CT,34855,108088,0,1158,9389,379,759,180,197,5413,B,3125,9389,149562,39620,407151,38775,1900,149,522,3997,142943,142943,4519,142943,84,0
DC,6584,25074,0,423,5109,379,759,82,197,934,A,350,5109,485619,39620,407151,38775,1900,149,99,509,31658,31658,608,31658,14,0
DE,6952,27801,0,282,5109,379,759,180,197,2942,B,351,5109,485619,39620,407151,38775,308,43,211,1251,34753,34753,1462,34753,17,0
FL,42402,552361,1191,961,7835,379,759,180,197,0,A+,1898,7835,485619,39620,407151,42402,1898,149,479,14680,595954,594763,15159,594763,49,181
GA,35332,238572,0,1091,6259,379,1494,180,197,0,A+,1505,6259,273904,39620,407151,35332,1900,149,697,11028,273904,273904,11725,273904,44,129
GU,152,4110,0,961,5109,379,759,180,197,124,C,5,5109,485619,39620,407151,148,1900,149,0,171,4262,4262,171,4262,0,0
HI,635,37730,0,961,81,379,759,180,197,563,B,17,81,485619,39620,407151,38775,1900,149,1,425,38365,38365,426,38365,0,0
IA,13289,72430,0,388,5109,133,759,101,197,5954,A+,306,5109,485619,39620,407151,13289,1900,149,377,4054,85719,85719,4431,85719,17,0
ID,2293,30835,0,20,214,379,88,180,197,1536,B,69,214,32934,39620,407151,2099,1900,149,33,390,33128,33128,423,33128,-1,4
IL,84698,404661,0,4563,5109,1208,759,714,197,0,A,3792,5109,485619,39620,407151,84698,3792,149,1677,15991,489359,489359,17668,489359,191,0
IN,25473,128610,0,1336,4389,481,990,217,197,0,A+,1619,4389,485619,39620,407151,38775,1482,137,346,3227,154083,154083,3573,154083,41,0
KS,7468,50160,0,961,704,379,238,180,108,422,A,164,704,485619,39620,407151,38775,1900,149,352,3167,57628,57628,3519,57628,6,44
KY,6853,103781,0,379,1825,215,783,180,197,2546,A+,321,1825,485619,39620,407151,6828,321,149,176,6434,110634,110634,6610,110634,10,58
LA,32662,205242,0,1194,5109,379,759,147,197,22608,B,2381,5109,485619,39620,407151,38775,2315,66,612,9280,237904,237904,9892,237904,34,0
MA,80497,329535,0,3101,8032,794,759,180,197,0,A+,5315,8032,485619,39620,407151,80497,5315,149,1165,7371,410032,410032,8536,410032,174,190
MD,34812,138762,0,1550,6404,572,759,180,197,2456,B,1881,6404,485619,39620,407151,34812,1787,94,751,3320,173574,173574,4071,173574,47,117
ME,1515,22092,0,41,204,20,759,7,197,943,B,66,204,33035,39620,407151,1372,66,149,38,0,23607,23607,38,23607,1,2
MI,56458,310242,0,1384,5109,693,759,525,197,22686,A+,5232,5109,373484,63242,310242,53451,5046,231,817,18541,366700,366700,19358,366700,44,0
MN,15772,125502,0,494,1851,199,647,180,197,8149,A+,638,1851,141274,39620,407151,12917,638,9,729,6568,141274,141274,7297,141274,24,52
MO,10142,114000,0,771,5109,379,759,129,197,0,B,542,5109,130101,12117,117748,10142,1900,149,136,2710,124142,124142,2846,124142,18,0
MP,19,3021,0,961,5109,379,759,180,197,12,D,2,5109,3040,39620,407151,19,2,149,0,167,3040,3040,167,3040,0,0
MS,10090,89958,0,604,1616,150,759,79,197,6268,A,465,1616,100048,39620,407151,10090,1900,149,182,2174,100048,100048,2356,100048,8,34
MT,462,23390,0,3,63,379,759,180,197,430,B,16,63,485619,39620,407151,462,1900,149,1,816,23852,23852,817,23852,0,0
NC,15816,194641,0,521,5109,379,759,180,197,9115,A,597,5109,485619,39620,407151,15816,597,149,470,7743,210457,210457,8213,210457,20,0
ND,1647,47298,0,37,127,379,759,180,197,969,C,29,127,485619,39620,407151,1647,29,149,76,1037,48945,48945,1113,48945,4,5
NE,8692,41033,0,192,5109,81,759,56,197,0,B,103,5109,485619,39620,407151,8692,1900,149,120,1662,49725,49725,1782,49725,3,0
NH,3239,33977,51,121,319,379,97,180,197,1234,B,142,319,485619,39620,407151,1863,1900,149,79,1576,37267,37216,1655,37216,9,1
NJ,141560,299890,0,4226,5109,1226,759,928,197,15642,A+,9702,5109,485619,39620,407151,141560,9702,149,817,7573,441450,441450,8390,441450,194,0
NM,5212,105077,0,199,886,379,759,180,197,1434,C,219,886,485619,39620,407151,5212,1900,149,143,3425,110289,110289,3568,110289,11,0
NV,6394,60278,0,522,5109,121,759,64,197,198,B,355,5109,79735,39620,407151,6394,1900,149,83,2514,66672,66672,2597,66672,5,0
NY,340661,918246,0,6946,85008,2308,759,1908,197,59193,A,22013,85008,485619,39620,407151,340661,1900,149,2176,31618,1258907,1258907,33794,1258907,168,519
OH,25721,200133,0,924,4618,353,1248,244,197,0,B,1483,4618,485619,39620,407151,24245,1347,136,471,7652,225854,225854,8123,225854,47,79
OK,4852,104275,0,218,848,93,759,180,197,3559,A+,278,848,109859,5317,104275,38775,1900,149,120,12896,109127,109127,13016,109127,0,20
OR,3416,80571,0,162,678,38,759,17,197,1406,A+,134,678,485619,39620,407151,3338,1900,149,130,6251,83987,83987,6381,83987,4,5
PA,58698,244171,0,2012,5109,379,759,473,197,0,C,3943,5109,485619,39620,407151,38775,1900,149,707,6182,302869,302869,6889,302869,137,0
PR,2329,,0,142,5109,10,759,6,197,0,C,115,5109,485619,39620,407151,1064,58,149,30,0,2329,2329,30,2329,1,0
RI,12203,72840,0,269,1328,68,759,48,197,886,A+,462,1328,107994,14782,93212,12203,1900,149,196,1924,85043,85043,2120,85043,18,21
SC,7927,85213,0,961,1338,379,759,180,197,6817,A,355,1338,485619,39620,407151,38775,355,149,0,0,93140,93140,0,93140,0,0
SD,3732,22112,0,79,281,379,759,180,197,2367,B,39,281,485619,39620,407151,38775,1900,149,69,578,25844,25844,647,25844,0,10
TN,16370,276547,0,635,1388,379,759,180,197,8624,A,273,1388,485619,39620,407151,16370,273,149,259,8834,292917,292917,9093,292917,8,25
TX,42403,514373,0,1676,5109,379,759,180,197,23519,A,1158,5109,556776,39620,407151,42403,1900,149,1355,17249,556776,556776,18604,556776,25,0
UT,6620,150166,0,158,553,379,182,180,81,3406,B,75,553,485619,39620,407151,6620,1900,149,188,3113,156786,156786,3301,156786,2,18
VA,26746,134646,485,1526,5080,374,759,202,197,3554,A+,927,5080,180084,39620,407151,25431,899,28,946,5117,161877,161392,6063,161392,36,151
VI,69,1128,62,961,5109,379,759,180,197,61,C,6,5109,485619,39620,407151,38775,6,149,0,13,1259,1197,13,1197,0,0
VT,930,19708,0,17,5109,379,759,180,197,789,B,53,5109,485619,39620,407151,929,53,149,1,601,20638,20638,602,20638,0,0
WA,19179,238384,0,384,5109,114,759,180,197,0,A,962,5109,485619,39620,407151,18554,962,149,227,4520,257563,257563,4747,257563,17,0
WI,12449,117111,194,527,1908,110,469,180,197,5673,A+,421,1908,485619,39620,407151,10902,421,149,318,4363,129754,129560,4681,129560,3,31
WV,1398,65282,0,58,5109,11,759,6,197,813,B,58,5109,485619,39620,407151,1398,1900,149,27,1584,66680,66680,1611,66680,1,0
WY,675,14384,0,10,67,379,759,180,197,477,B,7,67,14789,39620,407151,513,1900,149,0,0,15059,15059,0,15059,0,0
AK,383,29578,0,10,5109,379,759,180,197,334,B,10,5109,29961,39620,407151,383,10,149,2,1279,29961,29961,1281,29961,0,0
AL,10310,122908,0,529,1287,379,468,180,280,0,B,429,1287,485619,39620,407151,10310,429,149,301,3473,133218,133218,3774,133218,28,31
AR,4164,66280,0,59,485,379,759,12,98,3220,A,95,485,485619,39620,407151,4164,1900,149,130,1284,70444,70444,1414,70444,1,5
AS,0,105,0,961,5109,379,759,180,197,0,C,0,5109,485619,39620,407151,0,1900,149,0,0,105,105,0,105,0,0
AZ,11736,111106,0,765,2504,318,759,204,197,2909,A+,562,2504,122842,39620,407151,38775,1900,149,356,6022,122842,122842,6378,122842,20,42
CA,69382,963988,0,4544,5109,1349,759,180,197,0,B,2847,5109,1033370,39620,407151,69382,1900,149,1443,40030,1033370,1033370,41473,1033370,77,0
CO,19879,88778,0,738,3663,379,759,180,197,3114,A,987,3663,485619,39620,407151,17983,1900,149,-20,-113,108657,108657,-133,108657,6,-26
CT,34333,104091,0,1189,9389,379,759,180,197,5413,B,3041,9389,142943,39620,407151,38775,1900,149,568,5348,138424,138424,5916,138424,33,0
DC,6485,24565,0,416,5109,379,759,82,197,886,A,336,5109,485619,39620,407151,38775,1900,149,96,693,31050,31050,789,31050,8,0
DE,6741,26550,0,276,5109,379,759,180,197,2802,B,334,5109,485619,39620,407151,38775,296,38,176,1187,33291,33291,1363,33291,10,0
FL,41923,537681,1064,961,7654,379,759,180,197,0,A+,1849,7654,485619,39620,407151,41923,1849,149,941,17606,580668,579604,18547,579604,44,196
GA,34635,227544,0,1125,6130,379,1443,180,197,0,A+,1461,6130,262179,39620,407151,34635,1900,149,708,10183,262179,262179,10891,262179,20,115
GU,152,3939,0,961,5109,379,759,180,197,124,C,5,5109,485619,39620,407151,148,1900,149,1,101,4091,4091,102,4091,0,0
HI,634,37305,0,961,81,379,759,180,197,561,B,17,81,485619,39620,407151,38775,1900,149,2,254,37939,37939,256,37939,0,0
IA,12912,68376,0,385,5109,143,759,101,197,5618,A+,289,5109,485619,39620,407151,12912,1900,149,539,2957,81288,81288,3496,81288,18,0
ID,2260,30445,0,25,210,379,87,180,197,1508,B,70,210,32518,39620,407151,2073,1900,149,30,533,32705,32705,563,32705,3,3
IL,83021,388670,0,4626,5109,1215,759,730,197,0,A,3601,5109,485619,39620,407151,83021,3601,149,4014,25252,471691,471691,29266,471691,142,0
IN,25127,125383,0,1283,4389,472,759,212,197,0,A+,1578,4389,485619,39620,407151,38775,1444,134,500,3322,150510,150510,3822,150510,38,0
KS,7116,46993,0,961,660,379,233,180,101,376,A,158,660,485619,39620,407151,38775,1900,149,0,0,54109,54109,0,54109,0,0
KY,6677,97347,0,383,1767,220,768,180,197,2335,A+,311,1767,485619,39620,407151,6654,311,149,237,16864,104024,104024,17101,104024,7,10
LA,32050,195962,0,1320,5109,379,759,146,197,22608,B,2347,5109,485619,39620,407151,38775,2281,66,235,6947,228012,228012,7182,228012,39,0
MA,79332,322164,0,3127,7842,818,759,180,197,0,A+,5141,7842,485619,39620,407151,79332,5141,149,870,5898,401496,401496,6768,401496,33,110
MD,34061,135442,0,1563,6287,590,759,180,197,2394,B,1834,6287,485619,39620,407151,34061,1742,92,688,4035,169503,169503,4723,169503,46,104
ME,1477,22092,0,34,202,17,759,8,197,913,B,65,202,485619,39620,407151,1338,65,149,15,0,23569,23569,15,23569,0,2
MI,55641,291701,0,1384,5109,693,759,525,197,22686,A+,5188,5109,353909,62208,291701,53030,5001,230,1637,13408,347342,347342,15045,347342,49,0
MN,15043,118934,0,496,1799,199,625,180,197,7609,A,614,1799,133977,39620,407151,12494,614,149,664,3349,133977,133977,4013,133977,23,83
MO,10006,111290,0,787,5109,379,759,140,197,0,B,524,5109,125042,11865,112948,10006,1900,149,88,5588,121296,121296,5676,121296,36,0
MP,19,2854,0,961,5109,379,759,180,197,12,D,2,5109,2873,39620,407151,19,2,149,0,178,2873,2873,178,2873,0,0
MS,9908,87784,0,604,1582,146,759,75,197,6268,A,457,1582,97692,39620,407151,9908,1900,149,234,1573,97692,97692,1807,97692,22,36
MT,461,22574,0,4,63,379,759,180,197,425,B,16,63,485619,39620,407151,461,1900,149,2,461,23035,23035,463,23035,0,1
NC,15346,186898,0,475,5109,379,759,180,197,9115,A,577,5109,485619,39620,407151,15346,577,149,301,6078,202244,202244,6379,202244,27,0
ND,1571,46261,0,38,122,379,759,180,197,877,C,25,122,485619,39620,407151,1571,25,149,53,765,47832,47832,818,47832,1,7
NE,8572,39371,0,192,5109,81,759,56,197,0,B,100,5109,485619,39620,407151,8572,1900,149,257,1447,47943,47943,1704,47943,2,0
NH,3160,32401,54,117,318,379,97,180,197,1231,B,133,318,485619,39620,407151,38775,1900,149,0,678,35615,35561,678,35561,0,0
NJ,140743,292317,0,4328,5109,1306,759,982,197,15642,A+,9508,5109,485619,39620,407151,140743,9508,149,798,6329,433060,433060,7127,433060,198,0
NM,5069,101652,0,207,886,379,759,180,197,1300,C,208,886,485619,39620,407151,5069,1900,149,206,4017,106721,106721,4223,106721,8,97
NV,6311,57764,0,522,5109,121,759,64,197,185,C,350,5109,76914,39620,407151,6311,1900,149,159,3832,64075,64075,3991,64075,6,0
NY,338485,886628,0,7063,84489,2375,759,1964,197,58679,A,21845,84489,485619,39620,407151,338485,1900,149,1430,19032,1225113,1225113,20462,1225113,205,295
OH,25250,192481,0,1032,4539,401,1232,270,197,0,B,1436,4539,485619,39620,407151,23809,1303,133,473,6728,217731,217731,7201,217731,79,126
OK,4732,91379,0,190,828,83,759,180,197,3423,A+,278,828,106559,5229,101082,38775,1900,149,119,0,96111,96111,119,96111,4,0
OR,3286,74320,0,165,673,39,759,25,197,1125,A+,130,673,485619,39620,407151,3222,1900,149,0,0,77606,77606,0,77606,0,0
PA,57991,237989,0,2187,5109,379,759,497,197,0,C,3806,5109,485619,39620,407151,38775,1900,149,837,6285,295980,295980,7122,295980,75,0
PR,2299,,0,127,5109,379,759,180,197,0,C,114,5109,485619,39620,407151,1062,58,149,43,0,2299,2299,43,2299,1,0
RI,12007,70916,0,277,1307,72,759,53,197,863,A+,444,1307,104134,14437,89697,12007,1900,149,219,1551,82923,82923,1770,82923,14,27
SC,7927,85213,0,961,1338,379,759,180,197,6817,A,355,1338,485619,39620,407151,38775,355,149,274,8409,93140,93140,8683,93140,24,86
SD,3663,21534,0,74,271,379,759,180,197,2309,B,39,271,485619,39620,407151,38775,1900,149,49,570,25197,25197,619,25197,5,8
TN,16111,267713,0,591,1363,379,759,180,197,8336,A,265,1363,485619,39620,407151,16111,265,149,567,9980,283824,283824,10547,283824,14,19
TX,41048,497124,0,1725,5109,379,759,180,197,22674,A,1133,5109,485619,39620,407151,41048,1900,149,1179,11296,538172,538172,12475,538172,33,0
UT,6432,147053,0,166,535,379,178,180,80,3267,B,73,535,485619,39620,407151,6432,1900,149,70,2830,153485,153485,2900,153485,5,18
VA,25800,129529,447,1529,4929,364,759,201,197,3400,A+,891,4929,171239,39620,407151,24601,864,27,730,3982,155776,155329,4712,155329,41,152
VI,69,1115,58,961,5109,379,759,180,197,61,C,6,5109,485619,39620,407151,38775,6,149,0,5,1242,1184,5,1184,1,0
VT,929,19107,0,18,5109,379,759,180,197,787,B,53,5109,485619,39620,407151,927,53,149,2,310,20036,20036,312,20036,0,0
WA,18952,233864,0,321,5109,94,759,180,197,0,A,945,5109,485619,39620,407151,18249,945,149,211,4765,252816,252816,4976,252816,14,0
WI,12131,112748,180,520,1877,116,464,180,197,5371,A+,418,1877,485619,39620,407151,10611,418,149,211,4715,125059,124879,4926,124879,9,31
WV,1371,63698,0,50,5109,9,759,5,197,803,C,57,5109,485619,39620,407151,1371,1900,149,5,1595,65069,65069,1600,65069,3,0
WY,675,14384,0,10,67,379,759,180,197,477,B,7,67,14789,39620,407151,513,1900,149,13,2981,15059,15059,2994,15059,0,1
AK,381,28299,0,7,5109,379,759,180,197,328,C,10,5109,28680,39620,407151,381,1900,149,2,1314,28680,28680,1316,28680,0,0
AL,10009,119435,0,458,1256,379,463,180,276,0,B,401,1256,485619,39620,407151,10009,1900,149,232,1791,129444,129444,2023,129444,8,16
AR,4034,64996,0,61,480,379,759,11,98,3149,A,94,480,485619,39620,407151,4034,1900,149,287,3215,69030,69030,3502,69030,6,9
AS,0,105,0,961,5109,379,759,180,197,0,D,0,5109,485619,39620,407151,0,1900,149,0,22,105,105,22,105,0,0
AZ,11380,105084,0,717,2462,297,759,201,197,2852,A+,542,2462,116464,39620,407151,38775,1900,149,261,5826,116464,116464,6087,116464,6,41
CA,67939,923958,0,4549,5109,1329,759,180,197,0,B,2770,5109,991897,39620,407151,67939,1900,149,1259,34974,991897,991897,36233,991897,25,0
CO,19899,88891,0,573,3689,379,759,180,197,3076,B,981,3689,485619,39620,407151,17809,1900,149,196,4517,108790,108790,4713,108790,14,66
CT,33765,98743,0,1212,9389,379,759,180,197,5413,B,3008,9389,138424,39620,407151,38775,2718,149,211,2105,132508,132508,2316,132508,41,0
DC,6389,23872,0,416,5109,379,759,82,197,881,A,328,5109,485619,39620,407151,38775,1900,149,117,574,30261,30261,691,30261,5,0
DE,6565,25363,0,275,5109,379,759,180,197,2619,B,324,5109,485619,39620,407151,38775,288,36,118,771,31928,31928,889,31928,12,0
FL,40982,520075,1080,961,7458,379,759,180,197,0,B,1805,7458,485619,39620,407151,40982,1900,149,386,21723,562137,561057,22109,561057,14,54
GA,33927,217361,0,1133,6015,379,1414,180,197,0,A,1441,6015,251288,39620,407151,33927,1900,149,486,7255,251288,251288,7741,251288,36,18
GU,151,3838,0,961,5109,379,759,180,197,124,C,5,5109,485619,39620,407151,147,1900,149,0,195,3989,3989,195,3989,0,0
HI,632,37051,0,961,81,379,759,180,197,561,B,17,81,485619,39620,407151,38775,1900,149,1,412,37683,37683,413,37683,0,0
IA,12373,65419,0,394,5109,152,759,107,197,5249,A+,271,5109,485619,39620,407151,12373,1900,149,414,3204,77792,77792,3618,77792,6,0
ID,2230,29912,0,30,207,379,87,180,197,1473,B,67,207,31961,39620,407151,2049,1900,149,0,0,32142,32142,0,32142,0,0
IL,79007,363418,0,4319,5109,1248,759,730,197,0,A,3459,5109,485619,39620,407151,79007,1900,149,1266,11175,442425,442425,12441,442425,53,0
IN,24627,122061,0,1346,4389,452,990,213,197,0,A+,1540,4389,485619,39620,407151,38775,1900,149,501,6158,146688,146688,6659,146688,32,0
KS,7116,46993,0,961,660,379,233,180,101,376,A,158,660,485619,39620,407151,38775,1900,149,168,1436,54109,54109,1604,54109,1,3
KY,6440,80483,0,394,1757,226,758,180,197,2308,A,304,1757,485619,39620,407151,6417,1900,149,0,0,86923,86923,0,86923,0,0
LA,31815,189015,0,1310,5109,379,759,157,197,22608,B,2308,5109,485619,39620,407151,38775,1900,149,215,4743,220830,220830,4958,220830,22,0
MA,78462,316266,0,3102,7732,813,759,180,197,0,A,5108,7732,485619,39620,407151,78462,1900,149,669,5670,394728,394728,6339,394728,129,115
MD,33373,131407,0,1544,6183,585,759,180,197,2298,A,1788,6183,485619,39620,407151,33373,1698,90,786,4063,164780,164780,4849,164780,49,228
ME,1462,22092,0,37,200,17,759,9,197,872,B,65,200,485619,39620,407151,1328,1900,149,26,0,23554,23554,26,23554,1,1
MI,54004,278293,0,1424,5109,685,759,557,197,22686,A+,5139,5109,339843,61550,278293,52399,4958,228,971,10876,332297,332297,11847,332297,58,0
MN,14379,115585,0,452,1716,194,600,180,197,6945,A,591,1716,129964,39620,407151,11799,1900,149,827,4476,129964,129964,5303,129964,13,59
MO,9918,105702,0,824,5109,379,759,137,197,0,B,488,5109,123746,11789,111728,9918,1900,149,74,0,115620,115620,74,115620,6,0
MP,19,2676,0,961,5109,379,759,180,197,12,D,2,5109,2695,39620,407151,19,1900,149,3,355,2695,2695,358,2695,0,0
MS,9674,86211,0,507,1546,132,759,68,197,6268,A,435,1546,95885,39620,407151,9674,1900,149,173,14110,95885,95885,14283,95885,5,15
MT,459,22113,0,4,62,379,759,180,197,423,C,16,62,485619,39620,407151,459,1900,149,1,867,22572,22572,868,22572,0,0
NC,15045,180820,0,464,5109,379,759,180,197,9115,B,550,5109,485619,39620,407151,15045,1900,149,281,3449,195865,195865,3730,195865,3,0
ND,1518,45496,0,34,115,379,759,180,197,846,C,24,115,485619,39620,407151,1518,24,149,27,2118,47014,47014,2145,47014,0,5
NE,8315,37924,0,961,5109,379,759,180,197,0,D,98,5109,485619,39620,407151,8315,1900,149,81,589,46239,46239,670,46239,2,0
NH,3160,31723,261,113,318,379,97,180,197,1229,B,133,318,485619,39620,407151,38775,1900,149,149,1281,35144,34883,1430,34883,2,5
NJ,139945,285988,0,4195,5109,1255,759,970,197,15642,A+,9310,5109,485619,39620,407151,139945,1900,149,1413,112073,425933,425933,113486,425933,55,0
NM,4863,97635,0,194,789,379,759,180,197,1285,C,200,789,485619,39620,407151,4863,1900,149,85,5360,102498,102498,5445,102498,9,0
NV,6152,53932,0,482,5109,117,759,60,197,183,C,344,5109,72970,39620,407151,6152,1900,149,54,1221,60084,60084,1275,60084,5,0
NY,337055,867596,0,7226,84194,2450,759,2020,197,58363,A,21640,84194,485619,39620,407151,337055,1900,149,1660,19993,1204651,1204651,21653,1204651,162,433
OH,24777,185753,0,1011,4413,391,1217,256,197,0,B,1357,4413,485619,39620,407151,23400,1236,121,696,4972,210530,210530,5668,210530,16,62
OK,4613,91379,0,177,828,93,759,180,197,3241,A+,274,828,95869,4923,90721,38775,1900,149,24,0,95992,95992,24,95992,2,2
OR,3286,74320,0,164,673,40,759,23,197,1125,A+,130,673,485619,39620,407151,3222,1900,149,58,2041,77606,77606,2099,77606,3,3
PA,57154,231704,0,2176,5109,379,759,497,197,0,C,3731,5109,485619,39620,407151,38775,1900,149,543,3932,288858,288858,4475,288858,24,0
PR,2256,,0,159,5109,379,759,180,197,0,D,113,5109,485619,39620,407151,1054,1900,149,58,0,2256,2256,58,2256,2,0
RI,11788,69365,0,276,1280,73,759,52,197,841,A+,430,1280,101331,14067,87264,11788,1900,149,175,1259,81153,81153,1434,81153,8,29
SC,7653,76804,0,961,1252,379,759,180,197,4120,B,331,1252,485619,39620,407151,38775,1900,149,0,0,84457,84457,0,84457,0,0
SD,3614,20964,0,78,263,379,759,180,197,2187,C,34,263,485619,39620,407151,38775,1900,149,97,587,24578,24578,684,24578,0,2
TN,15544,257733,0,581,1344,379,759,180,197,8038,B,251,1344,485619,39620,407151,15544,1900,149,559,10849,273277,273277,11408,273277,8,19
TX,39869,485828,0,1525,5109,379,759,180,197,21713,B,1100,5109,485619,39620,407151,39869,1900,149,1000,22921,525697,525697,23921,525697,12,0
UT,6362,144223,0,160,517,379,169,180,76,3181,B,68,517,485619,39620,407151,6362,1900,149,111,3964,150585,150585,4075,150585,1,5
VA,25070,125547,432,1504,4777,362,759,194,197,3273,A+,850,4777,167758,39620,407151,23889,823,27,989,6573,151049,150617,7562,150617,11,21
VI,69,1110,36,961,5109,379,759,180,197,60,C,5,5109,485619,39620,407151,38775,1900,149,0,8,1215,1179,8,1179,1,0
VT,927,18797,0,14,5109,379,759,180,197,785,B,53,5109,485619,39620,407151,926,1900,149,1,630,19724,19724,631,19724,0,0
WA,18741,229099,0,350,5109,110,759,180,197,0,B,931,5109,485619,39620,407151,18001,1900,149,292,4551,247840,247840,4843,247840,10,0
WI,11920,108033,180,520,1846,116,460,180,197,5176,A+,409,1846,485619,39620,407151,10418,1900,149,226,2870,120133,119953,3096,119953,9,26
WV,1366,62103,0,49,5109,10,759,6,197,775,C,54,5109,485619,39620,407151,1366,1900,149,6,819,63469,63469,825,63469,0,0
WY,662,11403,0,12,66,379,759,180,197,443,C,7,66,13416,39620,407151,504,1900,149,1,0,12065,12065,1,12065,0,1
AK,379,26985,0,8,5109,379,759,180,197,324,C,10,5109,27364,39620,407151,379,1900,149,1,914,27364,27364,915,27364,0,0
AL,9777,117644,0,424,1240,379,460,180,274,0,B,393,1240,485619,39620,407151,9777,1900,149,210,1717,127421,127421,1927,127421,5,12
AR,3747,61781,0,64,471,379,759,14,96,2968,B,88,471,485619,39620,407151,3747,1900,149,0,0,65528,65528,0,65528,0,0
AS,0,83,0,961,5109,379,759,180,197,0,D,0,5109,485619,39620,407151,0,1900,149,0,0,83,83,0,83,0,0
AZ,11119,99258,0,713,2421,300,759,195,197,2775,A+,536,2421,110377,39620,407151,38775,1900,149,159,4408,110377,110377,4567,110377,4,35
CA,66680,888984,0,4555,5109,1328,759,180,197,0,B,2745,5109,955664,39620,407151,66680,1900,149,2119,40975,955664,955664,43094,955664,67,0
CO,19703,84374,0,790,3623,379,759,180,197,3023,B,967,3623,485619,39620,407151,17491,1900,149,876,6429,104077,104077,7305,104077,7,23
CT,33554,96638,0,1242,9389,379,759,180,197,5413,B,2967,9389,132508,39620,407151,38775,2633,149,570,6053,130192,130192,6623,130192,35,0
DC,6272,23298,0,447,5109,130,759,91,197,880,A+,323,5109,485619,39620,407151,38775,1900,149,170,1217,29570,29570,1387,29570,12,0
DE,6447,24592,0,285,5109,379,759,180,197,2537,B,312,5109,485619,39620,407151,38775,277,35,170,1573,31039,31039,1743,31039,11,0
FL,40596,498352,1265,961,7404,379,759,180,197,0,B,1791,7404,485619,39620,407151,40596,1900,149,595,10622,540213,538948,11217,538948,6,79
GA,33441,210106,0,1144,5997,379,1412,180,197,0,A,1405,5997,243547,39620,407151,33441,1900,149,909,7314,243547,243547,8223,243547,5,10
GU,151,3643,0,961,5109,379,759,180,197,124,C,5,5109,485619,39620,407151,147,1900,149,0,0,3794,3794,0,3794,0,0
HI,631,36639,0,961,81,379,759,180,197,551,B,17,81,485619,39620,407151,38775,1900,149,2,1006,37270,37270,1008,37270,0,0
IA,11959,62215,0,413,5109,157,759,105,197,5154,A+,265,5109,485619,39620,407151,11959,1900,149,288,2410,74174,74174,2698,74174,13,0
ID,2230,29912,0,25,207,379,87,180,197,1473,B,67,207,31961,39620,407151,2049,1900,149,25,311,32142,32142,336,32142,0,1
IL,77741,352243,0,4293,5109,1232,759,709,197,0,A,3406,5109,485619,39620,407151,77741,1900,149,1656,11997,429984,429984,13653,429984,57,0
IN,24126,115903,0,1328,4389,462,990,205,197,0,A+,1508,4389,485619,39620,407151,38775,1900,149,394,3949,140029,140029,4343,140029,18,0
KS,6948,45557,0,961,657,379,231,180,101,371,A,157,657,485619,39620,407151,38775,1900,149,197,2375,52505,52505,2572,52505,0,22
KY,6440,80483,0,394,1757,226,758,180,197,2308,A,304,1757,485619,39620,407151,6417,1900,149,152,324,86923,86923,476,86923,6,61
LA,31600,184272,0,1324,5109,379,759,161,197,20316,B,2286,5109,485619,39620,407151,38775,1900,149,183,3532,215872,215872,3715,215872,19,0
MA,77793,310596,0,3128,7617,810,759,180,197,0,A,4979,7617,485619,39620,407151,77793,1900,149,1050,10802,388389,388389,11852,388389,139,66
MD,32587,127344,0,1640,5955,611,759,180,197,2293,A,1739,5955,485619,39620,407151,32587,1652,87,1053,2850,159931,159931,3903,159931,47,23
ME,1436,22092,0,36,199,17,759,10,197,861,B,64,199,485619,39620,407151,1312,1900,149,28,0,23528,23528,28,23528,0,1
MI,53033,267417,0,1437,5109,674,759,536,197,22686,A+,5081,5109,328334,60917,267417,50925,4911,228,301,8152,320450,320450,8453,320450,45,0
MN,13552,111109,0,434,1657,199,581,180,197,6304,A,578,1657,124661,39620,407151,11271,1900,149,231,5069,124661,124661,5300,124661,20,45
MO,9844,105702,0,824,5109,379,759,137,197,0,B,482,5109,121559,11659,109674,9844,1900,149,178,6470,115546,115546,6648,115546,10,0
MP,16,2321,0,961,5109,379,759,180,197,12,D,2,5109,2336,39620,407151,16,1900,149,0,0,2337,2337,0,2337,0,0
MS,9501,72101,0,645,1531,141,759,78,197,4421,A,430,1531,91999,39620,407151,9501,1900,149,123,0,81602,81602,123,81602,9,19
MT,458,21246,0,4,62,379,759,180,197,422,C,16,62,485619,39620,407151,458,1900,149,0,375,21704,21704,375,21704,0,0
NC,14764,177371,0,442,5109,379,759,180,197,0,B,547,5109,485619,39620,407151,14764,1900,149,404,5369,192135,192135,5773,192135,3,0
ND,1491,43378,0,29,110,379,759,180,197,792,C,24,110,485619,39620,407151,1491,24,149,27,909,44869,44869,936,44869,0,0
NE,8234,37335,0,961,5109,379,759,180,197,0,D,96,5109,485619,39620,407151,8234,1900,149,403,2190,45569,45569,2593,45569,4,0
NH,3011,30442,512,107,313,379,97,180,197,1228,B,131,313,485619,39620,407151,38775,1900,149,64,1091,33965,33453,1155,33453,10,4
NJ,138532,173915,591,4308,5109,1338,759,994,197,15642,A+,9255,5109,485619,39620,407151,138532,1900,149,1447,5794,313038,312447,7241,312447,139,0
NM,4778,92275,0,198,789,379,759,180,197,1268,C,191,789,485619,39620,407151,4778,1900,149,105,3686,97053,97053,3791,97053,10,0
NV,6098,52711,0,444,5109,116,759,65,197,182,C,339,5109,71603,39620,407151,6098,1900,149,70,2628,58809,58809,2698,58809,5,0
NY,335395,847603,0,7262,83761,2488,759,2073,197,58006,A,21478,83761,485619,39620,407151,335395,1900,149,2273,26957,1182998,1182998,29230,1182998,207,476
OH,24081,180781,0,962,4351,381,1205,254,197,0,B,1341,4351,485619,39620,407151,22891,1220,121,384,7808,204862,204862,8192,204862,10,51
OK,4589,91379,0,177,826,93,759,180,197,3204,A+,272,826,95869,4923,90721,38775,1900,149,99,0,95968,95968,99,95968,2,4
OR,3228,72279,0,164,670,45,759,22,197,1125,A+,127,670,485619,39620,407151,3171,1900,149,68,819,75507,75507,887,75507,0,8
PA,56611,227772,0,2230,5109,379,759,501,197,0,C,3707,5109,485619,39620,407151,38775,1900,149,1295,5981,284383,284383,7276,284383,19,0
PR,2198,,0,143,5109,379,759,180,197,0,D,111,5109,485619,39620,407151,1040,1900,149,25,0,2198,2198,25,2198,3,0
RI,11613,68106,0,283,1251,70,759,52,197,809,A+,422,1251,99293,13826,85467,11613,1900,149,186,1502,79719,79719,1688,79719,4,33
SC,7653,76804,0,961,1252,379,759,180,197,4120,B,331,1252,485619,39620,407151,38775,1900,149,122,3372,84457,84457,3494,84457,1,0
SD,3517,20377,0,77,261,379,759,180,197,2147,C,34,261,485619,39620,407151,38775,1900,149,124,818,23894,23894,942,23894,0,8
TN,14985,246884,0,484,1325,379,759,180,197,7528,B,243,1325,485619,39620,407151,14985,1900,149,217,8904,261869,261869,9121,261869,1,6
TX,38869,462907,0,1626,5109,379,759,180,197,21022,B,1088,5109,485619,39620,407151,38869,1900,149,1009,11473,501776,501776,12482,501776,39,0
UT,6251,140259,0,144,512,379,168,180,76,3033,B,67,512,485619,39620,407151,6251,1900,149,148,3068,146510,146510,3216,146510,1,14
VA,24081,118974,506,1555,4756,351,759,187,197,3201,A+,839,4756,157957,39620,407151,22962,813,26,885,5021,143561,143055,5906,143055,12,39
VI,69,1102,39,961,5109,379,759,180,197,59,C,4,5109,485619,39620,407151,38775,1900,149,1,78,1210,1171,79,1171,0,0
VT,926,18167,0,21,5109,379,759,180,197,777,B,53,5109,485619,39620,407151,927,1900,149,0,477,19093,19093,477,19093,0,0
WA,18449,224548,0,335,5109,101,759,180,197,0,B,921,5109,485619,39620,407151,17705,1900,149,174,1187,242997,242997,1361,242997,16,0
WI,11694,105163,182,514,1820,113,456,180,197,5014,A+,400,1820,485619,39620,407151,10219,1900,149,292,3228,117039,116857,3520,116857,2,14
WV,1360,61284,0,49,5109,10,759,6,197,775,C,54,5109,485619,39620,407151,1360,1900,149,25,1622,62644,62644,1647,62644,1,0
WY,661,11403,0,12,65,379,759,180,197,443,C,7,65,13416,39620,407151,503,1900,149,17,0,12064,12064,17,12064,0,1
AK,378,26071,0,8,5109,379,759,180,197,318,C,10,5109,26449,39620,407151,378,1900,149,1,975,26449,26449,976,26449,0,0
AL,9567,115927,0,437,1228,379,459,180,272,0,B,388,1228,485619,39620,407151,9567,1900,149,346,5034,125494,125494,5380,125494,13,21
AR,3747,61781,0,64,471,379,759,14,96,2968,B,88,471,485619,39620,407151,3747,1900,149,53,1481,65528,65528,1534,65528,0,5
AS,0,83,0,961,5109,379,759,180,197,0,D,0,5109,485619,39620,407151,0,1900,149,0,0,83,83,0,83,0,0
AZ,10960,94850,0,739,2386,296,759,186,197,2684,A+,532,2386,105810,39620,407151,38775,1900,149,434,4251,105810,105810,4685,105810,15,36
CA,64561,848009,0,4538,5109,1349,759,180,197,0,B,2678,5109,912570,39620,407151,64561,1900,149,2049,35249,912570,912570,37298,912570,93,0
CO,18827,77945,0,790,3600,379,759,180,197,2974,B,960,3600,485619,39620,407151,16969,1900,149,26,2210,96772,96772,2236,96772,-1,43
CT,32984,90585,0,1301,9389,379,759,180,197,5413,B,2932,9389,130192,39620,407151,38775,2495,149,573,2455,123569,123569,3028,123569,58,0
DC,6102,22081,0,447,5109,130,759,91,197,879,A+,311,5109,485619,39620,407151,38775,1900,149,203,865,28183,28183,1068,28183,7,0
DE,6277,23019,0,288,5109,379,759,180,197,2450,B,301,5109,485619,39620,407151,38775,268,33,166,866,29296,29296,1032,29296,4,0
FL,40001,487730,1452,961,7325,379,759,180,197,0,B,1785,7325,485619,39620,407151,40001,1900,149,802,13588,529183,527731,14390,527731,47,168
GA,32532,202792,0,1179,5987,379,1409,180,197,0,A,1400,5987,235324,39620,407151,32532,1900,149,426,7331,235324,235324,7757,235324,23,52
GU,151,3643,0,961,5109,379,759,180,197,124,C,5,5109,485619,39620,407151,147,1900,149,0,17,3794,3794,17,3794,0,0
HI,629,35633,0,961,81,379,759,180,197,566,C,17,81,485619,39620,407151,38775,1900,149,0,-356,36262,36262,-356,36262,0,7
IA,11671,59805,0,402,5109,161,759,106,197,5011,A+,252,5109,485619,39620,407151,11671,1900,149,214,1001,71476,71476,1215,71476,9,0
ID,2205,29601,0,19,206,379,86,180,197,1442,B,67,206,31628,39620,407151,2027,1900,149,27,509,31806,31806,536,31806,0,0
IL,76085,340246,0,4739,5109,1215,759,739,197,0,A,3349,5109,485619,39620,407151,76085,1900,149,2325,14292,416331,416331,16617,416331,108,0
IN,23732,111954,0,1361,4389,458,990,213,197,0,A+,1490,4389,485619,39620,407151,38775,1900,149,586,4972,135686,135686,5558,135686,43,0
KS,6751,43182,0,961,635,379,229,180,100,350,A,157,635,485619,39620,407151,38775,1900,149,250,1975,49933,49933,2225,49933,5,27
KY,6288,80159,0,369,1696,210,723,180,197,2266,A,298,1696,485619,39620,407151,6269,1900,149,159,4887,86447,86447,5046,86447,4,12
LA,31417,180740,0,1333,5109,379,759,165,197,20316,B,2267,5109,485619,39620,407151,38775,2042,149,562,9179,212157,212157,9741,212157,40,0
MA,76743,299794,0,3229,7551,814,759,180,197,0,A,4840,7551,485619,39620,407151,76743,1900,149,1410,9104,376537,376537,10514,376537,138,117
MD,31534,124494,0,1665,5932,575,759,180,197,2159,A,1692,5932,485619,39620,407151,31534,1609,83,1049,2792,156028,156028,3841,156028,49,121
ME,1408,22092,0,43,198,22,759,10,197,857,B,64,198,485619,39620,407151,1287,1900,149,34,0,23500,23500,34,23500,1,4
MI,52732,259265,0,1531,5109,683,759,539,197,22686,A+,5036,5109,319680,60415,259265,50129,4853,227,383,11123,311997,311997,11506,311997,49,0
MN,13321,106040,0,476,1612,180,556,180,197,5764,A,558,1612,119361,39620,407151,10790,1900,149,281,4632,119361,119361,4913,119361,24,63
MO,9666,99232,0,855,5109,379,759,144,197,0,B,472,5109,117301,11486,105590,9666,1900,149,177,0,108898,108898,177,108898,23,0
MP,16,2321,0,961,5109,379,759,180,197,12,D,2,5109,2336,39620,407151,16,1900,149,1,0,2337,2337,1,2337,0,0
MS,9378,72101,0,607,1512,133,759,76,197,4421,A,421,1512,90472,39620,407151,9378,1900,149,288,0,81479,81479,288,81479,12,34
MT,458,20871,0,4,62,379,759,180,197,422,C,16,62,485619,39620,407151,458,1900,149,0,384,21329,21329,384,21329,0,0
NC,14360,172002,0,513,5109,379,759,180,197,0,B,544,5109,485619,39620,407151,14360,1900,149,492,7257,186362,186362,7749,186362,17,0
ND,1464,42469,0,34,110,379,759,180,197,762,C,24,110,485619,39620,407151,1464,24,149,39,1393,43933,43933,1432,43933,0,6
NE,7831,35145,0,961,5109,379,759,180,197,0,D,92,5109,485619,39620,407151,7831,1900,149,641,1923,42976,42976,2564,42976,2,0
NH,2947,29351,304,112,309,379,97,180,197,1210,B,121,309,485619,39620,407151,2947,1900,149,104,1522,32602,32298,1626,32298,7,1
NJ,137085,168121,557,4628,5109,1416,759,1054,197,15642,A+,9116,5109,485619,39620,407151,137085,1900,149,1631,4816,305763,305206,6447,305206,164,0
NM,4673,88589,0,201,789,379,759,180,197,1189,C,181,789,485619,39620,407151,4673,1900,149,180,4050,93262,93262,4230,93262,9,29
NV,6028,50083,0,961,5109,379,759,180,197,205,D,334,5109,68366,39620,407151,6028,1900,149,144,2623,56111,56111,2767,56111,6,0
NY,333122,820646,0,7776,83285,2664,759,2203,197,57180,B,21271,83285,485619,39620,407151,333122,1900,149,2715,29510,1153768,1153768,32225,1153768,226,555
OH,23697,172973,0,929,4300,368,1200,222,197,0,B,1331,4300,485619,39620,407151,22560,1214,117,681,11673,196670,196670,12354,196670,25,82
OK,4490,91379,0,177,822,93,759,180,197,3154,A+,270,822,95869,4923,90721,38775,1900,149,66,5946,95869,95869,6012,95869,4,17
OR,3160,71460,0,139,662,34,759,19,197,1125,A+,127,662,485619,39620,407151,3111,1900,149,92,1835,74620,74620,1927,74620,3,3
PA,55316,221791,0,2285,5109,379,759,502,197,0,C,3688,5109,485619,39620,407151,38775,1900,149,1078,5470,277107,277107,6548,277107,72,0
PR,2173,,0,148,5109,379,759,7,197,0,C,108,5109,485619,39620,407151,1034,1900,149,17,0,2173,2173,17,2173,1,0
RI,11427,66604,0,292,1218,77,759,56,197,772,A+,418,1218,96926,13549,83377,11427,1900,149,286,2266,78031,78031,2552,78031,19,31
SC,7531,73432,0,961,1252,379,759,180,197,4120,B,330,1252,485619,39620,407151,38775,1900,149,389,7132,80963,80963,7521,80963,14,100
SD,3393,19559,0,79,253,379,759,180,197,2125,C,34,253,485619,39620,407151,38775,1900,149,249,1410,22952,22952,1659,22952,3,6
TN,14768,237980,0,509,1319,379,759,180,197,7369,B,242,1319,485619,39620,407151,14768,1900,149,327,8843,252748,252748,9170,252748,1,20
TX,37860,451434,0,1735,5109,379,759,180,197,20141,B,1049,5109,485619,39620,407151,37860,1900,149,1251,10925,489294,489294,12176,489294,45,0
UT,6103,137191,0,172,498,379,166,180,75,2901,B,66,498,485619,39620,407151,6103,1900,149,184,4422,143294,143294,4606,143294,5,10
VA,23196,113953,501,1593,4717,367,759,198,197,3124,A+,827,4717,150952,39620,407151,22086,801,26,854,6350,137650,137149,7204,137149,15,95
VI,68,1024,36,961,5109,379,759,180,197,57,C,4,5109,485619,39620,407151,38775,1900,149,0,0,1128,1092,0,1092,0,0
VT,926,17690,0,21,5109,379,759,180,197,744,B,53,5109,485619,39620,407151,921,1900,149,8,468,18616,18616,476,18616,0,0
WA,18275,223361,0,393,5109,128,759,180,197,0,B,905,5109,485619,39620,407151,17645,1900,149,151,1943,241636,241636,2094,241636,14,0
WI,11402,101935,204,543,1806,110,452,180,197,4875,A+,398,1806,485619,39620,407151,9939,1900,149,372,4670,113541,113337,5042,113337,14,39
WV,1335,59662,0,53,5109,13,759,7,197,761,C,53,5109,485619,39620,407151,1335,1900,149,25,1536,60997,60997,1561,60997,2,0
WY,644,11403,0,12,64,379,759,180,197,438,C,7,64,13416,39620,407151,490,1900,149,9,0,12047,12047,9,12047,0,4
AK,377,25096,0,16,5109,379,759,180,197,305,C,10,5109,25473,39620,407151,377,1900,149,3,1129,25473,25473,1132,25473,0,0
AL,9221,110893,0,481,1207,379,454,180,266,0,B,375,1207,485619,39620,407151,9221,1900,149,323,4618,120114,120114,4941,120114,26,29
AR,3694,60300,0,70,466,379,759,14,93,2159,B,88,466,485619,39620,407151,3694,1900,149,83,3916,63994,63994,3999,63994,1,4
AS,0,83,0,961,5109,379,759,180,197,0,F,0,5109,485619,39620,407151,0,1900,149,0,0,83,83,0,83,0,0
AZ,10526,90599,0,730,2350,295,759,197,197,1747,A+,517,2350,101125,39620,407151,38775,1900,149,581,4110,101125,101125,4691,101125,67,58
CA,62512,812760,0,4514,5109,1342,759,180,197,0,B,2585,5109,875272,39620,407151,62512,1900,149,1898,30500,875272,875272,32398,875272,81,0
CO,18801,75735,0,821,3557,379,759,180,197,2869,B,961,3557,485619,39620,407151,16532,1900,149,971,2218,94536,94536,3189,94536,40,571
CT,32411,88130,0,1327,9389,379,759,180,197,5413,B,2874,9389,123569,39620,407151,38775,2436,149,627,3740,120541,120541,4367,120541,77,0
DC,5899,21216,0,447,5109,130,759,91,197,825,A+,304,5109,485619,39620,407151,38775,1900,149,245,1014,27115,27115,1259,27115,19,0
DE,6111,22153,0,289,5109,379,759,180,197,2288,B,297,5109,485619,39620,407151,38775,264,33,172,766,28264,28264,938,28264,12,0
FL,39199,474142,1433,961,7157,379,759,180,197,0,C,1738,7157,485619,39620,407151,39199,1900,149,371,20020,514774,513341,20391,513341,71,167
GA,32106,195461,0,1227,5935,379,1399,180,197,0,A,1377,5935,227477,39620,407151,32106,1900,149,667,9597,227567,227567,10264,227567,41,100
GU,151,3626,0,961,5109,379,759,180,197,122,D,5,5109,485619,39620,407151,147,1900,149,0,62,3777,3777,62,3777,0,0
HI,629,35989,0,961,74,379,759,180,197,565,B,17,74,485619,39620,407151,38775,1900,149,3,1074,36618,36618,1077,36618,0,0
IA,11457,58804,0,407,5109,164,759,109,197,4685,A+,243,5109,485619,39620,407151,11457,1900,149,398,3436,70261,70261,3834,70261,12,0
ID,2178,29092,0,16,206,379,86,180,197,1420,B,67,206,31099,39620,407151,2007,1900,149,20,360,31270,31270,380,31270,1,1
IL,73760,325954,0,4750,5109,1222,759,727,197,0,A,3241,5109,485619,39620,407151,73760,1900,149,2887,17784,399714,399714,20671,399714,130,0
IN,23146,106982,0,1379,4389,481,990,219,197,0,A+,1447,4389,485619,39620,407151,38775,1900,149,643,4703,130128,130128,5346,130128,33,4389
KS,6501,41207,0,961,608,379,223,180,99,332,A,152,608,485619,39620,407151,38775,1900,149,357,2529,47708,47708,2886,47708,5,21
KY,6129,75272,0,356,1684,199,714,180,197,2177,A,294,1684,485619,39620,407151,6119,1900,149,195,2600,81401,81401,2795,81401,11,68
LA,30855,171561,0,1359,5109,379,759,185,197,20316,B,2227,5109,485619,39620,407151,38775,1991,149,203,1446,202416,202416,1649,202416,19,0
MA,75333,290690,0,3349,7434,826,759,180,197,0,A,4702,7434,485619,39620,407151,75333,1900,149,1612,12779,366023,366023,14391,366023,150,197
MD,30485,121702,0,1674,5811,571,759,180,197,2041,A,1643,5811,485619,39620,407151,30485,1561,82,1111,2476,152187,152187,3587,152187,63,148
ME,1374,22092,0,44,194,23,759,10,197,836,B,63,194,485619,39620,407151,1264,1900,149,44,0,23466,23466,44,23466,1,2
MI,52349,248142,0,1637,5109,725,759,570,197,15659,A+,4987,5109,307801,59659,248142,49871,4809,215,618,11958,300491,300491,12576,300491,62,0
MN,13040,101408,0,473,1549,198,540,180,197,5163,A,534,1549,114448,39620,407151,10088,1900,149,712,4164,114448,114448,4876,114448,26,90
MO,9489,99232,0,832,5109,379,759,143,197,0,B,449,5109,113490,11307,101966,9489,1900,149,148,4951,108721,108721,5099,108721,31,0
MP,15,2321,0,961,5109,379,759,180,197,12,D,2,5109,2336,39620,407151,15,1900,149,0,538,2336,2336,538,2336,0,0
MS,9090,72101,0,632,1478,123,759,58,197,4421,A,409,1478,485619,39620,407151,9090,1900,149,404,0,81191,81191,404,81191,13,36
MT,458,20487,0,6,62,379,759,180,197,420,C,16,62,485619,39620,407151,458,1900,149,2,696,20945,20945,698,20945,0,0
NC,13868,164745,0,515,5109,379,759,180,197,0,B,527,5109,485619,39620,407151,13868,1900,149,471,6814,178613,178613,7285,178613,20,0
ND,1425,41076,0,33,104,379,759,180,197,714,C,24,104,485619,39620,407151,1425,24,149,54,1580,42501,42501,1634,42501,1,2
NE,7190,33222,0,961,5109,379,759,180,197,0,D,90,5109,485619,39620,407151,7190,1900,149,419,2235,40412,40412,2654,40412,4,0
NH,2843,27829,532,113,308,379,97,180,197,1165,B,114,308,485619,39620,407151,2843,1900,149,103,1763,31204,30672,1866,30672,3,1
NJ,135454,163305,553,4605,5109,1439,759,1089,197,15642,A+,8952,5109,485619,39620,407151,135454,1900,149,1819,4282,299312,298759,6101,298759,151,0
NM,4493,84539,0,197,760,379,759,180,197,1125,C,172,760,485619,39620,407151,4493,1900,149,202,3146,89032,89032,3348,89032,3,73
NV,5884,47460,0,961,5109,379,759,180,197,205,D,328,5109,65544,39620,407151,5884,1900,149,118,1869,53344,53344,1987,53344,8,0
NY,330407,791136,0,8196,82730,2811,759,2295,197,56378,B,21045,82730,485619,39620,407151,330407,1900,149,2758,28869,1121543,1121543,31627,1121543,217,533
OH,23016,161300,0,1060,4218,393,1188,274,197,0,B,1306,4218,485619,39620,407151,21969,1185,121,885,7372,184316,184316,8257,184316,35,78
OK,4424,85433,0,228,805,96,759,180,197,3064,A+,266,805,89857,4779,85078,38775,1900,149,94,2876,89857,89857,2970,89857,6,0
OR,3068,69625,0,159,659,42,759,18,197,1125,A+,124,659,485619,39620,407151,3032,1900,149,79,2156,72693,72693,2235,72693,3,14
PA,54238,216321,0,2342,5109,379,759,517,197,0,C,3616,5109,485619,39620,407151,38775,1900,149,1323,6448,270559,270559,7771,270559,200,0
PR,2156,,0,161,5109,379,759,10,197,0,C,107,5109,485619,39620,407151,1029,1900,149,125,0,2156,2156,125,2156,5,0
RI,11141,64338,0,312,1187,71,759,52,197,730,A+,399,1187,93190,13103,80087,11141,1900,149,231,1691,75479,75479,1922,75479,11,34
SC,7142,66300,0,961,1152,379,759,180,197,3816,B,316,1152,485619,39620,407151,38775,1900,149,206,-4246,73442,73442,-4040,73442,11,0
SD,3144,18149,0,76,247,379,759,180,197,2069,C,31,247,485619,39620,407151,38775,1900,149,239,940,21293,21293,1179,21293,0,11
TN,14441,229137,0,550,1299,379,759,180,197,7011,B,241,1299,485619,39620,407151,14441,1900,149,345,6905,243578,243578,7250,243578,4,33
TX,36609,440509,0,1734,5109,379,759,180,197,19197,B,1004,5109,485619,39620,407151,36609,1900,149,1219,20737,477118,477118,21956,477118,31,0
UT,5919,132769,0,216,488,379,162,180,73,2769,B,61,488,485619,39620,407151,5919,1900,149,195,3950,138688,138688,4145,138688,0,12
VA,22342,107603,549,1625,4622,378,759,199,197,2997,A+,812,4622,143220,39620,407151,21274,787,25,772,6021,130494,129945,6793,129945,43,184
VI,68,1024,36,961,5109,379,759,180,197,57,C,4,5109,485619,39620,407151,38775,1900,149,2,34,1128,1092,36,1092,0,0
VT,918,17222,0,15,5109,379,759,180,197,737,B,53,5109,485619,39620,407151,919,1900,149,2,532,18140,18140,534,18140,0,0
WA,18124,221418,0,393,5109,122,759,180,197,0,B,891,5109,485619,39620,407151,17519,1900,149,210,4965,239542,239542,5175,239542,21,0
WI,11030,97265,204,552,1767,110,441,180,197,4694,A+,384,1767,485619,39620,407151,9590,1900,149,409,4230,108499,108295,4639,108295,10,35
WV,1310,58126,0,65,5109,19,759,11,197,761,C,51,5109,485619,39620,407151,1310,1900,149,23,1892,59436,59436,1915,59436,0,0
WY,635,11403,0,9,60,379,759,180,197,428,C,7,60,12968,39620,407151,483,1900,149,4,0,12038,12038,4,12038,0,1
AK,374,23967,0,12,5109,379,759,180,197,291,C,10,5109,24341,39620,407151,374,1900,149,2,684,24341,24341,686,24341,0,0
AL,8898,106275,0,502,1178,379,448,180,266,0,B,349,1178,485619,39620,407151,8898,1900,149,317,5340,115173,115173,5657,115173,9,20
AR,3611,56384,0,69,462,379,759,14,93,2123,B,87,462,485619,39620,407151,3611,1900,149,43,949,59995,59995,992,59995,2,9
AS,0,83,0,961,5109,379,759,180,197,0,F,0,5109,485619,39620,407151,0,1900,149,0,0,83,83,0,83,0,0
AZ,9945,86489,0,766,2292,288,759,196,197,1722,A+,450,2292,96434,39620,407151,38775,1900,149,238,4459,96434,96434,4697,96434,24,48
CA,60614,782260,0,4560,5109,1374,759,180,197,0,B,2504,5109,842874,39620,407151,60614,1900,149,1799,32039,842874,842874,33838,842874,92,0
CO,17830,73517,0,798,2986,379,759,180,197,2869,B,921,2986,485619,39620,407151,16012,1900,149,466,4905,91347,91347,5371,91347,18,67
CT,31784,84390,0,1385,9389,379,759,180,197,5413,B,2797,9389,120541,39620,407151,38775,2339,149,789,3938,116174,116174,4727,116174,79,1631
DC,5654,20202,0,447,5109,130,759,91,197,825,A+,285,5109,485619,39620,407151,38775,1900,149,193,679,25856,25856,872,25856,8,0
DE,5939,21387,0,285,5109,379,759,180,197,2110,B,285,5109,485619,39620,407151,38775,253,32,161,697,27326,27326,858,27326,16,0
FL,38828,454122,1499,961,6990,379,759,180,197,0,C,1667,6990,485619,39620,407151,38828,1900,149,826,12073,494449,492950,12899,492950,62,214
GA,31439,185864,0,1309,5835,379,1374,180,197,0,A,1336,5835,204137,39620,407151,31439,1900,149,743,12423,217303,217303,13166,217303,25,70
GU,151,3564,0,961,5109,379,759,180,197,123,F,5,5109,485619,39620,407151,147,1900,149,0,88,3715,3715,88,3715,0,0
HI,626,34915,0,961,74,379,759,180,197,558,B,17,74,485619,39620,407151,38775,1900,149,1,341,35541,35541,342,35541,0,1
IA,11059,55368,0,417,5109,151,759,107,197,4266,A+,231,5109,485619,39620,407151,11059,1900,149,655,2601,66427,66427,3256,66427,12,0
ID,2158,28732,0,20,205,379,86,180,197,1399,B,66,205,30718,39620,407151,1986,1900,149,31,314,30890,30890,345,30890,1,2
IL,70873,308170,0,4862,5109,1253,759,766,197,0,A,3111,5109,485619,39620,407151,70873,1900,149,2641,15142,379043,379043,17783,379043,137,0
IN,22503,102279,0,1457,5109,487,759,228,197,0,A+,1414,5109,485619,39620,407151,38775,1900,149,633,3653,124782,124782,4286,124782,37,0
KS,6144,38678,0,961,587,379,218,180,97,323,A,147,587,485619,39620,407151,38775,1900,149,410,2298,44822,44822,2708,44822,3,16
KY,5934,72672,0,351,1616,190,693,180,197,2125,A,283,1616,485619,39620,407151,5931,1900,149,112,17480,78606,78606,17592,78606,8,13
LA,30652,170115,0,1432,5109,379,759,189,197,20316,B,2208,5109,485619,39620,407151,38775,1926,149,253,5842,200767,200767,6095,200767,93,0
MA,73721,277911,0,3436,7237,852,759,180,197,0,A,4552,7237,485619,39620,407151,73721,1900,149,1696,10297,351632,351632,11993,351632,132,157
MD,29374,119226,0,1683,5663,584,759,180,197,2029,A,1580,5663,485619,39620,407151,29374,1500,80,1211,3377,148600,148600,4588,148600,60,166
ME,1330,22092,0,39,192,16,759,11,197,787,B,62,192,485619,39620,407151,1231,1900,149,76,0,23422,23422,76,23422,0,1
MI,51731,236184,0,1697,5109,753,759,612,197,15659,A+,4925,5109,295016,58832,236184,49565,4772,211,600,11621,287915,287915,12221,287915,86,0
MN,12328,97244,0,435,1459,182,512,180,197,4800,A,508,1459,109572,39620,407151,9365,1900,149,818,4197,109572,109572,5015,109572,23,54
MO,9341,94281,0,917,5109,379,759,141,197,0,B,418,5109,109282,11048,98025,9341,1900,149,239,2636,103622,103622,2875,103622,22,0
MP,15,1783,0,961,5109,379,759,180,197,12,D,2,5109,1797,39620,407151,15,1900,149,0,0,1798,1798,0,1798,0,0
MS,8686,72101,0,650,1442,139,759,71,197,4421,A,396,1442,485619,39620,407151,8686,1900,149,262,0,80787,80787,262,80787,22,50
MT,456,19791,0,6,62,379,759,180,197,417,C,16,62,485619,39620,407151,456,1900,149,0,543,20247,20247,543,20247,0,0
NC,13397,157931,0,525,5109,379,759,180,197,0,B,507,5109,485619,39620,407151,13397,1900,149,639,6207,171328,171328,6846,171328,30,0
ND,1371,39496,0,35,102,379,759,180,197,601,C,23,102,485619,39620,407151,1371,23,149,48,2187,40867,40867,2235,40867,1,5
NE,6771,30987,0,961,5109,379,759,180,197,0,D,86,5109,485619,39620,407151,6771,1900,149,333,1297,37758,37758,1630,37758,4,0
NH,2740,26066,345,113,307,379,82,180,197,1110,B,111,307,485619,39620,407151,2740,1900,149,104,969,29151,28806,1073,28806,19,12
NJ,133635,159023,552,4996,5109,1470,759,1107,197,15642,A+,8801,5109,485619,39620,407151,133635,1900,149,1745,1993,293210,292658,3738,292658,252,0
NM,4291,81393,0,193,687,379,759,180,197,1073,C,169,687,485619,39620,407151,4291,1900,149,153,2280,85684,85684,2433,85684,7,0
NV,5766,45591,0,961,5109,379,759,180,197,205,D,320,5109,63708,39620,407151,5766,1900,149,103,1979,51357,51357,2082,51357,9,0
NY,327649,762267,0,8665,82197,2976,759,2425,197,55547,B,20828,82197,485619,39620,407151,327649,1900,149,3671,30324,1089916,1089916,33995,1089916,951,627
OH,22131,153928,0,1057,4140,418,1167,279,197,0,B,1271,4140,485619,39620,407151,21132,1153,118,555,6575,176059,176059,7130,176059,46,88
OK,4330,82557,0,223,805,97,759,180,197,2985,A+,260,805,87459,4698,82557,38775,1900,149,129,3868,86887,86887,3997,86887,7,32
OR,2989,67469,0,171,645,48,759,23,197,1125,A+,121,645,485619,39620,407151,2957,1900,149,73,2409,70458,70458,2482,70458,6,4
PA,52915,209873,0,2420,5109,379,759,539,197,0,C,3416,5109,485619,39620,407151,38775,1900,149,1070,5378,262788,262788,6448,262788,310,0
PR,2031,,0,164,5109,379,759,180,197,0,D,102,5109,485619,39620,407151,1013,1900,149,63,0,2031,2031,63,2031,3,0
RI,10910,62647,0,318,1153,82,759,56,197,696,A+,388,1153,90357,12764,77593,10910,1900,149,271,1929,73557,73557,2200,73557,18,30
SC,6936,70546,0,961,1152,379,759,180,197,3816,B,305,1152,485619,39620,407151,38775,1900,149,0,0,77482,77482,0,77482,0,0
SD,2905,17209,0,70,236,379,759,180,197,2028,C,31,236,485619,39620,407151,38775,1900,149,126,572,20114,20114,698,20114,2,6
TN,14096,222232,0,558,1266,379,759,180,197,6783,B,237,1266,485619,39620,407151,14096,1900,149,158,9069,236328,236328,9227,236328,-2,45
TX,35390,419772,0,1750,5109,379,759,180,197,18440,B,973,5109,485619,39620,407151,35390,1900,149,968,15256,455162,455162,16224,455162,25,0
UT,5724,128819,0,194,476,379,159,180,73,2640,B,61,476,485619,39620,407151,5724,1900,149,129,3412,134543,134543,3541,134543,3,12
VA,21570,101582,519,1613,4438,371,759,203,197,2825,A+,769,4438,136558,39620,407151,20537,745,24,1314,8130,123671,123152,9444,123152,56,325
VI,66,990,37,961,5109,379,759,180,197,54,C,4,5109,485619,39620,407151,38775,1900,149,0,0,1093,1056,0,1056,0,0
VT,916,16690,0,14,5109,2,759,0,197,718,B,53,5109,485619,39620,407151,916,1900,149,2,409,17606,17606,411,17606,1,0
WA,17914,216453,0,358,5109,144,759,180,197,0,B,870,5109,485619,39620,407151,17269,1900,149,196,4388,234367,234367,4584,234367,8,0
WI,10621,93035,219,624,1732,108,435,180,197,4520,A+,374,1732,485619,39620,407151,9215,1900,149,359,5209,103875,103656,5568,103656,12,38
WV,1287,56234,0,76,5109,22,759,12,197,716,C,51,5109,485619,39620,407151,1287,1900,149,39,1698,57521,57521,1737,57521,1,0
WY,631,11403,0,11,59,379,759,180,197,416,C,7,59,12569,39620,407151,479,1900,149,27,0,12034,12034,27,12034,0,-1
AK,372,23283,0,8,5109,379,759,180,197,284,C,10,5109,23655,39620,407151,372,1900,149,1,962,23655,23655,963,23655,1,0
AL,8581,100935,0,485,1158,379,442,180,264,0,B,340,1158,485619,39620,407151,8581,1900,149,296,2454,109516,109516,2750,109516,27,51
AR,3568,55435,0,69,453,379,759,14,89,2109,B,85,453,485619,39620,407151,3568,1900,149,72,4296,59003,59003,4368,59003,2,0
AS,0,83,0,961,5109,379,759,180,197,0,F,0,5109,485619,39620,407151,0,1900,149,0,0,83,83,0,83,0,0
AZ,9707,82030,0,754,2244,286,759,193,197,1693,A+,426,2244,91737,39620,407151,38775,1900,149,402,3075,91737,91737,3477,91737,31,52
CA,58815,750221,0,4681,5109,1415,759,180,197,0,B,2412,5109,809036,39620,407151,58815,1900,149,2603,26531,809036,809036,29134,809036,95,0
CO,17364,68612,0,792,2919,379,759,180,197,2801,B,903,2919,485619,39620,407151,15600,1900,149,457,515,85976,85976,972,85976,52,81
CT,30995,80452,0,1445,7758,379,759,180,197,4346,B,2718,7758,116174,39620,407151,38775,2339,149,374,2430,111447,111447,2804,111447,85,0
DC,5461,19523,0,447,5109,130,759,91,197,808,A+,277,5109,485619,39620,407151,38775,1900,149,139,516,24984,24984,655,24984,13,0
DE,5778,20690,0,299,5109,379,759,180,197,2008,B,269,5109,485619,39620,407151,38775,237,32,407,1381,26468,26468,1788,26468,3,0
FL,38002,442049,1351,961,6776,379,759,180,197,0,C,1605,6776,485619,39620,407151,38002,1900,149,563,13797,481402,480051,14360,480051,69,230
GA,30696,173441,0,1339,5765,379,1343,180,197,0,A,1311,5765,204137,39620,407151,30696,1900,149,985,2269,204137,204137,3254,204137,23,131
GU,151,3476,0,961,5109,379,759,180,197,123,F,5,5109,485619,39620,407151,147,1900,149,2,135,3627,3627,137,3627,0,0
HI,625,34574,0,961,73,379,759,180,197,551,B,17,73,485619,39620,407151,38775,1900,149,4,1196,35199,35199,1200,35199,0,0
IA,10404,52767,0,414,5109,151,759,103,197,3803,B,219,5109,485619,39620,407151,10404,1900,149,293,2309,63171,63171,2602,63171,12,0
ID,2127,28418,0,21,203,379,84,180,197,1379,C,65,203,30375,39620,407151,1957,1900,149,21,216,30545,30545,237,30545,1,2
IL,68232,293028,0,4832,5109,1231,759,780,197,0,A,2974,5109,485619,39620,407151,68232,1900,149,2270,12704,361260,361260,14974,361260,136,0
IN,21870,98626,0,1558,5109,526,759,281,197,0,A+,1377,5109,485619,39620,407151,38775,1900,149,837,3825,120496,120496,4662,120496,51,0
KS,5734,36380,0,961,571,379,213,180,96,318,A,144,571,485619,39620,407151,38775,1900,149,276,1746,42114,42114,2022,42114,7,5
KY,5822,55192,0,347,1603,189,685,180,197,2058,A,275,1603,485619,39620,407151,5821,1900,149,577,390,61014,61014,967,61014,14,74
LA,30399,164273,0,1465,5109,379,759,187,197,20316,B,2115,5109,485619,39620,407151,38775,1907,149,403,6038,194672,194672,6441,194672,0,0
MA,72025,267614,0,3564,7080,922,759,180,197,0,A,4420,7080,485619,39620,407151,72025,1900,149,1754,4536,339639,339639,6290,339639,208,249
MD,28163,115849,0,1707,5497,584,759,180,197,1903,A,1520,5497,485619,39620,407151,28163,1444,76,1046,2863,144012,144012,3909,144012,44,160
ME,1254,22092,0,37,191,18,759,12,197,766,B,62,191,485619,39620,407151,1174,1900,149,28,2546,23346,23346,2574,23346,1,4
MI,51131,224563,0,1818,5109,794,759,617,197,15659,A+,4839,5109,282451,57888,224563,49064,4714,209,634,11472,275694,275694,12106,275694,58,0
MN,11510,93047,0,443,1405,180,488,180,197,4520,A,485,1405,104557,39620,407151,8579,1900,149,634,3845,104557,104557,4479,104557,30,55
MO,9102,91645,0,953,5109,379,759,134,197,0,B,396,5109,104488,10719,93577,9102,1900,149,186,5495,100747,100747,5681,100747,19,0
MP,15,1783,0,961,5109,379,759,180,197,12,D,2,5109,1797,39620,407151,15,1900,149,1,0,1798,1798,1,1798,0,0
MS,8424,72101,0,618,1392,144,759,79,197,4421,B,374,1392,485619,39620,407151,8424,1900,149,217,0,80525,80525,217,80525,32,40
MT,456,19248,0,6,62,379,759,180,197,417,C,16,62,485619,39620,407151,456,1900,149,0,4432,19704,19704,4432,19704,0,0
NC,12758,151724,0,516,5109,379,759,180,197,0,B,477,5109,485619,39620,407151,12758,1900,149,502,12180,164482,164482,12682,164482,25,0
ND,1323,37309,0,32,97,379,759,180,197,582,C,22,97,485619,39620,407151,1323,22,149,57,2154,38632,38632,2211,38632,5,2
NE,6438,29690,0,961,5109,379,759,180,197,0,D,82,5109,485619,39620,407151,6438,1900,149,355,1164,36128,36128,1519,36128,4,0
NH,2636,25097,79,115,295,379,82,180,197,1105,B,92,295,485619,39620,407151,2636,1900,149,48,815,27812,27733,863,27733,6,9
NJ,131890,157030,594,5221,5109,1549,759,1146,197,15642,A+,8549,5109,485619,39620,407151,131890,1900,149,1297,0,289514,288920,1297,288920,305,0
NM,4138,79113,0,178,687,379,759,180,197,964,C,162,687,485619,39620,407151,4138,1900,149,107,1424,83251,83251,1531,83251,6,20
NV,5663,43612,0,961,5109,379,759,180,197,203,D,311,5109,61090,39620,407151,5663,1900,149,69,1322,49275,49275,1391,49275,14,0
NY,323978,731943,0,9179,81570,3098,759,180,197,54597,B,19877,81570,485619,39620,407151,321192,1900,149,2786,24236,1055921,1055921,27022,1055921,232,652
OH,21576,147353,0,1045,4052,407,1151,275,197,0,B,1225,4052,485619,39620,407151,20625,1114,111,607,7587,168929,168929,8194,168929,90,96
OK,4201,78689,0,230,773,102,759,180,197,2909,A,253,773,83401,4538,78689,38775,1900,149,74,3399,82890,82890,3473,82890,6,0
OR,2916,65060,0,191,641,47,759,20,197,1125,A+,115,641,485619,39620,407151,2887,1900,149,77,2475,67976,67976,2552,67976,2,19
PA,51845,204495,0,2545,5109,379,759,560,197,0,C,3106,5109,485619,39620,407151,38775,1900,149,888,4570,256340,256340,5458,256340,94,0
PR,1968,,0,144,5109,379,759,180,197,0,D,99,5109,485619,39620,407151,1006,1900,149,44,-9313,1968,1968,-9269,1968,0,0
RI,10639,60718,0,324,1123,86,759,60,197,665,A+,370,1123,87037,12348,74689,10639,1900,149,342,1937,71357,71357,2279,71357,15,31
SC,6936,70546,0,961,1152,379,759,180,197,3816,B,305,1152,485619,39620,407151,38775,1900,149,179,9532,77482,77482,9711,77482,22,42
SD,2779,16637,0,72,230,379,759,180,197,1977,C,29,230,485619,39620,407151,38775,1900,149,58,336,19416,19416,394,19416,5,10
TN,13938,213163,0,557,1221,379,759,180,197,6564,B,239,1221,485619,39620,407151,13938,1900,149,248,7991,227101,227101,8239,227101,13,65
TX,34422,404516,0,1812,5109,379,759,180,197,17622,B,948,5109,485619,39620,407151,34422,1900,149,1053,10675,438938,438938,11728,438938,42,0
UT,5595,125407,0,961,464,379,759,180,197,2509,C,58,464,485619,39620,407151,5595,1900,149,146,4141,131002,131002,4287,131002,2,8
VA,20256,93452,469,1496,4113,361,759,189,197,2617,A+,713,4113,127938,39620,407151,19357,690,23,0,0,114177,113708,0,113708,0,0
VI,66,990,37,961,5109,379,759,180,197,54,C,4,5109,485619,39620,407151,38775,1900,149,0,17,1093,1056,17,1056,0,0
VT,914,16281,0,26,5109,2,759,0,197,706,B,52,5109,485619,39620,407151,908,1900,149,5,216,17195,17195,221,17195,0,0
WA,17718,212065,0,390,5109,127,759,180,197,0,B,862,5109,485619,39620,407151,17012,1900,149,248,5051,229783,229783,5299,229783,21,0
WI,10262,87826,212,511,1694,107,423,180,197,4348,A+,362,1694,485619,39620,407151,8901,1900,149,366,3859,98300,98088,4225,98088,9,31
WV,1248,54536,0,76,5109,22,759,12,197,716,C,50,5109,485619,39620,407151,1248,1900,149,10,951,55784,55784,961,55784,0,0
WY,604,11403,0,11,60,379,759,180,197,409,C,7,60,12306,39620,407151,452,1900,149,8,1084,12007,12007,1092,12007,0,0
AK,371,22321,0,13,5109,379,759,180,197,277,C,9,5109,22692,39620,407151,371,1900,149,1,968,22692,22692,969,22692,0,0
AL,8285,98481,0,522,1107,379,428,180,255,0,B,313,1107,485619,39620,407151,8285,1900,149,260,3389,106766,106766,3649,106766,17,43
AR,3496,51139,0,89,453,379,759,16,89,2041,B,83,453,485619,39620,407151,3496,1900,149,38,155,54635,54635,193,54635,2,15
AS,0,83,0,961,5109,379,759,180,197,0,F,0,5109,485619,39620,407151,0,1900,149,0,0,83,83,0,83,0,0
AZ,9305,78955,0,728,2192,303,759,185,197,1671,A+,395,2192,88260,39620,407151,38775,1900,149,386,2621,88260,88260,3007,88260,33,57
CA,56212,723690,0,4622,5109,1388,759,180,197,0,B,2317,5109,779902,39620,407151,56212,1900,149,1275,30753,779902,779902,32028,779902,63,0
CO,16907,68097,0,834,2838,379,759,180,197,2743,B,851,2838,485619,39620,407151,15169,1900,149,272,1642,85004,85004,1914,85004,9,39
CT,30621,78022,0,1500,7758,379,759,180,197,4346,B,2633,7758,111447,39620,407151,38775,2257,149,1334,4816,108643,108643,6150,108643,138,0
DC,5322,19007,0,447,5109,130,759,91,197,667,A+,264,5109,485619,39620,407151,38775,1900,149,152,382,24329,24329,534,24329,6,0
DE,5371,19309,0,284,5109,379,759,180,197,1847,B,266,5109,485619,39620,407151,38775,235,31,83,487,24680,24680,570,24680,11,0
FL,37439,428252,1265,961,6546,379,759,180,197,0,C,1536,6546,485619,39620,407151,37439,1900,149,542,20879,466956,465691,21421,465691,113,217
GA,29711,171172,0,1343,5634,379,1318,180,197,0,A,1288,5634,200814,39620,407151,29711,1900,149,343,17215,200883,200883,17558,200883,66,108
GU,149,3341,0,961,5109,379,759,180,197,124,F,5,5109,485619,39620,407151,145,1900,149,0,99,3490,3490,99,3490,0,0
HI,621,33378,0,961,73,379,759,180,197,548,B,17,73,485619,39620,407151,38775,1900,149,1,132,33999,33999,133,33999,0,0
IA,10111,50458,0,407,5109,152,759,94,197,3572,B,207,5109,485619,39620,407151,10111,1900,149,408,3000,60569,60569,3408,60569,19,0
ID,2106,28202,0,27,201,379,83,180,197,1358,C,64,201,30146,39620,407151,1944,1900,149,45,456,30308,30308,501,30308,0,1
IL,65962,280324,0,4780,5109,1266,759,780,197,0,A,2838,5109,485619,39620,407151,65962,1900,149,2122,11017,346286,346286,13139,346286,176,0
IN,21033,94801,0,1537,5109,480,759,272,197,0,A+,1326,5109,485619,39620,407151,38775,1900,149,526,2011,115834,115834,2537,115834,62,0
KS,5458,34634,0,961,566,379,212,180,95,296,A,137,566,485619,39620,407151,38775,1900,149,213,1276,40092,40092,1489,40092,1,13
KY,5245,54802,0,333,1529,174,659,180,197,1892,A,261,1529,485619,39620,407151,5244,1900,149,115,1523,60047,60047,1638,60047,8,10
LA,29996,158235,0,1512,5109,379,759,194,197,20316,B,2115,5109,485619,39620,407151,38775,1884,149,323,6977,188231,188231,7300,188231,51,0
MA,70271,263078,0,3542,6831,914,759,180,197,0,A,4212,6831,485619,39620,407151,70271,1900,149,1184,7897,333349,333349,9081,333349,122,209
MD,27117,112986,0,1693,5337,573,759,180,197,1810,A,1476,5337,485619,39620,407151,27117,1402,74,709,2399,140103,140103,3108,140103,52,138
ME,1226,19546,0,36,187,18,759,12,197,741,B,61,187,485619,39620,407151,1150,1900,149,21,0,20772,20772,21,20772,4,1
MI,50497,213091,0,1948,5109,839,759,670,197,15659,A+,4781,5109,269955,56864,213091,48572,4630,208,688,10420,263588,263588,11108,263588,59,0
MN,10876,89202,0,434,1350,182,475,180,197,4159,A,455,1350,100078,39620,407151,7851,1900,149,641,2525,100078,100078,3166,100078,27,79
MO,8916,86150,0,893,5109,379,759,139,197,0,A,377,5109,100383,10407,89800,8916,1900,149,162,3453,95066,95066,3615,95066,19,0
MP,14,1783,0,961,5109,379,759,180,197,12,D,2,5109,485619,39620,407151,14,1900,149,0,462,1797,1797,462,1797,0,0
MS,8207,72101,0,645,1352,162,759,77,197,4421,B,342,1352,485619,39620,407151,8207,1900,149,330,301,80308,80308,631,80308,32,36
MT,456,14816,0,6,62,379,759,180,197,410,C,16,62,485619,39620,407151,456,1900,149,-1,185,15272,15272,184,15272,0,0
NC,12256,139544,0,534,5109,379,759,180,197,0,B,452,5109,485619,39620,407151,12256,1900,149,408,4953,151800,151800,5361,151800,22,0
ND,1266,35155,0,31,95,379,759,180,197,559,C,17,95,485619,39620,407151,1266,17,149,41,1626,36421,36421,1667,36421,2,1
NE,6083,28526,0,961,5109,379,759,180,197,0,D,78,5109,485619,39620,407151,6083,1900,149,173,682,34609,34609,855,34609,0,0
NH,2588,24282,79,111,286,379,82,180,197,1019,C,86,286,485619,39620,407151,2588,1900,149,0,0,26949,26870,0,26870,0,0
NJ,130593,157030,550,5328,5109,1534,759,1169,197,15642,A+,8244,5109,485619,39620,407151,130593,1900,149,2324,8079,288173,287623,10403,287623,334,0
NM,4031,77689,0,181,667,379,759,180,197,842,C,156,667,485619,39620,407151,4031,1900,149,181,3562,81720,81720,3743,81720,5,80
NV,5594,42290,0,961,5109,379,759,180,197,200,D,297,5109,59437,39620,407151,5594,1900,149,103,1615,47884,47884,1718,47884,5,0
NY,321192,707707,0,9600,80918,3281,759,180,197,58950,B,19645,80918,485619,39620,407151,321192,1900,149,2239,19350,1028899,1028899,21589,1028899,230,542
OH,20969,139766,0,1069,3956,402,1123,281,197,0,B,1135,3956,485619,39620,407151,20072,1038,97,495,5085,160735,160735,5580,160735,79,147
OK,4127,75290,0,236,773,113,759,180,197,2830,A,247,773,79892,4430,75290,38775,1900,149,83,15486,79417,79417,15569,79417,9,20
OR,2839,62585,0,219,622,49,759,25,197,860,A+,113,622,485619,39620,407151,2817,1900,149,80,1887,65424,65424,1967,65424,4,14
PA,50957,199925,0,2580,5109,379,759,550,197,0,B,3012,5109,485619,39620,407151,38775,1900,149,865,4427,250882,250882,5292,250882,554,0
PR,1924,9313,0,140,5109,379,759,180,197,0,D,99,5109,485619,39620,407151,1005,1900,149,81,0,11237,11237,81,11237,2,0
RI,10297,58781,0,327,1092,89,759,62,197,639,A+,355,1092,83711,11858,71853,10297,1900,149,303,1979,69078,69078,2282,69078,14,31
SC,6757,61014,0,961,1110,379,759,180,197,3622,B,283,1110,485619,39620,407151,38775,1900,149,131,3452,67771,67771,3583,67771,8,0
SD,2721,16301,0,75,220,379,759,180,197,1895,C,24,220,485619,39620,407151,38775,1900,149,53,256,19022,19022,309,19022,3,9
TN,13690,205172,0,520,1156,379,759,180,197,6356,B,226,1156,485619,39620,407151,13624,1900,149,119,7300,218862,218862,7419,218862,7,13
TX,33369,393841,0,1888,5109,379,759,180,197,16791,B,906,5109,485619,39620,407151,33369,1900,149,1037,18775,427210,427210,19812,427210,22,0
UT,5449,121266,0,961,456,379,759,180,197,2387,C,56,456,485619,39620,407151,5449,1900,149,132,1922,126715,126715,2054,126715,6,15
VA,20256,93452,469,1496,4113,361,759,189,197,2617,A+,713,4113,127938,39620,407151,19357,690,23,764,651,114177,113708,1415,113708,29,103
VI,66,973,34,961,5109,379,759,180,197,51,C,4,5109,485619,39620,407151,38775,1900,149,0,8,1073,1039,8,1039,0,0
VT,909,16065,0,33,5109,2,759,0,197,0,B,52,5109,485619,39620,407151,907,1900,149,3,176,16974,16974,179,16974,0,0
WA,17470,207014,0,292,5109,102,759,180,197,0,B,841,5109,485619,39620,407151,16726,1900,149,261,4808,224484,224484,5069,224484,7,0
WI,9896,83967,236,543,1663,92,414,180,197,4131,A,353,1663,485619,39620,407151,8566,1900,149,358,3500,94099,93863,3858,93863,13,42
WV,1238,53585,0,64,5109,23,759,12,197,630,C,50,5109,485619,39620,407151,1238,1900,149,32,1552,54823,54823,1584,54823,0,0
WY,596,10319,0,13,60,379,759,180,197,405,C,7,60,11996,479,11517,444,1900,149,10,451,10915,10915,461,10915,0,0
AK,370,21353,0,12,5109,379,759,180,197,263,C,9,5109,21723,39620,407151,370,1900,149,2,143,21723,21723,145,21723,0,0
AL,8025,95092,0,517,1064,379,411,180,247,0,B,296,1064,485619,39620,407151,8025,1900,149,300,10317,103117,103117,10617,103117,6,29
AR,3458,50984,0,91,438,379,759,16,88,2016,B,81,438,485619,39620,407151,3458,1900,149,27,1525,54442,54442,1552,54442,5,11
AS,0,83,0,961,5109,379,759,180,197,0,F,0,5109,485619,39620,407151,0,1900,149,0,26,83,83,26,83,0,0
AZ,8919,76334,0,703,2135,288,759,200,197,1632,A+,362,2135,85253,39620,407151,38775,1900,149,279,3855,85253,85253,4134,85253,0,46
CA,54937,692937,0,4616,5109,1464,759,180,197,0,B,2254,5109,747874,39620,407151,54937,1900,149,1321,30802,747874,747874,32123,747874,39,0
CO,16635,66455,0,883,2799,379,759,180,197,2650,B,842,2799,485619,39620,407151,14897,1900,149,410,2774,83090,83090,3184,83090,10,6
CT,29287,73206,0,1488,7758,379,759,180,197,4346,B,2495,7758,108643,39620,407151,38775,2168,149,0,0,102493,102493,0,102493,59,0
DC,5170,18625,0,447,5109,130,759,91,197,666,A+,258,5109,485619,39620,407151,38775,1900,149,154,539,23795,23795,693,23795,7,0
DE,5288,18822,0,281,5109,379,759,180,197,1716,B,255,5109,485619,39620,407151,38775,226,29,80,293,24110,24110,373,24110,9,0
FL,36897,407373,1181,961,6329,379,759,180,197,0,C,1423,6329,485619,39620,407151,36897,1900,149,819,15262,445451,444270,16081,444270,20,85
GA,29368,153957,0,1377,5526,379,1284,180,197,0,A,1222,5526,183012,39620,407151,29368,1900,149,766,7463,183325,183325,8229,183325,45,133
GU,149,3242,0,961,5109,379,759,180,197,125,F,5,5109,485619,39620,407151,145,1900,149,-1,90,3391,3391,89,3391,0,0
HI,620,33246,0,961,73,379,759,180,197,544,B,17,73,485619,39620,407151,38775,1900,149,0,916,33866,33866,916,33866,1,1
IA,9703,47458,0,389,5109,143,759,93,197,3486,B,188,5109,485619,39620,407151,9703,1900,149,534,3441,57161,57161,3975,57161,4,0
ID,2061,27746,0,27,200,379,83,180,197,1267,C,64,200,29651,39620,407151,1905,1900,149,0,0,29807,29807,0,29807,1,0
IL,63840,269307,0,4493,5109,1232,759,763,197,0,A,2662,5109,485619,39620,407151,63840,1900,149,2341,11493,333147,333147,13834,333147,44,0
IN,20507,92790,0,1449,5109,483,759,249,197,0,A+,1264,5109,485619,39620,407151,38775,1900,149,574,3864,113297,113297,4438,113297,18,0
KS,5245,33358,0,961,553,379,209,180,95,291,A,136,553,485619,39620,407151,38775,1900,149,215,1610,38603,38603,1825,38603,2,6
KY,5130,53279,0,329,1519,170,654,180,197,1892,A,253,1519,485619,39620,407151,5129,1900,149,251,509,58409,58409,760,58409,5,108
LA,29673,151258,0,1502,5109,379,759,220,197,20316,B,2064,5109,485619,39620,407151,38775,1905,149,333,4438,180931,180931,4771,180931,95,0
MA,69087,255181,0,3539,6622,908,759,180,197,0,A,4090,6622,485619,39620,407151,69087,1900,149,1000,8622,324268,324268,9622,324268,86,115
MD,26408,110587,0,1649,5199,563,759,180,197,1695,A,1424,5199,485619,39620,407151,26408,1353,71,946,3255,136995,136995,4201,136995,52,148
ME,1205,19546,0,37,186,18,759,11,197,720,B,57,186,485619,39620,407151,1136,1900,149,20,0,20751,20751,20,20751,0,3
MI,49809,202671,0,1948,5109,839,759,670,197,15659,A+,4722,5109,258536,55865,202671,48034,4573,206,780,7310,252480,252480,8090,252480,81,0
MN,10235,86677,0,396,1271,166,444,180,197,3784,A,428,1271,96912,39620,407151,7234,1900,149,824,3244,96912,96912,4068,96912,9,72
MO,8754,82697,0,858,5109,379,759,135,197,0,A,358,5109,99201,10319,88708,8754,1900,149,368,8107,91451,91451,8475,91451,6,0
MP,14,1321,0,961,5109,379,759,180,197,12,D,2,5109,485619,39620,407151,14,1900,149,0,0,1335,1335,0,1335,0,0
MS,7877,71800,0,646,1316,145,759,78,197,4421,B,310,1316,485619,39620,407151,7877,1900,149,327,1757,79677,79677,2084,79677,7,18
MT,457,14631,0,6,62,379,759,180,197,404,C,16,62,485619,39620,407151,457,1900,149,2,79,15088,15088,81,15088,0,1
NC,11848,134591,0,498,5109,379,759,180,197,0,B,430,5109,485619,39620,407151,11848,1900,149,184,2420,146439,146439,2604,146439,8,0
ND,1225,33529,0,31,94,379,759,180,197,540,C,15,94,485619,39620,407151,1225,15,149,34,1367,34754,34754,1401,34754,-1,4
NE,5910,27844,0,961,5109,379,759,180,197,0,D,78,5109,485619,39620,407151,5910,1900,149,584,1908,33754,33754,2492,33754,2,0
NH,2588,24282,244,103,286,379,759,180,197,1017,C,86,286,485619,39620,407151,2588,1900,149,159,-1682,27114,26870,-1523,26870,2,9
NJ,128269,148951,647,5287,5109,1610,759,1189,197,15642,A+,7910,5109,485619,39620,407151,128269,1900,149,1525,629,277867,277220,2154,277220,39,0
NM,3850,74127,0,164,587,379,759,180,197,832,C,151,587,485619,39620,407151,3850,1900,149,118,2915,77977,77977,3033,77977,12,0
NV,5491,40675,0,961,5109,379,759,180,197,185,D,292,5109,57274,39620,407151,5491,1900,149,65,832,46166,46166,897,46166,5,0
NY,318953,688357,0,9647,80376,3330,759,180,197,58950,B,19415,80376,485619,39620,407151,318953,1900,149,2538,18861,1007310,1007310,21399,1007310,226,608
OH,20474,134681,0,1078,3809,412,1090,275,197,0,B,1056,3809,485619,39620,407151,19609,975,81,560,4429,155155,155155,4989,155155,18,40
OK,4044,59804,0,236,753,92,759,180,197,2682,A,238,753,70368,4150,66084,38775,1900,149,72,0,63848,63848,72,63848,0,10
OR,2759,60698,0,207,608,41,759,17,197,860,A+,109,608,485619,39620,407151,2745,1900,149,79,1324,63457,63457,1403,63457,0,10
PA,50092,195498,0,2708,5109,379,759,573,197,0,B,2458,5109,485619,39620,407151,38775,1900,149,825,4124,245590,245590,4949,245590,14,0
PR,1843,9313,0,152,5109,379,759,180,197,0,D,97,5109,485619,39620,407151,1001,1900,149,35,0,11156,11156,35,11156,0,0
RI,9994,56802,0,339,1061,84,759,61,197,601,A+,341,1061,80398,11423,68975,9994,1900,149,291,1569,66796,66796,1860,66796,21,48
SC,6626,57562,0,961,1110,379,759,180,197,3622,B,275,1110,485619,39620,407151,38775,1900,149,0,0,64188,64188,0,64188,0,0
SD,2668,16045,0,69,211,379,759,180,197,1830,C,21,211,485619,39620,407151,38775,1900,149,37,259,18713,18713,296,18713,0,14
TN,13571,197872,0,499,1143,379,759,180,197,6081,B,219,1143,485619,39620,407151,13502,1900,149,394,6442,211443,211443,6836,211443,9,8
TX,32332,375066,0,1533,5109,379,759,180,197,16090,B,884,5109,485619,39620,407151,32332,1900,149,784,16054,407398,407398,16838,407398,17,0
UT,5317,119344,0,961,441,379,759,180,197,2342,C,50,441,485619,39620,407151,5317,1900,149,142,2417,124661,124661,2559,124661,0,5
VA,19492,92801,478,1463,4010,348,759,192,197,2547,A+,684,4010,122778,39620,407151,18640,662,22,821,3470,112771,112293,4291,112293,24,100
VI,66,965,15,961,5109,379,759,180,197,51,C,4,5109,485619,39620,407151,38775,1900,149,0,14,1046,1031,14,1031,0,0
VT,906,15889,0,15,5109,379,759,180,197,0,C,52,5109,485619,39620,407151,902,1900,149,5,319,16795,16795,324,16795,0,0
WA,17209,202206,0,263,5109,86,759,180,197,0,B,834,5109,485619,39620,407151,16472,1900,149,266,5244,219415,219415,5510,219415,4,0
WI,9538,80467,226,573,1621,116,404,180,197,3973,A,340,1621,485619,39620,407151,8236,1900,149,311,2470,90231,90005,2781,90005,1,13
WV,1206,52033,0,73,5109,28,759,15,197,611,C,50,5109,485619,39620,407151,1206,1900,149,15,1586,53239,53239,1601,53239,0,0
WY,586,9868,0,13,60,379,759,180,197,391,C,7,60,9976,438,9538,435,1900,149,7,228,10454,10454,235,10454,0,0
AK,368,21210,0,12,5109,379,759,180,197,262,C,9,5109,21578,39620,407151,368,1900,149,3,176,21578,21578,179,21578,0,0
AL,7725,84775,0,427,1035,379,403,180,242,0,B,290,1035,485619,39620,407151,7725,1900,149,291,0,92500,92500,291,92500,2,12
AR,3431,49459,0,100,427,379,759,20,88,1999,B,76,427,485619,39620,407151,3431,1900,149,59,1249,52890,52890,1308,52890,3,13
AS,0,57,0,961,5109,379,759,180,197,0,F,0,5109,485619,39620,407151,0,1900,149,0,0,57,57,0,57,0,0
AZ,8640,72479,0,732,2089,282,759,192,197,1597,A+,362,2089,81119,39620,407151,38775,1900,149,276,2846,81119,81119,3122,81119,14,56
CA,53616,662135,0,4734,5109,1468,759,180,197,0,B,2215,5109,715751,39620,407151,53616,1900,149,1419,27529,715751,715751,28948,715751,44,0
CO,16225,63681,0,883,2793,379,759,180,197,2607,B,832,2793,485619,39620,407151,14498,1900,149,457,2500,79906,79906,2957,79906,12,46
CT,29287,73206,0,1551,7758,379,759,180,197,4346,B,2436,7758,105330,39620,407151,38775,2089,149,523,1713,102493,102493,2236,102493,97,0
DC,5016,18086,0,961,5109,379,759,180,197,666,B,251,5109,485619,39620,407151,38775,1900,149,219,879,23102,23102,1098,23102,11,0
DE,5208,18529,0,284,5109,379,759,180,197,1640,B,246,5109,485619,39620,407151,38775,220,26,170,455,23737,23737,625,23737,11,0
FL,36078,392111,1226,961,6244,379,759,180,197,0,C,1403,6244,485619,39620,407151,36078,1900,149,615,11562,429415,428189,12177,428189,15,299
GA,28602,146494,0,1410,5393,379,1249,180,197,0,A,1177,5393,174800,39620,407151,28602,1900,149,296,0,175096,175096,296,175096,3,6
GU,150,3152,0,961,5109,379,759,180,197,126,F,5,5109,485619,39620,407151,146,1900,149,2,112,3302,3302,114,3302,0,0
HI,620,32330,0,961,72,379,759,180,197,541,B,16,72,485619,39620,407151,38775,1900,149,1,964,32950,32950,965,32950,0,0
IA,9169,44017,0,378,5109,133,759,93,197,3325,B,184,5109,485619,39620,407151,9169,1900,149,528,6309,53186,53186,6837,53186,9,0
ID,2061,27746,0,27,200,379,83,180,197,1267,C,63,200,29651,39620,407151,1905,1900,149,26,291,29807,29807,317,29807,0,22
IL,61499,257814,0,4701,5109,1232,759,759,197,0,A,2618,5109,485619,39620,407151,61499,1900,149,2994,16423,319313,319313,19417,319313,59,0
IN,19933,88926,0,1398,5109,476,759,242,197,0,A+,1246,5109,485619,39620,407151,38775,1900,149,638,4080,108859,108859,4718,108859,17,0
KS,5030,31748,0,961,547,379,209,180,95,286,A,134,547,485619,39620,407151,38775,1900,149,284,1552,36778,36778,1836,36778,3,6
KY,4879,52770,0,334,1411,178,652,180,197,1752,A,248,1411,485619,39620,407151,4878,212,149,0,0,57649,57649,0,57649,0,0
LA,29340,146820,0,1530,5109,379,759,213,197,17303,B,1969,5109,485619,39620,407151,38775,1845,149,200,3102,176160,176160,3302,176160,19,0
MA,68087,246559,0,3617,6507,904,759,180,197,0,A,4004,6507,485619,39620,407151,68087,1900,149,1824,13828,314646,314646,15652,314646,158,129
MD,25462,107332,0,1635,5051,565,759,180,197,1666,A,1372,5051,485619,39620,407151,25462,1302,70,989,6283,132794,132794,7272,132794,49,141
ME,1185,19546,0,33,183,18,759,12,197,706,B,57,183,485619,39620,407151,1185,1900,149,33,0,20731,20731,33,20731,1,2
MI,49029,195361,0,2100,5109,850,759,713,197,15659,A+,4641,5109,250589,55228,195361,47451,4516,205,357,6648,244390,244390,7005,244390,62,0
MN,9411,83433,0,373,1199,155,426,180,197,2596,A,419,1199,92844,39620,407151,6663,1900,149,340,2824,92844,92844,3164,92844,24,40
MO,8386,74590,0,896,5109,379,759,141,197,0,A,352,5109,97614,10227,87215,8386,1900,149,232,0,82976,82976,232,82976,1,0
MP,14,1321,0,961,5109,379,759,180,197,12,D,2,5109,485619,39620,407151,14,1900,149,0,387,1335,1335,387,1335,0,0
MS,7550,70043,0,667,1298,143,759,73,197,3413,B,303,1298,485619,39620,407151,7550,1900,149,109,3009,77593,77593,3118,77593,12,33
MT,455,14552,0,5,61,379,759,180,197,404,C,16,61,485619,39620,407151,455,1900,149,0,372,15007,15007,372,15007,0,0
NC,11664,132171,0,475,5109,379,759,180,197,0,B,422,5109,485619,39620,407151,11664,1900,149,155,4205,143835,143835,4360,143835,2,0
ND,1191,32162,0,31,90,379,759,180,197,517,C,16,90,485619,39620,407151,1191,16,149,38,1768,33353,33353,1806,33353,-8,0
NE,5326,25936,0,961,5109,379,759,180,197,0,D,76,5109,485619,39620,407151,5326,1900,149,488,1426,31262,31262,1914,31262,3,0
NH,2429,25964,220,103,277,379,759,180,197,1107,C,84,277,485619,39620,407151,2429,1900,149,119,3925,28613,28393,4044,28393,3,7
NJ,126744,148322,641,5317,5109,1623,759,1198,197,15642,A+,7871,5109,485619,39620,407151,126744,1900,149,3027,9727,275707,275066,12754,275066,129,0
NM,3732,71212,0,168,587,379,759,180,197,812,C,139,587,485619,39620,407151,3732,1900,149,219,3607,74944,74944,3826,74944,8,0
NV,5426,39843,0,961,5109,379,759,180,197,182,D,287,5109,56203,39620,407151,5426,1900,149,115,767,45269,45269,882,45269,6,0
NY,316415,669496,0,9786,79768,3430,759,180,197,58950,B,19189,79768,485619,39620,407151,316415,1900,149,3438,23402,985911,985911,26840,985911,280,826
OH,19914,130252,0,931,3769,393,1078,255,197,0,B,1038,3769,485619,39620,407151,19094,957,81,579,3768,150166,150166,4347,150166,17,57
OK,3972,59804,0,236,743,92,759,180,197,2635,A,238,743,70368,4150,66084,38775,1900,149,121,0,63776,63776,121,63776,0,0
OR,2680,59374,0,205,598,46,759,21,197,860,A+,109,598,485619,39620,407151,38775,1900,149,45,1873,62054,62054,1918,62054,0,3
PA,49267,191374,0,2645,5109,379,759,562,197,0,B,2444,5109,485619,39620,407151,38775,1900,149,962,4303,240641,240641,5265,240641,26,0
PR,1808,9313,0,171,5109,379,759,180,197,0,D,97,5109,485619,39620,407151,988,53,149,51,0,11121,11121,51,11121,2,0
RI,9703,55233,0,330,1013,83,759,59,197,565,A+,320,1013,77910,11036,66874,9703,1900,149,181,1610,64936,64936,1791,64936,24,36
SC,6626,57562,0,961,1110,379,759,180,197,3622,B,275,1110,485619,39620,407151,38775,1900,149,137,2435,64188,64188,2572,64188,8,0
SD,2631,15786,0,71,197,379,759,180,197,1799,C,21,197,485619,39620,407151,38775,1900,149,43,283,18417,18417,326,18417,0,10
TN,13177,191430,0,510,1135,379,759,180,197,5814,B,210,1135,485619,39620,407151,13177,1900,149,516,7815,204607,204607,8331,204607,1,10
TX,31548,359012,0,1540,5109,379,759,180,197,15544,B,867,5109,485619,39620,407151,31548,1900,149,1026,8886,390560,390560,9912,390560,20,0
UT,5175,116927,0,961,436,379,759,180,197,2238,C,50,436,485619,39620,407151,5175,1900,149,194,4104,122102,122102,4298,122102,1,18
VA,18671,89331,465,1413,3910,385,759,193,197,2497,B,660,3910,119065,39620,407151,17873,644,16,940,4966,108467,108002,5906,108002,44,172
VI,66,951,29,961,5109,379,759,180,197,51,C,4,5109,485619,39620,407151,38775,1900,149,0,29,1046,1017,29,1017,0,0
VT,901,15570,0,19,5109,379,759,180,197,0,C,52,5109,485619,39620,407151,897,1900,149,5,338,16471,16471,343,16471,1,0
WA,16943,196962,0,411,5109,120,759,180,197,0,B,830,5109,485619,39620,407151,16093,1900,149,141,1343,213905,213905,1484,213905,6,0
WI,9227,77997,231,582,1608,118,402,180,197,3723,A+,339,1608,485619,39620,407151,7964,1900,149,307,2427,87455,87224,2734,87224,5,17
WV,1191,50447,0,73,5109,28,759,15,197,611,C,50,5109,485619,39620,407151,1191,1900,149,22,2470,51638,51638,2492,51638,2,0
WY,579,9640,0,13,60,379,759,180,197,391,C,7,60,9976,438,9538,429,1900,149,13,177,10219,10219,190,10219,0,2
AK,365,21034,0,10,5109,379,759,180,197,261,C,9,5109,21399,39620,407151,365,1900,149,1,1073,21399,21399,1074,21399,0,0
AL,7434,84775,0,420,1023,379,335,180,195,0,B,288,1023,485619,39620,407151,7434,1900,149,276,0,92209,92209,276,92209,9,15
AR,3372,48210,0,95,414,379,759,20,85,1987,B,73,414,485619,39620,407151,3372,1900,149,51,1855,51582,51582,1906,51582,9,0
AS,0,57,0,961,5109,379,759,180,197,0,F,0,5109,485619,39620,407151,0,1900,149,0,0,57,57,0,57,0,0
AZ,8364,69633,0,718,2033,291,759,198,197,1565,A+,348,2033,77997,39620,407151,38775,1900,149,402,2716,77997,77997,3118,77997,18,47
CA,52197,634606,0,4722,5109,1433,759,180,197,0,B,2171,5109,685048,39620,407151,52197,1900,149,1755,30063,686803,686803,31818,686803,98,0
CO,15768,61181,0,931,2747,379,759,180,197,2553,B,820,2747,485619,39620,407151,14078,1900,149,484,4075,76949,76949,4559,76949,43,50
CT,28764,71493,0,1592,7758,379,759,180,197,4346,B,2339,7758,102493,39620,407151,38775,1998,149,0,0,100257,100257,0,100257,0,0
DC,4797,17207,0,961,5109,379,759,180,197,666,B,240,5109,485619,39620,407151,38775,1900,149,139,730,22004,22004,869,22004,9,0
DE,5038,18074,0,300,5109,379,759,180,197,1546,B,235,5109,485619,39620,407151,38775,209,26,120,407,23112,23112,527,23112,13,0
FL,35463,380549,0,961,5945,379,759,180,197,0,C,1388,5945,485619,39620,407151,35463,1900,149,735,12578,416012,416012,13313,416012,74,150
GA,28306,146494,0,1440,5387,379,1247,180,197,0,A,1174,5387,174800,39620,407151,28306,1900,149,1036,5397,174800,174800,6433,174800,20,118
GU,148,3040,0,961,5109,379,759,180,197,131,F,5,5109,485619,39620,407151,144,1900,149,2,181,3188,3188,183,3188,0,0
HI,619,31366,0,961,72,379,759,180,197,532,B,16,72,485619,39620,407151,38775,1900,149,1,890,31985,31985,891,31985,0,2
IA,8641,37708,0,353,5109,131,759,90,197,3156,A,175,5109,485619,39620,407151,8641,1900,149,757,0,46349,46349,757,46349,5,0
ID,2035,27455,0,23,178,379,76,180,197,1215,C,63,178,29335,39620,407151,1880,1900,149,20,245,29490,29490,265,29490,0,0
IL,58505,241391,0,4717,5109,1250,759,789,197,0,A,2559,5109,485619,39620,407151,58505,1900,149,2450,12758,299896,299896,15208,299896,102,0
IN,19295,84846,0,1456,5109,487,759,244,197,0,A+,1229,5109,485619,39620,407151,38775,1900,149,665,3837,104141,104141,4502,104141,54,0
KS,4746,30196,0,961,541,379,206,180,95,286,A,131,541,485619,39620,407151,38775,1900,149,297,1611,34942,34942,1908,34942,1,7
KY,4879,52770,0,334,1411,178,652,180,197,1752,A,248,1411,485619,39620,407151,4878,1900,149,171,866,57649,57649,1037,57649,8,36
LA,29140,143718,0,1545,5109,379,759,208,197,17303,B,1950,5109,485619,39620,407151,38775,1801,149,429,4178,172858,172858,4607,172858,23,0
MA,66263,232731,0,3601,6378,921,759,180,197,0,A,3846,6378,485619,39620,407151,66263,1900,149,1952,7406,298994,298994,9358,298994,130,209
MD,24473,101049,0,1657,4910,566,759,180,197,1590,A,1323,4910,485619,39620,407151,24473,1258,65,1001,3538,125522,125522,4539,125522,47,192
ME,1152,19546,0,36,181,19,759,10,197,689,B,56,181,485619,39620,407151,1152,1900,149,29,0,20698,20698,29,20698,1,4
MI,48672,188713,0,2100,5109,850,759,713,197,15659,A+,4579,5109,243366,54653,188713,46783,4436,203,432,9906,237385,237385,10338,237385,59,0
MN,9071,80609,0,389,1159,135,404,180,197,2002,A,395,1159,89680,39620,407151,6228,1900,149,335,3395,89680,89680,3730,89680,24,63
MO,8154,74590,0,896,5109,379,759,141,197,0,A,351,5109,93120,9908,83051,8154,1900,149,319,0,82744,82744,319,82744,14,0
MP,14,934,0,961,5109,379,759,180,197,12,D,2,5109,485619,39620,407151,38775,1900,149,0,185,948,948,185,948,0,0
MS,7441,67034,0,632,1265,142,759,71,197,3413,B,291,1265,485619,39620,407151,7441,1900,149,229,2698,74475,74475,2927,74475,10,39
MT,455,14180,0,5,61,379,759,180,197,404,C,16,61,485619,39620,407151,455,1900,149,2,430,14635,14635,432,14635,0,0
NC,11509,127966,0,502,5109,379,759,180,197,0,B,420,5109,485619,39620,407151,11509,1900,149,586,5057,139475,139475,5643,139475,21,0
ND,1153,30394,0,32,90,379,759,180,197,510,C,24,90,485619,39620,407151,1153,1900,149,46,1976,31547,31547,2022,31547,1,4
NE,4838,24510,0,961,5109,379,759,180,197,0,D,73,5109,485619,39620,407151,4838,1900,149,557,1406,29348,29348,1963,29348,3,0
NH,2310,22039,159,103,270,379,759,180,197,980,C,81,270,485619,39620,407151,2310,1900,149,164,2136,24508,24349,2300,24349,9,8
NJ,123717,138595,676,5713,5109,1715,759,1230,197,15642,A+,7742,5109,485619,39620,407151,123717,1900,149,2527,3240,262988,262312,5767,262312,204,0
NM,3513,67605,0,159,587,379,759,180,197,785,C,131,587,485619,39620,407151,3513,1900,149,102,3147,71118,71118,3249,71118,8,51
NV,5311,39076,0,961,5109,379,759,180,197,182,D,281,5109,54918,39620,407151,5311,1900,149,84,708,44387,44387,792,44387,4,0
NY,312977,646094,0,10350,78942,3501,759,180,197,57540,B,18909,78942,485619,39620,407151,312977,1900,149,4663,26970,959071,959071,31633,959071,299,718
OH,19335,126484,0,1003,3712,424,1066,267,197,0,B,1021,3712,485619,39620,407151,18537,940,81,592,4721,145819,145819,5313,145819,19,78
OK,3851,59804,0,236,743,92,759,180,197,2554,A,238,743,70368,4150,66084,38775,1900,149,103,0,63655,63655,103,63655,8,28
OR,2635,57501,0,209,595,50,759,22,197,0,A,109,595,485619,39620,407151,38775,1900,149,56,1904,60136,60136,1960,60136,5,4
PA,48305,187071,0,2673,5109,379,759,571,197,0,B,2418,5109,485619,39620,407151,38775,1900,149,1334,6594,235376,235376,7928,235376,64,0
PR,1757,9313,0,187,5109,379,759,180,197,0,D,95,5109,485619,39620,407151,973,53,149,182,0,11070,11070,182,11070,3,0
RI,9522,53623,0,333,977,80,759,54,197,531,A+,296,977,75458,10752,64706,9522,1900,149,189,1295,63145,63145,1484,63145,17,40
SC,6489,55127,0,961,1110,379,759,180,197,3622,B,267,1110,59379,39620,407151,6489,1900,149,231,2006,61616,61616,2237,61616,11,0
SD,2588,15503,0,71,187,379,759,180,197,1759,C,21,187,485619,39620,407151,38775,1900,149,63,665,18091,18091,728,18091,0,8
TN,12661,183615,0,474,1125,379,759,180,197,5718,B,209,1125,485619,39620,407151,12661,1900,149,770,9374,196276,196276,10144,196276,5,12
TX,30522,350126,0,1725,5109,379,759,180,197,14891,B,847,5109,485619,39620,407151,30522,1900,149,1293,27580,380648,380648,28873,380648,31,0
UT,4981,112823,0,961,418,379,759,180,197,2185,C,49,418,485619,39620,407151,4981,1900,149,153,5093,117804,117804,5246,117804,3,15
VA,17731,84365,458,1426,3738,375,759,202,197,2312,B,616,3738,485619,39620,407151,16979,607,9,830,-5174,102554,102096,-4344,102096,35,84
VI,66,922,54,961,5109,379,759,180,197,51,C,4,5109,485619,39620,407151,38775,1900,149,0,111,1042,988,111,988,0,0
VT,896,15232,0,11,5109,379,759,180,197,0,C,51,5109,485619,39620,407151,886,1900,149,11,302,16128,16128,313,16128,1,0
WA,16802,195619,0,428,5109,117,759,180,197,0,B,824,5109,485619,39620,407151,16011,1900,149,149,2170,212421,212421,2319,212421,10,0
WI,8920,75570,231,582,1591,118,400,180,197,3698,A+,334,1591,485619,39620,407151,7660,1900,149,370,3004,84721,84490,3374,84490,7,47
WV,1169,47977,0,76,5109,29,759,15,197,572,C,48,5109,485619,39620,407151,1169,1900,149,33,2269,49146,49146,2302,49146,2,0
WY,566,9463,0,13,58,379,759,180,197,387,C,7,58,9976,438,9538,420,1900,149,7,327,10029,10029,334,10029,0,2
AK,364,19961,0,25,5109,379,759,180,197,254,C,9,5109,20325,39620,407151,364,1900,149,9,1197,20325,20325,1206,20325,0,0
AL,7158,84775,0,495,1008,379,335,180,195,0,B,279,1008,485619,39620,407151,7158,1900,149,139,4598,91933,91933,4737,91933,10,30
AR,3321,46355,0,95,414,379,759,23,85,1973,B,64,414,485619,39620,407151,3321,1900,149,66,1231,49676,49676,1297,49676,3,12
AS,0,57,0,961,5109,379,759,180,197,0,F,0,5109,485619,39620,407151,0,1900,149,0,54,57,57,54,57,0,0
AZ,7962,66917,0,709,1986,311,759,187,197,1528,A+,330,1986,74879,39620,407151,38775,1900,149,314,2779,74879,74879,3093,74879,10,49
CA,50442,604543,0,4706,5109,1434,759,180,197,0,B,2073,5109,654985,39620,407151,50442,1900,149,1525,28123,654985,654985,29648,654985,91,0
CO,15284,57106,0,959,2697,379,759,180,197,2486,B,777,2697,485619,39620,407151,13637,1900,149,526,805,72390,72390,1331,72390,11,76
CT,28764,71493,0,1592,7758,379,759,180,197,4346,B,2339,7758,100257,39620,407151,38775,1924,149,1064,2060,100257,100257,3124,100257,82,7758
DC,4658,16477,0,961,5109,379,759,180,197,666,B,231,5109,485619,39620,407151,38775,1900,149,335,721,21135,21135,1056,21135,7,0
DE,4918,17667,0,281,5109,379,759,180,197,1403,B,222,5109,485619,39620,407151,38775,197,25,184,581,22585,22585,765,22585,12,0
FL,34728,367971,0,961,5795,379,759,180,197,0,C,1314,5795,485619,39620,407151,34728,1900,149,1038,19256,402699,402699,20294,402699,24,0
GA,27270,141097,0,1500,5269,379,1215,180,197,0,A,1154,5269,168367,39620,407151,27270,1900,149,1115,18208,168367,168367,19323,168367,34,113
GU,146,2859,0,961,5109,379,759,180,197,131,F,5,5109,485619,39620,407151,142,1900,149,0,897,3005,3005,897,3005,0,0
HI,618,30476,0,961,70,379,759,180,197,526,B,16,70,485619,39620,407151,38775,1900,149,5,449,31094,31094,454,31094,0,1
IA,7884,37708,0,345,5109,121,759,91,197,2899,A,170,5109,485619,39620,407151,7884,1900,149,739,2186,45592,45592,2925,45592,8,0
ID,2015,27210,0,28,178,379,75,180,197,1175,C,63,178,29070,39620,407151,1860,1900,149,31,348,29225,29225,379,29225,3,3
IL,56055,228633,0,4900,5109,1263,759,777,197,0,A,2457,5109,485619,39620,407151,56055,1900,149,3137,11684,284688,284688,14821,284688,102,0
IN,18630,81009,0,1431,5109,514,759,257,197,0,A+,1175,5109,485619,39620,407151,38775,1900,149,795,3846,99639,99639,4641,99639,61,0
KS,4449,28585,0,961,534,379,206,180,96,280,A,130,534,485619,39620,407151,38775,1900,149,211,1197,33034,33034,1408,33034,1,11
KY,4708,51904,0,330,1375,178,642,180,197,1675,A,240,1375,485619,39620,407151,4707,1900,149,169,2342,56612,56612,2511,56612,5,16
LA,28711,139540,0,1607,5109,379,759,230,197,17303,B,1927,5109,485619,39620,407151,38775,1740,149,710,6232,168251,168251,6942,168251,65,0
MA,64311,225325,0,3716,6169,947,759,180,197,0,A,3716,6169,485619,39620,407151,64311,1900,149,2106,11883,289636,289636,13989,289636,154,227
MD,23472,97511,0,1668,4718,568,759,180,197,1517,A,1276,4718,485619,39620,407151,23472,1214,62,1730,4894,120983,120983,6624,120983,50,159
ME,1123,19546,0,37,177,17,759,9,197,657,B,55,177,485619,39620,407151,1123,1900,149,28,0,20669,20669,28,20669,2,7
MI,48240,178807,0,2319,5109,966,759,760,197,8342,A+,4520,5109,232528,53721,178807,46455,4376,203,735,9863,227047,227047,10598,227047,86,0
MN,8736,77214,0,369,1096,118,380,180,197,1911,A,371,1096,85950,39620,407151,5730,1900,149,620,3865,85950,85950,4485,85950,28,52
MO,7835,74590,0,883,5109,379,759,137,197,0,A,337,5109,88989,9578,79260,7835,1900,149,273,1465,82425,82425,1738,82425,8,0
MP,14,749,0,961,5109,379,759,180,197,12,D,2,5109,485619,39620,407151,38775,1900,149,0,164,763,763,164,763,0,0
MS,7212,64336,0,651,1226,160,759,75,197,3413,B,281,1226,485619,39620,407151,7212,1900,149,397,4811,71548,71548,5208,71548,20,51
MT,453,13750,0,5,61,379,759,180,197,397,C,16,61,485619,39620,407151,453,1900,149,0,289,14203,14203,289,14203,0,0
NC,10923,122909,0,547,5109,379,759,180,197,0,B,399,5109,485619,39620,407151,10923,1900,149,414,5382,133832,133832,5796,133832,21,0
ND,1107,28418,0,27,86,379,759,180,197,482,C,23,86,485619,39620,407151,1107,1900,149,40,2025,29525,29525,2065,29525,4,1
NE,4281,23104,0,961,5109,379,759,180,197,0,D,70,5109,485619,39620,407151,4281,1900,149,497,1567,27385,27385,2064,27385,2,0
NH,2146,19903,302,112,262,379,759,180,197,980,C,72,262,485619,39620,407151,2146,1900,149,92,36,22351,22049,128,22049,6,3
NJ,121190,135355,583,5972,5109,1724,759,1286,197,15642,A+,7538,5109,485619,39620,407151,121190,1900,149,2538,6089,257128,256545,8627,256545,310,0
NM,3411,64458,0,172,536,379,759,180,197,760,C,123,536,485619,39620,407151,3411,1900,149,198,2586,67869,67869,2784,67869,11,0
NV,5227,38368,0,961,5109,379,759,180,197,182,D,277,5109,53984,39620,407151,5227,1900,149,229,1380,43595,43595,1609,43595,8,0
NY,308314,619124,0,10993,78224,3640,759,180,197,56187,B,18610,78224,485619,39620,407151,308314,1900,149,3942,22860,927438,927438,26802,927438,289,824
OH,18743,121763,0,961,3634,379,1056,180,197,0,B,1002,3634,485619,39620,407151,17962,922,80,716,5900,140506,140506,6616,140506,27,101
OK,3748,59804,0,255,715,113,759,180,197,2467,A,230,715,66866,4032,62714,38775,1900,149,130,0,63552,63552,130,63552,8,12
OR,2579,55597,0,208,591,49,759,23,197,0,A,104,591,485619,39620,407151,38775,1900,149,69,2075,58176,58176,2144,58176,1,13
PA,46971,180477,0,2683,5109,379,759,590,197,0,B,2354,5109,485619,39620,407151,38775,1900,149,1208,4875,227448,227448,6083,227448,62,0
PR,1575,9313,0,200,5109,379,759,180,197,0,D,92,5109,485619,39620,407151,964,51,149,36,0,10888,10888,36,10888,0,0
RI,9333,52328,0,352,937,76,759,51,197,485,A+,279,937,73273,10493,62780,9333,1900,149,317,2228,61661,61661,2545,61661,13,41
SC,6258,53121,0,961,1110,379,759,180,197,3622,B,256,1110,59379,39620,407151,6258,1900,149,163,2704,59379,59379,2867,59379,12,110
SD,2525,14838,0,69,179,379,759,180,197,1686,C,21,179,485619,39620,407151,38775,1900,149,76,259,17363,17363,335,17363,4,6
TN,11891,174241,0,529,1113,379,759,180,197,5546,B,204,1113,485619,39620,407151,11891,1900,149,1156,7350,186132,186132,8506,186132,5,68
TX,29229,322546,0,1778,5109,379,759,180,197,14122,B,816,5109,485619,39620,407151,29229,1900,149,1142,20333,351775,351775,21475,351775,34,0
UT,4828,107730,0,961,403,379,759,180,197,2062,C,46,403,485619,39620,407151,4828,1900,149,156,3901,112558,112558,4057,112558,0,13
VA,16901,89539,468,1431,3654,366,759,193,197,2196,B,581,3654,485619,39620,407151,16109,572,9,1055,13876,106908,106440,14931,106440,29,0
VI,66,811,68,961,5109,379,759,180,197,51,C,4,5109,485619,39620,407151,38775,1900,149,0,4,945,877,4,877,0,0
VT,885,14930,0,19,5109,379,759,180,197,0,C,50,5109,485619,39620,407151,879,1900,149,6,573,15815,15815,579,15815,1,0
WA,16653,193449,0,470,5109,120,759,180,197,0,B,814,5109,485619,39620,407151,15899,1900,149,344,4448,210102,210102,4792,210102,13,0
WI,8550,72566,218,560,1544,127,391,180,197,3352,A+,327,1544,485619,39620,407151,7314,1900,149,498,3172,81334,81116,3670,81116,11,32
WV,1136,45708,0,81,5109,33,759,18,197,555,C,46,5109,46844,39620,407151,1136,1900,149,18,2285,46844,46844,2303,46844,5,0
WY,559,9136,0,13,56,379,759,180,197,373,C,7,56,9551,429,9122,415,1900,149,15,234,9695,9695,249,9695,0,0
AK,355,18764,0,19,5109,379,759,180,197,252,C,9,5109,19119,39620,407151,355,1900,149,0,0,19119,19119,0,19119,0,0
AL,7019,80177,0,479,978,379,335,180,195,0,B,269,978,485619,39620,407151,7019,1900,149,177,6570,87196,87196,6747,87196,24,33
AR,3255,45124,0,95,402,379,759,23,85,1305,B,61,402,485619,39620,407151,3255,1900,149,63,2867,48379,48379,2930,48379,2,13
AS,0,3,17,961,5109,379,759,180,197,0,F,0,5109,485619,39620,407151,0,1900,149,0,0,20,3,0,3,0,0
AZ,7648,64138,0,755,1937,311,759,194,197,1499,A+,320,1937,71786,39620,407151,38775,1900,149,446,2527,71786,71786,2973,71786,16,53
CA,48917,576420,0,4981,5109,1473,759,180,197,0,B,1982,5109,625337,39620,407151,48917,1900,149,2417,19781,625337,625337,22198,625337,95,0
CO,14758,56301,0,966,2621,379,759,180,197,2415,B,766,2621,485619,39620,407151,13148,1900,149,23,1587,71059,71059,1610,71059,6,11
CT,27700,69433,0,1650,5109,379,759,180,197,0,C,2257,5109,97133,39620,407151,38775,1862,149,933,1382,97133,97133,2315,97133,89,0
DC,4323,15756,0,961,5109,379,759,180,197,660,B,224,5109,485619,39620,407151,38775,1900,149,217,633,20079,20079,850,20079,19,0
DE,4734,17086,0,296,5109,379,759,180,197,1275,B,210,5109,485619,39620,407151,38775,185,25,79,203,21820,21820,282,21820,6,0
FL,33690,348715,1187,961,5795,379,759,180,197,0,C,1290,5795,485619,39620,407151,33690,1900,149,497,8420,383592,382405,8917,382405,50,171
GA,26155,122889,0,961,5156,379,1171,180,197,0,A,1120,5156,149044,39620,407151,26155,1900,149,532,4734,149044,149044,5266,149044,27,100
GU,146,1962,0,961,5109,379,759,180,197,131,F,5,5109,485619,39620,407151,142,1900,149,1,260,2108,2108,261,2108,0,0
HI,613,30027,0,961,69,379,759,180,197,516,B,16,69,485619,39620,407151,38775,1900,149,4,1018,30640,30640,1022,30640,0,0
IA,7145,35522,0,335,5109,121,759,86,197,2697,B,162,5109,485619,39620,407151,7145,1900,149,302,1028,42667,42667,1330,42667,14,0
ID,1984,26862,0,36,175,379,74,180,197,1121,C,60,175,28693,39620,407151,1831,1900,149,32,432,28846,28846,464,28846,0,2
IL,52918,216949,0,4953,5109,1289,759,785,197,0,A,2355,5109,485619,39620,407151,52918,1900,149,2563,10637,269867,269867,13200,269867,140,0
IN,17835,77163,0,1466,5109,549,759,275,197,0,A+,1114,5109,485619,39620,407151,38775,1900,149,653,2795,94998,94998,3448,94998,49,0
KS,4238,27388,0,961,523,379,201,180,93,272,A,129,523,485619,39620,407151,38775,1900,149,500,1668,31626,31626,2168,31626,4,8
KY,4539,49562,0,325,1359,176,636,180,197,1668,A,235,1359,485619,39620,407151,4539,1900,149,164,1526,54101,54101,1690,54101,10,28
LA,28001,133308,0,1601,5109,379,759,231,197,17303,B,1862,5109,485619,39620,407151,38775,1729,149,341,4400,161309,161309,4741,161309,60,0
MA,62205,213442,0,3803,5942,1001,759,180,197,0,A,3562,5942,485619,39620,407151,62205,1900,149,1940,8089,275647,275647,10029,275647,157,184
MD,21742,92617,0,1711,4559,590,759,180,197,1432,A,1226,4559,485619,39620,407151,21742,1167,59,893,2537,114359,114359,3430,114359,58,157
ME,1095,19546,0,35,170,18,759,8,197,631,B,53,170,485619,39620,407151,1095,1900,149,39,0,20641,20641,39,20641,1,4
MI,47505,168944,0,2319,5109,966,759,760,197,8342,A+,4434,5109,221578,52634,168944,46072,4317,202,1017,10571,216449,216449,11588,216449,99,0
MN,8116,73349,0,365,1044,130,358,180,197,1829,A,343,1044,81465,39620,407151,5136,1900,149,648,3699,81465,81465,4347,81465,24,94
MO,7562,73125,0,853,5109,379,759,141,197,0,A,329,5109,84070,9201,74728,7562,1900,149,137,3391,80687,80687,3528,80687,11,0
MP,14,585,0,961,5109,379,759,180,197,12,D,2,5109,485619,39620,407151,38775,1900,149,0,375,599,599,375,599,0,0
MS,6815,59525,0,639,1175,146,759,72,197,3413,B,261,1175,485619,39620,407151,6815,1900,149,246,0,66340,66340,246,66340,11,49
MT,453,13461,0,5,61,379,759,180,197,392,C,16,61,485619,39620,407151,453,1900,149,2,384,13914,13914,386,13914,0,0
NC,10509,117527,0,546,5109,379,759,180,197,0,B,378,5109,485619,39620,407151,10509,1900,149,561,9035,128036,128036,9596,128036,24,0
ND,1067,26393,0,30,85,379,759,180,197,458,C,19,85,485619,39620,407151,1067,1900,149,34,1890,27460,27460,1924,27460,0,3
NE,3784,21537,0,961,5109,379,759,180,197,0,D,68,5109,485619,39620,407151,3784,1900,149,410,1280,25321,25321,1690,25321,13,0
NH,2054,19867,272,107,259,379,759,180,197,980,C,66,259,485619,39620,407151,2054,1900,149,44,1131,22193,21921,1175,21921,6,10
NJ,118652,129266,478,6137,5109,1765,759,1271,197,15642,A+,7228,5109,485619,39620,407151,118652,1900,149,2388,4212,248396,247918,6600,247918,458,0
NM,3213,61872,0,163,536,379,759,180,197,734,C,112,536,485619,39620,407151,3213,1900,149,239,3101,65085,65085,3340,65085,2,27
NV,4998,36988,0,961,5109,379,759,180,197,158,D,269,5109,51761,39620,407151,4998,1900,149,100,858,41986,41986,958,41986,12,0
NY,304372,596264,0,11598,77400,3769,759,180,197,54771,B,18321,77400,485619,39620,407151,38775,1900,149,4681,23474,900636,900636,28155,900636,306,950
OH,18027,115863,0,961,3533,379,1035,180,197,0,B,975,3533,485619,39620,407151,17285,898,77,724,4258,133890,133890,4982,133890,38,112
OK,3618,59804,0,291,703,127,759,180,197,2401,A,222,703,63779,3859,59804,38775,1900,149,145,2010,63422,63422,2155,63422,8,10
OR,2510,53522,0,243,578,65,759,28,197,0,A,103,578,485619,39620,407151,38775,1900,149,64,1496,56032,56032,1560,56032,2,9
PA,45763,175602,0,2707,5109,379,759,556,197,0,B,2292,5109,485619,39620,407151,38775,1900,149,1397,5085,221365,221365,6482,221365,97,0
PR,1539,9313,0,201,5109,379,759,180,197,0,D,92,5109,485619,39620,407151,955,51,149,106,0,10852,10852,106,10852,6,0
RI,9016,50100,0,339,896,85,759,54,197,461,A+,266,896,69727,10036,59691,9016,1900,149,348,1957,59116,59116,2305,59116,15,146
SC,6095,50417,0,961,1000,379,759,180,197,3252,B,244,1000,485619,39620,407151,6095,1900,149,214,2081,56512,56512,2295,56512,41,0
SD,2449,14579,0,76,173,379,759,180,197,1573,C,17,173,485619,39620,407151,38775,1900,149,76,119,17028,17028,195,17028,4,8
TN,10735,166891,0,605,1045,379,759,180,197,5338,B,199,1045,485619,39620,407151,10366,1900,149,369,8708,177626,177626,9077,177626,4,32
TX,28087,302213,0,1686,5109,379,759,180,197,13353,B,782,5109,485619,39620,407151,28087,1900,149,1033,14477,330300,330300,15510,330300,50,0
UT,4672,103829,0,961,390,379,759,180,197,1939,C,46,390,485619,39620,407151,4672,1900,149,177,2546,108501,108501,2723,108501,1,7
VA,15846,75663,583,1550,3654,372,759,208,197,2104,B,552,3654,485619,39620,407151,15180,543,9,885,4684,92092,91509,5569,91509,30,46
VI,66,807,43,961,5109,379,759,180,197,51,C,4,5109,485619,39620,407151,38775,1900,149,4,75,916,873,79,873,0,0
VT,879,14357,0,23,5109,379,759,180,197,0,C,49,5109,485619,39620,407151,866,1900,149,13,202,15236,15236,215,15236,2,0
WA,16309,189001,0,474,5109,145,759,180,197,0,B,801,5109,485619,39620,407151,15589,1900,149,267,4615,205310,205310,4882,205310,15,0
WI,8052,69394,195,554,1512,119,382,180,197,3352,A+,316,1512,485619,39620,407151,6854,1900,149,392,2764,77641,77446,3156,77446,8,23
WV,1118,43423,0,84,5109,38,759,20,197,545,C,41,5109,44541,39620,407151,1118,1900,149,23,1447,44541,44541,1470,44541,3,0
WY,544,8902,0,13,56,379,759,180,197,371,C,7,56,9306,418,8888,404,1900,149,8,221,9446,9446,229,9446,0,0
AK,355,18764,0,14,5109,379,759,180,197,240,B,9,5109,19119,39620,407151,355,1900,149,4,2026,19119,19119,2030,19119,0,0
AL,6842,73607,0,498,945,379,335,180,195,0,B,245,945,485619,39620,407151,6842,1900,149,155,4467,80449,80449,4622,80449,3,34
AR,3192,42257,0,93,389,379,759,18,82,1249,B,59,389,485619,39620,407151,3192,1900,149,81,4697,45449,45449,4778,45449,7,389
AS,0,3,17,961,5109,379,759,180,197,0,F,0,5109,485619,39620,407151,0,1900,149,0,0,20,3,0,3,0,0
AZ,7202,61611,0,756,1884,312,759,191,197,1475,A+,304,1884,68813,39620,407151,38775,1900,149,254,1121,68813,68813,1375,68813,11,60
CA,46500,556639,0,5011,5109,1512,759,180,197,0,B,1887,5109,603139,39620,407151,46500,1900,149,1469,24062,603139,603139,25531,603139,78,0
CO,14735,54714,0,964,2610,379,759,180,197,2275,B,760,2610,485619,39620,407151,12741,1900,149,856,2252,69449,69449,3108,69449,54,125
CT,26767,68051,0,1691,5109,379,759,180,197,0,C,2168,5109,94818,39620,407151,38775,1764,149,455,1618,94818,94818,2073,94818,79,0
DC,4106,15123,0,961,5109,379,759,180,197,660,B,205,5109,485619,39620,407151,38775,1900,149,112,232,19229,19229,344,19229,15,0
DE,4655,16883,0,326,5109,379,759,180,197,1173,B,204,5109,485619,39620,407151,38775,179,25,80,278,21538,21538,358,21538,12,0
FL,33193,340295,1252,961,5624,379,759,180,197,0,C,1240,5624,485619,39620,407151,33193,1900,149,347,6266,374740,373488,6613,373488,86,358
GA,25623,118155,0,961,5056,379,1148,180,197,0,A,1093,5056,140223,39620,407151,25411,1900,149,1008,2750,143778,143778,3758,143778,67,242
GU,145,1702,0,961,5109,379,759,180,197,130,D,5,5109,485619,39620,407151,141,1900,149,0,164,1847,1847,164,1847,0,0
HI,609,29009,0,961,69,379,759,180,197,505,B,16,69,485619,628,27632,38775,1900,149,2,433,29618,29618,435,29618,0,1
IA,6843,34494,0,323,5109,100,759,74,197,2428,B,148,5109,485619,39620,407151,6843,1900,149,467,1047,41337,41337,1514,41337,12,0
ID,1952,26430,0,39,173,379,73,180,197,1087,C,60,173,28240,39620,407151,1810,1900,149,35,8295,28382,28382,8330,28382,2,1
IL,50355,206312,0,5036,5109,1290,759,777,197,0,A,2215,5109,485619,39620,407151,50355,1900,149,2253,12225,256667,256667,14478,256667,90,0
IN,17182,74368,0,1484,5109,570,759,262,197,0,A,1065,5109,485619,39620,407151,38775,1900,149,594,3775,91550,91550,4369,91550,164,0
KS,3738,25720,0,961,515,379,198,180,88,266,A,125,515,485619,39620,407151,38775,1900,149,247,1121,29458,29458,1368,29458,1,11
KY,4375,48036,0,320,1331,170,625,180,197,1617,A,225,1331,485619,39620,407151,4374,1900,149,229,3383,52411,52411,3612,52411,12,50
LA,27660,128908,0,1629,5109,379,759,244,197,17303,B,1802,5109,485619,39620,407151,38775,1703,149,374,5086,156568,156568,5460,156568,44,0
MA,60265,205353,0,3856,5758,1011,759,180,197,0,A,3405,5758,485619,39620,407151,60265,1900,149,1963,9155,265618,265618,11118,265618,252,243
MD,20849,90080,0,1610,4402,586,759,180,197,1361,A,1168,4402,485619,39620,407151,20849,1110,58,736,2408,110929,110929,3144,110929,69,134
ME,1056,19546,0,32,166,17,759,7,197,615,B,52,166,485619,39620,407151,1056,1900,149,16,2762,20602,20602,2778,20602,1,3
MI,46488,158373,0,2498,5109,997,759,778,197,8342,A+,4335,5109,209855,51482,158373,45406,4232,199,950,9463,204861,204861,10413,204861,88,0
MN,7468,69650,0,320,950,119,337,180,197,1724,A,319,950,77118,39620,407151,4644,1900,149,680,6402,77118,77118,7082,77118,18,38
MO,7425,69734,0,891,5109,379,759,125,197,0,A,318,5109,79128,8781,70219,7425,1900,149,122,3534,77159,77159,3656,77159,4,0
MP,14,210,0,961,5109,379,759,180,197,12,D,2,5109,485619,39620,407151,38775,1900,149,0,159,224,224,159,224,0,0
MS,6569,59525,0,677,1126,151,759,69,197,3413,B,250,1126,485619,39620,407151,38775,1900,149,227,1455,66094,66094,1682,66094,11,38
MT,451,13077,0,5,61,379,759,180,197,382,C,16,61,485619,39620,407151,38775,1900,149,0,337,13528,13528,337,13528,1,0
NC,9948,108492,0,551,5109,379,759,180,197,0,B,354,5109,485619,39620,407151,9948,1900,149,380,5308,118440,118440,5688,118440,12,0
ND,1033,24503,0,28,82,379,759,180,197,437,C,19,82,485619,39620,407151,1033,1900,149,42,1771,25536,25536,1813,25536,0,3
NE,3374,20257,0,961,5109,379,759,180,197,0,D,55,5109,485619,39620,407151,3374,1900,149,16,10,23631,23631,26,23631,0,0
NH,2010,18736,81,106,249,379,759,180,197,936,C,60,249,485619,39620,407151,2010,1900,149,72,529,20827,20746,601,20746,0,3
NJ,116264,125054,617,6289,5109,1811,759,1327,197,15642,A+,6770,5109,485619,39620,407151,116264,1900,149,2408,4551,241935,241318,6959,241318,328,0
NM,2974,58771,0,157,509,379,759,180,197,705,C,110,509,485619,39620,407151,2974,1900,149,151,2791,61745,61745,2942,61745,6,28
NV,4898,36130,0,961,5109,379,759,180,197,100,D,257,5109,50526,39620,407151,4898,1900,149,93,816,41028,41028,909,41028,6,0
NY,299691,572790,0,12159,76450,3923,759,180,197,53238,B,18015,76450,485619,39620,407151,38775,1900,149,4585,22902,872481,872481,27487,872481,377,1088
OH,17303,111605,0,961,3421,379,1014,180,197,0,B,937,3421,485619,39620,407151,16601,856,81,534,5027,128908,128908,5561,128908,138,81
OK,3473,57794,0,283,693,126,759,180,197,2319,A,214,693,61619,3717,57794,38775,1900,149,63,1505,61267,61267,1568,61267,7,37
OR,2446,52026,0,227,569,56,759,24,197,0,A,101,569,485619,39620,407151,38775,1900,149,92,3182,54472,54472,3274,54472,9,15
PA,44366,170517,0,2781,5109,379,759,602,197,0,B,2195,5109,485619,39620,407151,38775,1900,149,1102,4693,214883,214883,5795,214883,479,0
PR,1433,9313,1940,125,5109,379,759,180,197,0,D,86,5109,485619,39620,407151,904,51,149,33,0,12686,10746,33,10746,0,0
RI,8668,48143,0,269,750,80,759,55,197,391,A+,251,750,66523,9604,56919,8668,1900,149,372,2454,56811,56811,2826,56811,12,18
SC,5881,48336,0,961,1000,379,759,180,197,3252,B,203,1000,485619,39620,407151,5881,1900,149,268,1804,54217,54217,2072,54217,26,56
SD,2373,14460,0,69,165,379,759,180,197,1492,C,13,165,485619,39620,407151,38775,1900,149,60,161,16833,16833,221,16833,2,8
TN,10366,158183,0,614,1013,379,759,180,197,5140,B,195,1013,485619,39620,407151,10366,1900,149,314,6307,168549,168549,6621,168549,7,119
TX,27054,287736,0,1702,5109,379,759,180,197,12507,B,732,5109,485619,39620,407151,27054,1900,149,883,13523,314790,314790,14406,314790,42,0
UT,4495,101283,0,961,383,379,759,180,197,1790,C,45,383,485619,39620,407151,4495,1900,149,152,3187,105778,105778,3339,105778,0,13
VA,14961,70979,620,1566,3608,387,759,222,197,2042,B,522,3608,485619,39620,407151,14328,513,9,622,2020,86560,85940,2642,85940,30,186
VI,62,732,78,961,5109,379,759,180,197,51,C,4,5109,485619,39620,407151,38775,1900,149,3,13,872,794,16,794,0,0
VT,866,14155,0,26,5109,379,759,180,197,0,C,47,5109,485619,39620,407151,862,1900,149,4,208,15021,15021,212,15021,0,0
WA,16042,184386,0,490,5109,156,759,180,197,0,B,786,5109,485619,39620,407151,15343,1900,149,244,4679,200428,200428,4923,200428,21,0
WI,7660,66630,227,577,1489,121,363,180,197,0,A,308,1489,485619,39620,407151,6520,1900,149,269,3095,74517,74290,3364,74290,8,33
WV,1095,41976,0,102,5109,40,759,21,197,504,C,38,5109,42032,39620,407151,1095,1900,149,16,0,43071,43071,16,43071,1,0
WY,536,8681,0,12,56,379,759,180,197,362,C,7,56,9055,407,8648,396,1900,149,147,455,9217,9217,602,9217,0,0
AK,351,16738,0,16,5109,379,759,180,197,228,B,9,5109,17089,39620,407151,351,1900,149,6,827,17089,17089,833,17089,0,0
AL,6687,69140,0,530,911,379,335,180,195,0,B,242,911,485619,39620,407151,6687,1900,149,188,1642,75827,75827,1830,75827,20,39
AR,3111,37560,0,104,5109,379,759,20,197,1146,B,52,5109,485619,39620,407151,3111,1900,149,94,120,40671,40671,214,40671,2,0
AS,0,3,17,961,5109,379,759,180,197,0,F,0,5109,485619,39620,407151,0,1900,149,0,0,20,3,0,3,0,0
AZ,6948,60490,0,737,1824,303,759,193,197,1450,A+,293,1824,67438,39620,407151,38775,1900,149,232,663,67438,67438,895,67438,18,52
CA,45031,532577,0,4983,5109,1485,759,180,197,0,B,1809,5109,577608,39620,407151,38775,1900,149,1567,22632,577608,577608,24199,577608,54,0
CO,13879,52462,0,994,2485,379,759,180,197,2275,B,706,2485,485619,39620,407151,12374,1900,149,438,2629,66341,66341,3067,66341,26,47
CT,26312,66433,0,1732,5109,379,759,180,197,0,C,2089,5109,92745,39620,407151,38775,1639,149,1043,11891,92745,92745,12934,92745,91,0
DC,3994,14891,0,961,5109,379,759,180,197,660,B,190,5109,485619,39620,407151,38775,1900,149,102,367,18885,18885,469,18885,5,0
DE,4575,16605,0,337,5109,379,759,180,197,1096,B,192,5109,485619,39620,407151,38775,170,22,413,1151,21180,21180,1564,21180,11,0
FL,32846,334029,1216,961,5266,379,759,180,197,0,C,1154,5266,485619,39620,407151,38775,1900,149,708,9704,368091,366875,10412,366875,53,55
GA,24615,115405,0,961,4814,379,1087,180,197,0,B,1026,4814,140020,39620,407151,38775,1900,149,702,12149,140020,140020,12851,140020,55,133
GU,145,1538,0,3,5109,379,759,180,197,129,D,5,5109,485619,39620,407151,38775,1900,149,1,114,1683,1683,115,1683,0,0
HI,607,28576,0,961,68,379,759,180,197,493,C,16,68,485619,39620,407151,38775,1900,149,1,172,29183,29183,173,29183,2,0
IA,6376,33447,0,304,5109,98,759,64,197,2164,B,136,5109,485619,39620,407151,6376,1900,149,508,1165,39823,39823,1673,39823,9,0
ID,1917,18135,0,41,172,379,73,180,197,1039,C,58,172,20052,39620,407151,38775,1900,149,20,8,20052,20052,28,20052,2,3
IL,48102,194087,0,4738,5109,1245,759,778,197,0,A,2125,5109,485619,39620,407151,38775,1900,149,2219,12342,242189,242189,14561,242189,142,0
IN,16588,70593,0,1518,5109,546,759,275,197,0,B,901,5109,485619,39620,407151,38775,1900,149,627,2078,87181,87181,2705,87181,57,0
KS,3491,24599,0,961,504,379,759,180,197,0,C,124,504,485619,39620,407151,38775,1900,149,163,760,28090,28090,923,28090,4,8
KY,4146,44653,0,313,1281,165,612,180,197,1521,A,213,1281,485619,39620,407151,4145,1900,149,72,253,48799,48799,325,48799,5,7
LA,27286,123822,0,1666,5109,379,759,244,197,17303,B,1758,5109,485619,39620,407151,38775,1660,149,218,3901,151108,151108,4119,151108,61,0
MA,58302,196198,0,3875,5515,1005,759,180,197,0,B,3153,5515,485619,39620,407151,38775,1900,149,1840,7773,254500,254500,9613,254500,150,278
MD,20113,87672,0,1528,4268,551,759,180,197,1295,A,1099,4268,485619,39620,407151,20113,1042,57,626,2183,107785,107785,2809,107785,54,167
ME,1040,16784,0,33,163,17,759,7,197,585,B,51,163,485619,39620,407151,38775,1900,149,17,0,17824,17824,17,17824,0,2
MI,45538,148910,0,2623,5109,1027,759,801,197,8342,A+,4247,5109,199206,50296,148910,44508,4136,198,829,7938,194448,194448,8767,194448,99,0
MN,6788,63248,0,314,912,120,324,180,197,1611,A,301,912,70036,39620,407151,38775,1900,149,601,2745,70036,70036,3346,70036,15,51
MO,7303,66200,0,655,5109,379,759,105,197,0,B,314,5109,75149,8424,66603,38775,1900,149,132,2265,73503,73503,2397,73503,26,0
MP,14,51,0,961,5109,379,759,180,197,12,D,2,5109,485619,39620,407151,38775,1900,149,0,0,65,65,0,65,0,0
MS,6342,58070,0,639,1088,162,759,77,197,0,B,239,1088,485619,39620,407151,38775,1900,149,248,702,64412,64412,950,64412,10,28
MT,451,12740,0,10,61,379,759,180,197,356,C,15,61,485619,39620,407151,38775,1900,149,2,156,13191,13191,158,13191,1,0
NC,9568,103184,0,463,5109,379,759,180,197,0,B,342,5109,485619,39620,407151,38775,1900,149,426,2406,112752,112752,2832,112752,36,0
ND,991,22732,0,25,79,379,759,180,197,409,C,19,79,485619,39620,407151,38775,1900,149,49,1240,23723,23723,1289,23723,0,2
NE,3358,20247,0,961,5109,379,759,180,197,0,D,55,5109,485619,39620,407151,38775,1900,149,330,912,23605,23605,1242,23605,-1,0
NH,1938,18207,223,99,246,379,759,180,197,798,C,60,246,485619,39620,407151,38775,1900,149,74,347,20368,20145,421,20145,0,4
NJ,113856,120503,0,6476,5109,1809,759,1262,197,15642,A+,6442,5109,485619,39620,407151,38775,1900,149,2668,3916,234359,234359,6584,234359,398,0
NM,2823,55980,0,155,481,379,759,180,197,666,C,104,481,485619,39620,407151,38775,1900,149,97,2091,58803,58803,2188,58803,5,69
NV,4805,35314,0,961,5109,379,759,180,197,0,F,251,5109,485619,39620,407151,38775,1900,149,115,1191,40119,40119,1306,40119,6,0
NY,295106,549888,0,12646,75362,4071,759,180,197,51673,B,17638,75362,485619,39620,407151,38775,1900,149,3110,15789,844994,844994,18899,844994,335,760
OH,16769,106578,0,961,3340,379,1004,180,197,0,B,799,3340,485619,39620,407151,16128,757,42,444,2886,123347,123347,3330,123347,46,108
OK,3410,56289,0,288,656,118,759,180,197,2260,A,207,656,485619,39620,407151,38775,1900,149,130,6398,59699,59699,6528,59699,10,0
OR,2354,48844,0,249,554,71,759,31,197,0,B,92,554,485619,39620,407151,38775,1900,149,0,0,51198,51198,0,51198,0,0
PA,43264,165824,0,2781,5109,379,759,616,197,0,B,1716,5109,485619,39620,407151,38775,1900,149,1214,4452,209088,209088,5666,209088,119,0
PR,1400,9313,1940,132,5109,379,759,180,197,0,D,86,5109,485619,39620,407151,38775,1900,149,11,0,12653,10713,11,10713,2,0
RI,8296,45689,0,266,732,84,759,55,197,466,A+,239,732,62696,9128,53568,8296,1900,149,324,1774,53985,53985,2098,53985,6,14
SC,5613,46532,0,961,944,379,759,180,197,2830,B,177,944,485619,39620,407151,38775,1900,149,123,1261,52145,52145,1384,52145,3,0
SD,2313,14299,0,69,157,379,759,180,197,1392,C,11,157,485619,39620,407151,38775,1900,149,68,169,16612,16612,237,16612,0,7
TN,10052,151876,0,611,894,379,759,180,197,4921,B,188,894,485619,39620,407151,38775,1900,149,134,7392,161928,161928,7526,161928,4,57
TX,26171,274213,0,1682,5109,379,759,180,197,11786,B,690,5109,485619,39620,407151,26171,1900,149,874,8993,300384,300384,9867,300384,27,0
UT,4343,98096,0,961,370,379,759,180,197,1704,C,45,370,485619,39620,407151,4343,1900,149,110,2134,102439,102439,2244,102439,4,21
VA,14339,68959,560,1508,3422,376,759,217,197,1914,B,492,3422,485619,39620,407151,13794,487,5,804,1815,83858,83298,2619,83298,34,124
VI,59,719,57,961,5109,379,759,180,197,51,D,4,5109,485619,39620,407151,38775,1900,149,0,3,835,778,3,778,0,0
VT,862,13947,0,29,5109,379,759,180,197,0,C,47,5109,485619,39620,407151,862,1900,149,0,128,14809,14809,128,14809,0,0
WA,15798,179707,0,436,5109,158,759,180,197,0,B,765,5109,485619,39620,407151,15014,1900,149,232,5115,195505,195505,5347,195505,16,0
WI,7391,63535,193,544,1456,123,363,180,197,0,A,300,1456,485619,39620,407151,6289,1900,149,230,2224,71119,70926,2454,70926,19,41
WV,1079,41976,0,87,5109,28,759,15,197,481,B,37,5109,485619,39620,407151,38775,1900,149,16,0,43055,43055,16,43055,1,0
WY,389,8226,0,16,56,379,759,180,197,343,C,7,56,485619,39620,407151,389,1900,149,19,429,8615,8615,448,8615,0,2
AK,345,15911,0,10,5109,379,759,180,197,218,B,9,5109,16256,39620,407151,345,1900,149,4,75,16256,16256,79,16256,0,0
AL,6499,67498,0,426,872,379,335,180,195,0,B,222,872,485619,39620,407151,6499,1900,149,229,217,73997,73997,446,73997,6,27
AR,3017,37440,0,109,5109,379,759,25,197,987,B,50,5109,485619,39620,407151,3017,1900,149,76,912,40457,40457,988,40457,1,-291
AS,0,3,17,961,5109,379,759,180,197,0,F,0,5109,485619,39620,407151,0,1900,149,0,0,20,3,0,3,0,0
AZ,6716,59827,0,647,1772,328,759,200,197,1418,A+,275,1772,66543,39620,407151,38775,1900,149,190,1542,66543,66543,1732,66543,0,56
CA,43464,509945,0,4878,5109,1499,759,180,197,0,B,1755,5109,553409,39620,407151,38775,1900,149,1300,26025,553409,553409,27325,553409,45,0
CO,13441,49833,0,1007,2438,379,759,180,197,2150,B,680,2438,485619,39620,407151,11980,1900,149,473,3010,63274,63274,3483,63274,8,28
CT,25269,54542,0,1758,5109,379,759,180,197,0,C,1998,5109,90746,39620,407151,38775,1544,149,0,0,79811,79811,0,79811,74,0
DC,3892,14524,0,402,5109,379,759,180,197,659,B,185,5109,485619,39620,407151,38775,1900,149,51,297,18416,18416,348,18416,7,0
DE,4162,15454,0,325,5109,379,759,180,197,996,B,181,5109,485619,39620,407151,38775,159,22,128,239,19616,19616,367,19616,13,0
FL,32138,324325,1099,961,5211,379,759,180,197,0,C,1101,5211,485619,39620,407151,38775,1900,149,610,11240,357562,356463,11850,356463,7,56
GA,23913,103256,0,961,4681,379,1057,180,197,0,B,971,4681,127169,39620,407151,38775,1900,149,512,3434,127169,127169,3946,127169,59,322
GU,144,1424,0,3,5109,379,759,180,197,128,D,5,5109,485619,39620,407151,38775,1900,149,3,37,1568,1568,40,1568,0,0
HI,606,28404,0,961,68,379,759,180,197,488,C,14,68,485619,39620,407151,38775,1900,149,3,524,29010,29010,527,29010,0,0
IA,5868,32282,0,300,5109,100,759,58,197,2021,B,127,5109,485619,39620,407151,5868,1900,149,392,1668,38150,38150,2060,38150,9,0
ID,1897,18127,0,36,169,379,71,180,197,983,C,56,169,20024,39620,407151,38775,1900,149,10,516,20024,20024,526,20024,0,0
IL,45883,181745,0,4672,5109,1249,759,763,197,0,A,1983,5109,485619,39620,407151,38775,1900,149,1980,10696,227628,227628,12676,227628,50,0
IN,15961,68515,0,1493,5109,581,759,284,197,0,B,844,5109,485619,39620,407151,38775,1900,149,949,1819,84476,84476,2768,84476,31,0
KS,3328,23839,0,961,496,379,759,180,197,0,C,120,496,485619,39620,407151,38775,1900,149,154,786,27167,27167,940,27167,2,11
KY,4074,44400,0,308,1274,166,608,180,197,1511,A,208,1274,485619,39620,407151,38775,1900,149,169,1747,48474,48474,1916,48474,3,8
LA,27068,119921,0,1683,5109,379,759,262,197,17303,B,1697,5109,485619,39620,407151,38775,1599,149,295,3658,146989,146989,3953,146989,27,0
MA,56462,188425,0,3892,5237,1089,759,180,197,0,B,3003,5237,485619,39620,407151,38775,1900,149,1524,7263,244887,244887,8787,244887,104,133
MD,19487,85489,0,1513,4101,535,759,180,197,1263,A,1045,4101,485619,39620,407151,19487,990,55,906,7405,104976,104976,8311,104976,44,139
ME,1023,16784,0,39,161,16,759,7,197,549,B,51,161,485619,39620,407151,38775,1900,149,8,0,17807,17807,8,17807,1,2
MI,44709,140972,0,2667,5109,1059,759,832,197,8342,A+,4148,5109,190156,49184,140972,43634,4049,191,920,6541,185681,185681,7461,185681,112,0
MN,6187,60503,0,292,861,122,316,180,197,1556,A,286,861,66690,39620,407151,38775,1900,149,675,1342,66690,66690,2017,66690,14,32
MO,7171,63935,0,679,5109,379,759,109,197,0,B,288,5109,74013,8326,65566,38775,1900,149,174,1184,71106,71106,1358,71106,14,0
MP,14,51,0,961,5109,379,759,180,197,11,D,2,5109,485619,39620,407151,38775,1900,149,0,0,65,65,0,65,0,0
MS,6094,57368,0,590,1060,142,759,71,197,0,B,229,1060,485619,39620,407151,38775,1900,149,183,2491,63462,63462,2674,63462,2,59
MT,449,12584,0,11,61,379,759,180,197,352,C,14,61,485619,39620,407151,38775,1900,149,1,170,13033,13033,171,13033,0,0
NC,9142,100778,0,473,5109,379,759,180,197,0,B,306,5109,485619,39620,407151,38775,1900,149,312,1714,109920,109920,2026,109920,7,0
ND,942,21492,0,23,77,379,759,180,197,350,C,19,77,485619,39620,407151,38775,1900,149,75,1642,22434,22434,1717,22434,2,6
NE,3028,19335,0,961,5109,379,759,180,197,0,D,56,5109,485619,39620,407151,38775,1900,149,296,839,22363,22363,1135,22363,3,0
NH,1864,17860,270,101,242,379,759,180,197,779,C,60,242,485619,39620,407151,38775,1900,149,77,896,19994,19724,973,19724,0,4
NJ,111188,116587,0,6407,5109,1801,759,1303,197,0,A,6044,5109,485619,39620,407151,38775,1900,149,2150,2481,227775,227775,4631,227775,106,0
NM,2726,53889,0,148,412,379,759,180,197,650,C,99,412,485619,39620,407151,38775,1900,149,66,2814,56615,56615,2880,56615,6,0
NV,4690,34123,0,961,5109,379,759,180,197,0,F,245,5109,485619,39620,407151,38775,1900,149,88,539,38813,38813,627,38813,10,0
NY,291996,534099,0,12819,74602,4157,759,180,197,50751,B,17303,74602,485619,39620,407151,38775,1900,149,3951,16794,826095,826095,20745,826095,337,1062
OH,16325,103692,0,961,3232,379,978,180,197,0,B,753,3232,485619,39620,407151,15699,712,41,362,3269,120017,120017,3631,120017,25,54
OK,3280,49891,0,306,656,150,759,180,197,2167,A,197,656,485619,39620,407151,38775,1900,149,27,0,53171,53171,27,53171,2,3
OR,2354,48844,0,249,554,71,759,31,197,0,B,92,554,485619,39620,407151,38775,1900,149,43,2191,51198,51198,2234,51198,1,8
PA,42050,161372,0,2800,5109,379,759,629,197,0,B,1597,5109,485619,39620,407151,38775,1900,149,885,3944,203422,203422,4829,203422,47,0
PR,1389,9313,1940,140,5109,379,759,180,197,0,D,84,5109,485619,39620,407151,38775,1900,149,18,0,12642,10702,18,10702,0,0
RI,7972,43915,0,266,718,81,759,56,197,452,A+,233,718,60017,8717,51300,7972,1900,149,203,1169,51887,51887,1372,51887,7,27
SC,5490,45271,0,961,944,379,759,180,197,3701,B,174,944,485619,39620,407151,38775,1900,149,0,0,50761,50761,0,50761,0,0
SD,2245,14130,0,61,150,379,759,180,197,1316,C,11,150,485619,39620,407151,38775,1900,149,33,68,16375,16375,101,16375,0,15
TN,9918,144484,0,618,837,379,759,180,197,4720,B,184,837,485619,39620,407151,38775,1900,149,251,6677,154402,154402,6928,154402,3,9
TX,25297,265220,0,1563,5109,379,759,180,197,11170,B,663,5109,485619,39620,407151,25297,1900,149,666,13830,290517,290517,14496,290517,15,0
UT,4233,95962,0,961,349,379,759,180,197,1641,C,41,349,485619,39620,407151,4233,1900,149,110,4383,100195,100195,4493,100195,0,4
VA,13535,67144,542,1455,3298,389,759,217,197,1843,B,458,3298,485619,39620,407151,13036,454,4,565,3514,81221,80679,4079,80679,10,1284
VI,59,716,5,961,5109,379,759,180,197,51,D,4,5109,485619,39620,407151,38775,1900,149,2,16,780,775,18,775,0,0
VT,862,13819,0,33,5109,379,759,180,197,0,C,47,5109,485619,39620,407151,862,1900,149,7,301,14681,14681,308,14681,1,0
WA,15566,174592,0,536,5109,115,759,180,197,0,B,749,5109,485619,39620,407151,14723,1900,149,274,4843,190158,190158,5117,190158,11,0
WI,7161,61311,204,337,1415,124,355,180,197,0,A,281,1415,485619,39620,407151,6081,1900,149,198,2076,68676,68472,2274,68472,9,18
WV,1063,41976,0,100,5109,38,759,20,197,455,B,36,5109,485619,39620,407151,38775,1900,149,19,3957,43039,43039,3976,43039,2,0
WY,370,7797,0,16,54,379,759,180,197,342,C,7,54,485619,39620,407151,370,1900,149,8,0,8167,8167,8,8167,0,0
AK,341,15836,0,14,5109,379,759,180,197,217,B,9,5109,16177,39620,407151,341,1900,149,2,443,16177,16177,445,16177,0,0
AL,6270,67281,0,384,845,379,288,180,170,0,B,216,845,485619,39620,407151,6270,1900,149,133,2074,73551,73551,2207,73551,4,6
AR,2941,36528,0,104,291,379,759,25,57,985,B,49,291,485619,39620,407151,2941,1900,149,112,1304,39469,39469,1416,39469,2,0
AS,0,3,17,961,5109,379,759,180,197,0,F,0,5109,485619,39620,407151,0,1900,149,0,0,20,3,0,3,0,0
AZ,6526,58285,0,671,1716,308,759,200,197,1383,A+,275,1716,64811,39620,407151,38775,1900,149,246,2057,64811,64811,2303,64811,9,44
CA,42164,483920,0,4928,5109,1473,759,180,197,0,B,1710,5109,526084,39620,407151,38775,1900,149,1027,19022,526084,526084,20049,526084,59,0
CO,12968,46823,0,1046,2410,379,759,180,197,2150,B,672,2410,485619,39620,407151,11533,1900,149,712,2290,59791,59791,3002,59791,-2,44
CT,25269,54542,0,1766,5109,379,759,180,197,0,C,1924,5109,79811,39620,407151,38775,1423,149,687,1522,79811,79811,2209,79811,62,0
DC,3841,14227,0,402,5109,120,759,69,197,657,B,178,5109,485619,39620,407151,38775,1900,149,142,624,18068,18068,766,18068,13,0
DE,4034,15215,0,317,5109,379,759,180,197,911,B,168,5109,485619,39620,407151,38775,147,21,458,1093,19249,19249,1551,19249,13,0
FL,31528,313085,1183,961,5155,379,759,180,197,0,C,1094,5155,485619,39620,407151,38775,1900,149,689,10825,345796,344613,11514,344613,19,110
GA,23401,99822,0,961,4359,379,759,180,197,0,B,912,4359,123223,39620,407151,38775,1900,149,706,3503,123223,123223,4209,123223,8,33
GU,141,1387,0,2,5109,379,759,180,197,128,D,5,5109,485619,39620,407151,38775,1900,149,0,79,1528,1528,79,1528,0,0
HI,603,27880,0,961,68,379,759,180,197,482,C,14,68,485619,39620,407151,38775,1900,149,2,441,28483,28483,443,28483,1,1
IA,5476,30614,0,286,5109,99,759,55,197,1900,B,118,5109,485619,39620,407151,5476,1900,149,384,1356,36090,36090,1740,36090,6,0
ID,1887,17611,0,38,169,379,72,180,197,938,C,56,169,19498,39620,407151,38775,1900,149,17,0,19498,19498,17,19498,2,1
IL,43903,171049,0,4595,5109,1267,759,772,197,0,A,1933,5109,485619,39620,407151,38775,1900,149,2126,11209,214952,214952,13335,214952,59,0
IN,15012,66696,0,1446,5109,589,759,310,197,0,B,813,5109,485619,39620,407151,38775,1900,149,617,1317,81708,81708,1934,81708,28,0
KS,3174,23053,0,961,485,379,759,180,197,0,C,118,485,485619,39620,407151,38775,1900,149,118,910,26227,26227,1028,26227,1,11
KY,3905,42653,0,301,1266,164,605,180,197,1501,A,205,1266,485619,39620,407151,38775,1900,149,126,1470,46558,46558,1596,46558,5,123
LA,26773,116263,0,1701,5109,379,759,265,197,14927,B,1670,5109,485619,39620,407151,38775,1900,149,261,3773,143036,143036,4034,143036,26,0
MA,54938,181162,0,3879,5104,1077,759,180,197,0,B,2899,5104,485619,39620,407151,38775,1900,149,1590,7665,236100,236100,9255,236100,22,139
MD,18581,78084,0,1463,3962,530,759,180,197,1177,A,1001,3962,485619,39620,407151,18581,950,51,815,6727,96665,96665,7542,96665,53,202
ME,1015,16784,0,39,159,19,759,7,197,532,B,50,159,485619,39620,407151,38775,1900,149,25,0,17799,17799,25,17799,0,3
MI,43789,134431,0,2757,5109,1099,759,871,197,8342,A+,4036,5109,182757,48326,134431,42885,3957,190,526,5476,178220,178220,6002,178220,107,0
MN,5512,59161,0,285,829,115,301,180,197,1502,A,272,829,64673,39620,407151,38775,1900,149,385,2179,64673,64673,2564,64673,28,32
MO,6997,62751,0,679,5109,379,759,109,197,0,B,274,5109,72715,8186,64409,38775,1900,149,171,2359,69748,69748,2530,69748,1,0
MP,14,51,0,961,5109,379,759,180,197,11,D,2,5109,485619,39620,407151,38775,1900,149,0,0,65,65,0,65,0,0
MS,5911,54877,0,644,1001,146,759,67,197,0,B,227,1001,485619,39620,407151,38775,1900,149,193,1638,60788,60788,1831,60788,6,5
MT,448,12414,0,11,61,379,759,180,197,339,C,14,61,485619,39620,407151,38775,1900,149,3,362,12862,12862,365,12862,0,0
NC,8830,99064,0,451,5109,379,759,180,197,0,B,299,5109,485619,39620,407151,38775,1900,149,207,2422,107894,107894,2629,107894,10,0
ND,867,19850,0,18,71,379,759,180,197,326,C,17,71,485619,39620,407151,38775,1900,149,64,1303,20717,20717,1367,20717,1,1
NE,2732,18496,0,961,5109,379,759,180,197,0,D,53,5109,485619,39620,407151,38775,1900,149,311,944,21228,21228,1255,21228,3,0
NH,1787,16964,550,95,238,379,759,180,197,777,C,60,238,485619,39620,407151,38775,1900,149,67,957,19301,18751,1024,18751,7,14
NJ,109038,114106,0,6573,5109,1804,759,1418,197,0,A,5938,5109,485619,39620,407151,38775,1900,149,3515,5943,223144,223144,9458,223144,75,0
NM,2660,51075,0,152,412,379,759,180,197,614,C,93,412,485619,39620,407151,38775,1900,149,139,2086,53735,53735,2225,53735,9,0
NV,4602,33584,0,961,5109,379,759,180,197,0,F,235,5109,485619,39620,407151,38775,1900,149,63,915,38186,38186,978,38186,6,0
NY,288045,517305,0,12839,73540,4284,759,180,197,49687,B,16966,73540,485619,39620,407151,38775,1900,149,5902,21880,805350,805350,27782,805350,367,1096
OH,15963,100423,0,961,3178,379,952,180,197,0,B,728,3178,485619,39620,407151,15360,687,41,376,4027,116386,116386,4403,116386,17,63
OK,3253,49891,0,306,653,150,759,180,197,2139,A,195,653,485619,39620,407151,38775,1900,149,60,0,53144,53144,60,53144,1,16
OR,2311,46653,0,249,546,71,759,31,197,0,B,91,546,485619,39620,407151,38775,1900,149,58,1529,48964,48964,1587,48964,4,10
PA,41165,157428,0,2736,5109,379,759,632,197,0,B,1550,5109,485619,39620,407151,38775,1900,149,1116,4542,198593,198593,5658,198593,13,0
PR,1371,9313,1940,146,5109,379,759,180,197,0,D,84,5109,485619,39620,407151,38775,1900,149,64,0,12624,10684,64,10684,1,0
RI,7769,42746,0,258,691,78,759,53,197,433,A+,226,691,58143,8467,49676,7769,1900,149,276,1886,50515,50515,2162,50515,11,115
SC,5490,45271,0,961,944,379,759,180,197,3701,B,174,944,485619,39620,407151,38775,1900,149,237,1510,50761,50761,1747,50761,8,0
SD,2212,14062,0,64,135,379,759,180,197,1257,C,11,135,485619,39620,407151,38775,1900,149,65,613,16274,16274,678,16274,1,7
TN,9667,137807,0,568,828,379,759,180,197,4527,B,181,828,485619,39620,407151,38775,1900,149,478,5590,147474,147474,6068,147474,3,7
TX,24631,251390,0,1542,5109,379,759,180,197,10763,B,648,5109,485619,39620,407151,24631,1900,149,858,12347,276021,276021,13205,276021,25,0
UT,4123,91579,0,961,345,379,759,180,197,1568,C,41,345,485619,39620,407151,4123,1900,149,175,5321,95702,95702,5496,95702,0,16
VA,12970,63630,539,1436,2014,387,759,217,197,1815,B,448,2014,485619,39620,407151,12488,444,4,604,3354,77139,76600,3958,76600,12,72
VI,57,700,19,961,5109,379,759,180,197,51,D,4,5109,485619,39620,407151,38775,1900,149,2,7,776,757,9,757,1,0
VT,855,13518,0,34,5109,379,759,180,197,0,C,46,5109,485619,39620,407151,855,1900,149,3,248,14373,14373,251,14373,0,0
WA,15292,169749,0,508,5109,145,759,180,197,0,B,738,5109,485619,39620,407151,14354,1900,149,182,1596,185041,185041,1778,185041,73,0
WI,6963,59235,197,337,1397,136,353,180,197,0,A,272,1397,485619,39620,407151,5911,1900,149,248,2097,66395,66198,2345,66198,6,21
WV,1044,38019,0,100,5109,38,759,20,197,455,B,34,5109,485619,39620,407151,38775,1900,149,24,6073,39063,39063,6097,39063,2,0
WY,362,7797,0,16,54,379,759,180,197,334,C,7,54,485619,39620,407151,362,1900,149,13,0,8159,8159,13,8159,0,0
AK,339,15393,0,32,5109,379,759,180,197,217,B,9,5109,15732,39620,407151,339,1900,149,0,3451,15732,15732,3451,15732,0,0
AL,6137,65207,0,351,839,379,288,180,170,0,B,212,839,485619,39620,407151,6137,1900,149,305,18344,71344,71344,18649,71344,15,71
AR,2829,35224,0,104,291,379,759,25,57,964,B,47,291,485619,39620,407151,2829,1900,149,88,2387,38053,38053,2475,38053,2,0
AS,0,3,17,961,5109,379,759,180,197,0,F,0,5109,485619,39620,407151,0,1900,149,0,0,20,3,0,3,0,0
AZ,6280,56228,0,697,1672,313,759,191,197,1345,A+,266,1672,62508,39620,407151,38775,1900,149,235,1559,62508,62508,1794,62508,0,46
CA,41137,464898,0,4847,5109,1458,759,180,197,0,B,1651,5109,506035,39620,407151,38775,1900,149,1883,9979,506035,506035,11862,506035,89,0
CO,12256,44533,0,1084,2366,379,759,180,197,2086,B,674,2366,485619,39620,407151,10995,1900,149,994,3471,56789,56789,4465,56789,122,129
CT,24582,53020,0,1810,5109,379,759,180,197,0,C,1862,5109,77602,39620,407151,38775,1331,149,661,2903,77602,77602,3564,77602,98,0
DC,3699,13603,0,402,5109,120,759,69,197,652,B,165,5109,485619,39620,407151,38775,1900,149,171,598,17302,17302,769,17302,12,0
DE,3576,14122,0,300,5109,379,759,180,197,809,B,155,5109,485619,39620,407151,38775,136,19,134,185,17698,17698,319,17698,8,0
FL,30839,302260,1292,961,5045,379,759,180,197,0,C,1075,5045,485619,39620,407151,38775,1900,149,665,15475,334391,333099,16140,333099,44,157
GA,22695,96319,0,961,4326,379,759,180,197,0,B,904,4326,119014,39620,407151,38775,1900,149,548,11290,119014,119014,11838,119014,12,105
GU,141,1308,0,2,5109,379,759,180,197,128,D,5,5109,485619,39620,407151,38775,1900,149,0,75,1449,1449,75,1449,0,0
HI,601,27439,0,961,67,379,759,180,197,463,C,13,67,485619,39620,407151,38775,1900,149,5,1148,28040,28040,1153,28040,1,4
IA,5092,29258,0,293,5109,108,759,60,197,1723,B,112,5109,485619,39620,407151,5092,1900,149,647,1730,34350,34350,2377,34350,5,0
ID,1870,17611,0,35,168,379,71,180,197,867,C,54,168,19481,39620,407151,38775,1900,149,34,0,19481,19481,34,19481,0,2
IL,41777,159840,0,4699,5109,1244,759,763,197,0,A,1874,5109,485619,39620,407151,38775,1900,149,2119,9866,201617,201617,11985,201617,79,0
IN,14395,65379,0,1515,5109,598,759,324,197,0,B,785,5109,485619,39620,407151,38775,1900,149,715,3506,79774,79774,4221,79774,44,0
KS,3056,22143,0,961,474,379,759,180,197,0,C,117,474,485619,39620,407151,38775,1900,149,279,1332,25199,25199,1611,25199,6,17
KY,3779,41183,0,303,1143,164,575,180,197,1341,A,200,1143,485619,39620,407151,38775,1900,149,298,1820,44962,44962,2118,44962,9,28
LA,26512,112490,0,1700,5109,379,759,268,197,14927,B,1644,5109,485619,39620,407151,38775,1900,149,372,518,139002,139002,890,139002,43,0
MA,53348,173497,0,3879,4965,1058,759,180,197,0,B,2877,4965,485619,39620,407151,38775,1900,149,2379,9253,226845,226845,11632,226845,0,213
MD,17766,71357,0,1408,3760,538,759,180,197,1165,A,948,3760,485619,39620,407151,17766,900,48,1150,3257,89123,89123,4407,89123,49,142
ME,990,16784,0,39,156,17,759,7,197,519,B,50,156,485619,39620,407151,38775,1900,149,25,0,17774,17774,25,17774,3,4
MI,43263,128955,0,2889,5109,1164,759,934,197,8342,A+,3929,5109,176663,47708,128955,42027,3846,184,533,5901,172218,172218,6434,172218,111,0
MN,5127,56982,0,288,797,109,291,180,197,1410,A,244,797,62109,39620,407151,38775,1900,149,339,2276,62109,62109,2615,62109,23,41
MO,6826,60392,0,850,5109,379,759,142,197,0,B,273,5109,69988,7919,61965,38775,1900,149,201,1810,67218,67218,2011,67218,11,0
MP,14,51,0,961,5109,379,759,180,197,11,D,2,5109,485619,39620,407151,38775,1900,149,0,0,65,65,0,65,0,0
MS,5718,53239,0,649,996,152,759,78,197,0,B,221,996,485619,39620,407151,38775,1900,149,284,3003,58957,58957,3287,58957,12,26
MT,445,12052,0,11,61,379,759,180,197,339,C,14,61,485619,39620,407151,38775,1900,149,1,369,12497,12497,370,12497,0,2
NC,8623,96642,0,456,5109,379,759,180,197,0,B,289,5109,485619,39620,407151,38775,1900,149,571,4110,105265,105265,4681,105265,20,0
ND,803,18547,0,17,70,379,759,180,197,310,C,16,70,485619,39620,407151,38775,1900,149,55,1846,19350,19350,1901,19350,1,3
NE,2421,17552,0,961,5109,379,759,180,197,0,D,50,5109,485619,39620,407151,38775,1900,149,297,1064,19973,19973,1361,19973,3,0
NH,1720,16007,398,89,224,379,759,180,197,578,C,53,224,485619,39620,407151,38775,1900,149,50,868,18125,17727,918,17727,2,6
NJ,105523,108163,0,6722,5109,1971,759,1442,197,0,A,5863,5109,485619,39620,407151,38775,1900,149,3327,4397,213686,213686,7724,213686,246,0
NM,2521,48989,0,152,412,379,759,180,197,614,C,84,412,485619,39620,407151,38775,1900,149,142,4805,51510,51510,4947,51510,6,45
NV,4539,32669,0,961,5109,379,759,180,197,0,F,229,5109,485619,39620,407151,38775,1900,149,141,875,37208,37208,1016,37208,13,0
NY,282143,495425,0,13524,72444,4410,759,180,197,47935,B,16599,72444,485619,39620,407151,38775,1900,149,10553,36359,777568,777568,46912,777568,437,1071
OH,15587,96396,0,961,3115,379,938,180,197,0,B,711,3115,485619,39620,407151,14983,671,40,418,3868,111983,111983,4286,111983,21,62
OK,3193,49891,0,306,637,150,759,180,197,2080,A,194,637,485619,39620,407151,38775,1900,149,72,6872,53084,53084,6944,53084,6,0
OR,2253,45124,0,261,536,60,759,29,197,0,B,87,536,485619,39620,407151,38775,1900,149,76,1809,47377,47377,1885,47377,1,16
PA,40049,152886,0,2748,5109,379,759,640,197,0,B,1537,5109,485619,39620,407151,38775,1900,149,1397,5395,192935,192935,6792,192935,45,0
PR,1307,9313,1940,137,5109,379,759,180,197,0,D,83,5109,485619,39620,407151,38775,1900,149,31,0,12560,10620,31,10620,6,0
RI,7493,40860,0,263,576,77,759,52,197,410,A+,215,576,55513,8151,47362,7493,1900,149,305,1789,48353,48353,2094,48353,13,0
SC,5253,43761,0,961,944,379,759,180,197,3701,B,166,944,485619,39620,407151,38775,1900,149,336,4215,49014,49014,4551,49014,16,107
SD,2147,13449,0,61,128,379,759,180,197,1223,C,10,128,485619,39620,407151,38775,1900,149,107,665,15596,15596,772,15596,0,4
TN,9189,132217,0,510,821,379,759,180,197,4467,B,178,821,485619,39620,407151,38775,1900,149,463,9615,141406,141406,10078,141406,10,13
TX,23773,239043,0,1597,5109,379,759,180,197,9986,B,623,5109,485619,39620,407151,23773,1900,149,967,19302,262816,262816,20269,262816,30,0
UT,3948,86258,0,961,329,379,759,180,197,1399,C,41,329,485619,39620,407151,3948,1900,149,166,5343,90206,90206,5509,90206,2,14
VA,12366,60276,1405,1405,1942,357,759,223,197,1717,B,436,1942,485619,39620,407151,11902,432,4,772,2430,74047,72642,3202,72642,26,105
VI,55,693,22,961,5109,379,759,180,197,51,D,3,5109,485619,39620,407151,38775,1900,149,1,51,770,748,52,748,0,0
VT,852,13270,0,37,5109,379,759,180,197,0,C,46,5109,485619,39620,407151,852,1900,149,9,462,14122,14122,471,14122,2,0
WA,15110,168153,0,455,5109,174,759,180,197,0,B,665,5109,485619,39620,407151,14243,1900,149,197,2814,183263,183263,3011,183263,6,0
WI,6715,57138,241,337,1376,136,353,180,197,0,A,266,1376,485619,39620,407151,5687,1900,149,351,2565,64094,63853,2916,63853,4,23
WV,1020,31946,0,97,5109,36,759,19,197,439,B,32,5109,485619,39620,407151,38775,1900,149,32,3123,32966,32966,3155,32966,0,0
WY,349,7797,0,16,54,379,759,180,197,321,C,7,54,485619,39620,407151,349,1900,149,0,101,8146,8146,101,8146,0,0
AK,339,11942,0,36,5109,379,759,180,197,208,A,9,5109,12281,39620,407151,339,1900,149,2,118,12281,12281,120,12281,0,0
AL,5832,46863,0,429,768,379,288,180,170,0,B,197,768,485619,39620,407151,5832,1900,149,54,0,52695,52695,54,52695,0,0
AR,2741,32837,0,101,291,379,759,24,57,929,A,45,291,485619,39620,407151,2741,1900,149,276,3712,35578,35578,3988,35578,0,0
AS,0,3,17,961,5109,379,759,180,197,0,,1400,5109,485619,39620,407151,0,1900,149,0,0,20,3,0,3,0,0
AZ,6045,54669,0,639,1626,332,759,186,197,1313,B,266,1626,60714,39620,407151,38775,1900,149,276,1741,60714,60714,2017,60714,17,54
CA,39254,454919,0,4880,5109,1521,759,180,197,0,B,1562,5109,494173,39620,407151,38775,1900,149,1885,10191,494173,494173,12076,494173,93,0
CO,11262,41062,0,1084,2237,379,759,180,197,0,A,552,2237,485619,39620,407151,10208,1900,149,384,1295,52324,52324,1679,52324,44,114
CT,23921,50117,0,1877,5109,379,759,180,197,0,A,1764,5109,74038,39620,407151,38775,1086,149,821,1720,74038,74038,2541,74038,125,0
DC,3528,13005,0,402,5109,120,759,69,197,651,A,153,5109,485619,39620,407151,38775,1900,149,167,436,16533,16533,603,16533,14,0
DE,3442,13937,0,277,5109,379,759,180,197,703,A,147,5109,485619,39620,407151,38775,128,19,134,333,17379,17379,467,17379,16,0
FL,30174,286785,1287,961,4888,379,759,180,197,0,A,1031,4888,485619,39620,407151,38775,1900,149,1342,18909,318246,316959,20251,316959,52,195
GA,22147,85029,0,961,4221,379,759,180,197,0,A,892,4221,107176,39620,407151,38775,1900,149,635,5479,107176,107176,6114,107176,20,152
GU,141,1233,0,2,5109,379,759,180,197,126,,5,5109,485619,39620,407151,38775,1900,149,6,53,1374,1374,59,1374,0,0
HI,596,26291,0,961,63,379,759,180,197,455,A,12,63,485619,39620,407151,38775,1900,149,4,755,26887,26887,759,26887,0,0
IA,4445,27528,0,278,5109,104,759,60,197,1604,A,107,5109,485619,39620,407151,4445,1900,149,521,2190,31973,31973,2711,31973,11,0
ID,1836,17611,0,31,166,379,63,180,197,822,A,54,166,19447,39620,407151,38775,1900,149,34,241,19447,19447,275,19447,0,4
IL,39658,149974,0,4828,5109,1225,759,709,197,0,A,1795,5109,485619,39620,407151,38775,1900,149,2724,13592,189632,189632,16316,189632,107,0
IN,13680,61873,0,961,5109,621,759,325,197,0,B,741,5109,485619,39620,407151,38775,1900,149,641,2872,75553,75553,3513,75553,35,0
KS,2777,20811,0,961,457,379,759,180,197,0,B,111,457,485619,39620,407151,38775,1900,149,295,1975,23588,23588,2270,23588,-1,15
KY,3481,39363,0,302,1115,163,570,180,197,1335,A,191,1115,485619,39620,407151,38775,1900,149,108,6661,42844,42844,6769,42844,6,10
LA,26140,111972,0,1697,5109,379,759,286,197,14927,A,1601,5109,485619,39620,407151,38775,1900,149,401,198,138112,138112,599,138112,61,0
MA,50969,164244,0,3847,4752,1034,759,180,197,0,B,2877,4752,485619,39620,407151,38775,1900,149,2977,7920,215213,215213,10897,215213,108,259
MD,16616,68100,0,1425,3618,547,759,180,197,1108,A,899,3618,485619,39620,407151,16616,853,46,879,3737,84716,84716,4616,84716,68,141
ME,965,16784,0,39,152,17,759,7,197,499,A,47,152,485619,39620,407151,38775,1900,149,28,0,17749,17749,28,17749,3,2
MI,42730,123054,0,3022,5109,1176,759,965,197,3237,B,3818,5109,169942,46888,123054,41548,3745,182,1036,8049,165784,165784,9085,165784,107,0
MN,4788,54706,0,278,756,111,281,180,197,1373,A,221,756,59494,39620,407151,38775,1900,149,518,2562,59494,59494,3080,59494,21,44
MO,6625,58582,0,877,5109,379,759,180,197,0,A,262,5109,67165,7639,59430,38775,1900,149,304,5453,65207,65207,5757,65207,44,0
MP,14,51,0,961,5109,379,759,180,197,11,,2,5109,485619,39620,407151,38775,1900,149,0,0,65,65,0,65,0,0
MS,5434,50236,0,586,970,148,759,74,197,0,A,209,970,485619,39620,407151,38775,1900,149,281,0,55670,55670,281,55670,8,24
MT,444,11683,0,12,59,379,759,180,197,325,A,14,59,485619,39620,407151,38775,1900,149,2,250,12127,12127,252,12127,0,0
NC,8052,92532,0,477,5109,379,759,180,197,0,A,269,5109,485619,39620,407151,38775,1900,149,444,3955,100584,100584,4399,100584,16,0
ND,748,16701,0,17,67,379,759,180,197,285,B,15,67,485619,39620,407151,38775,1900,149,39,1080,17449,17449,1119,17449,0,2
NE,2124,16488,0,961,5109,379,759,180,197,0,A,47,5109,485619,39620,407151,38775,1900,149,311,941,18612,18612,1252,18612,2,0
NH,1670,15139,424,92,218,379,759,180,197,551,B,51,218,485619,39620,407151,38775,1900,149,82,715,17233,16809,797,16809,3,5
NJ,102196,103766,0,6847,5109,1933,759,1487,197,0,A,5617,5109,485619,39620,407151,38775,1900,149,2207,3607,205962,205962,5814,205962,249,0
NM,2379,44184,0,123,367,379,759,180,197,573,A,78,367,485619,39620,407151,38775,1900,149,169,5162,46563,46563,5331,46563,7,36
NV,4398,31794,0,961,5109,379,759,180,197,0,A,216,5109,485619,39620,407151,38775,1900,149,190,1253,36192,36192,1443,36192,6,0
NY,271590,459066,0,14258,71373,4540,759,180,197,46156,A,16162,71373,485619,39620,407151,38775,1900,149,8130,26606,730656,730656,34736,730656,422,1191
OH,15169,92528,0,961,3053,379,920,180,197,0,B,690,3053,485619,39620,407151,14581,649,41,475,4345,107697,107697,4820,107697,34,93
OK,3121,43019,0,310,637,155,759,180,197,1961,B,188,637,485619,39620,407151,38775,1900,149,104,0,46140,46140,104,46140,9,15
OR,2177,43315,0,258,520,56,759,29,197,0,A,86,520,485619,39620,407151,38775,1900,149,50,1466,45492,45492,1516,45492,3,8
PA,38652,147491,0,2746,5109,379,759,679,197,0,A,1492,5109,485619,39620,407151,38775,1900,149,1599,5430,186143,186143,7029,186143,71,0
PR,1276,9313,1940,172,5109,379,759,180,197,0,A,77,5109,485619,39620,407151,38775,1900,149,361,0,12529,10589,361,10589,8,0
RI,7188,39071,0,267,576,77,759,48,197,377,B,202,576,52909,7757,45152,7188,1900,149,415,2648,46259,46259,3063,46259,-11,-181
SC,4917,39546,0,961,837,379,759,180,197,3317,B,150,837,485619,39620,407151,38775,1900,149,0,0,44463,44463,0,44463,0,0
SD,2040,12784,0,61,124,379,759,180,197,1190,A,10,124,485619,39620,407151,38775,1900,149,84,675,14824,14824,759,14824,1,5
TN,8726,122602,0,593,808,379,759,180,197,4370,A,168,808,485619,39620,407151,38775,1900,149,460,7768,131328,131328,8228,131328,-2,15
TX,22806,219741,0,1674,5109,379,759,180,197,9156,A,593,5109,485619,39620,407151,22806,1900,149,862,16607,242547,242547,17469,242547,32,0
UT,3782,80915,0,961,315,379,759,180,197,1252,A,39,315,485619,39620,407151,3782,1900,149,170,3900,84697,84697,4070,84697,4,14
VA,11594,57846,487,1399,1837,379,759,220,197,1672,A,410,1837,485619,39620,407151,11169,407,3,596,3955,69927,69440,4551,69440,38,84
VI,54,642,35,961,5109,379,759,180,197,50,,3,5109,485619,39620,407151,38775,1900,149,0,59,731,696,59,696,0,0
VT,843,12808,0,32,5109,379,759,180,197,0,A,44,5109,485619,39620,407151,843,1900,149,9,388,13651,13651,397,13651,1,0
WA,14913,165339,0,551,5109,164,759,180,197,0,C,659,5109,485619,39620,407151,14076,1900,149,285,5224,180252,180252,5509,180252,5,0
WI,6364,54573,206,361,1353,143,346,180,197,0,A,262,1353,485619,39620,407151,5356,1900,149,353,3117,61143,60937,3470,60937,5,35
WV,988,28823,0,97,5109,36,759,19,197,439,B,32,5109,485619,39620,407151,38775,1900,149,21,1885,29811,29811,1906,29811,3,0
WY,349,7696,0,16,54,379,759,180,197,321,A,7,54,485619,39620,407151,332,1900,149,23,455,8045,8045,478,8045,0,2
AK,337,11824,0,42,5109,379,759,180,197,209,A,9,5109,12161,39620,407151,337,1900,149,2,0,12161,12161,2,12161,0,-36
AL,5778,46863,0,406,768,379,288,180,170,0,B,197,768,485619,39620,407151,5778,1900,149,313,3568,52641,52641,3881,52641,3,38
AR,2465,29125,0,101,291,379,759,24,57,902,A,45,291,485619,39620,407151,2465,1900,149,189,1688,31590,31590,1877,31590,3,0
AS,0,3,17,961,5109,379,759,180,197,0,,1400,5109,485619,39620,407151,0,1900,149,0,0,20,3,0,3,0,0
AZ,5769,52928,0,699,1572,305,759,201,197,1282,B,249,1572,58697,39620,407151,38775,1900,149,310,1786,58697,58697,2096,58697,20,44
CA,37369,444728,0,4929,5109,1531,759,180,197,0,B,1469,5109,482097,39620,407151,38775,1900,149,1973,14797,482097,482097,16770,482097,115,0
CO,10878,39767,0,859,2123,379,759,180,197,0,A,508,2123,485619,39620,407151,38775,1900,149,431,1510,50645,50645,1941,50645,22,120
CT,23100,48397,0,1947,5109,379,759,180,197,0,A,1639,5109,71497,39620,407151,38775,1036,149,631,948,71497,71497,1579,71497,95,0
DC,3361,12569,0,402,5109,120,759,200,197,648,A,139,5109,485619,39620,407151,38775,1900,149,155,273,15930,15930,428,15930,12,0
DE,3308,13604,0,290,5109,379,759,180,197,643,A,131,5109,485619,39620,407151,38775,114,17,108,251,16912,16912,359,16912,14,0
FL,28832,267876,1301,961,4693,379,759,180,197,0,A,979,4693,485619,39620,407151,38775,1900,149,523,7558,298009,296708,8081,296708,69,224
GA,21512,79550,0,961,4069,379,759,180,197,0,A,872,4069,101062,39620,407151,38775,1900,149,772,6218,101062,101062,6990,101062,36,110
GU,135,1180,0,2,5109,379,759,180,197,126,,5,5109,485619,39620,407151,38775,1900,149,1,94,1315,1315,95,1315,0,0
HI,592,25536,0,961,63,379,759,180,197,444,A,12,63,485619,39620,407151,38775,1900,149,6,776,26128,26128,782,26128,0,7
IA,3924,25338,0,282,5109,102,759,55,197,1492,A,96,5109,485619,39620,407151,3924,1900,149,176,842,29262,29262,1018,29262,6,0
ID,1802,17370,0,52,162,379,60,180,197,767,A,54,162,19172,39620,407151,38775,1900,149,36,966,19172,19172,1002,19172,3,4
IL,36934,136382,0,4877,5109,1268,759,766,197,0,A,1688,5109,485619,39620,407151,38775,1900,149,1826,7144,173316,173316,8970,173316,123,0
IN,13039,59001,0,961,5109,652,759,333,197,0,B,706,5109,485619,39620,407151,38775,1900,149,601,1969,72040,72040,2570,72040,45,0
KS,2482,18836,0,961,442,379,759,180,197,0,B,112,442,485619,39620,407151,38775,1900,149,271,844,21318,21318,1115,21318,2,10
KY,3373,32702,0,301,1105,161,564,180,197,1311,A,185,1105,485619,39620,407151,38775,1900,149,181,2566,36075,36075,2747,36075,14,29
LA,25739,111774,0,1727,5109,379,759,274,197,14927,A,1540,5109,485619,39620,407151,38775,1900,149,481,186,137513,137513,667,137513,67,0
MA,47992,156324,0,3851,4493,1034,759,180,197,0,B,2769,4493,485619,39620,407151,38775,1900,149,3079,11535,204316,204316,14614,204316,172,237
MD,15737,64363,0,1405,3477,515,759,180,197,1040,A,831,3477,485619,39620,407151,15737,789,42,962,2609,80100,80100,3571,80100,52,152
ME,937,16784,0,42,150,18,759,11,197,485,A,44,150,485619,39620,407151,38775,1900,149,30,0,17721,17721,30,17721,5,6
MI,41694,115005,0,3611,5109,1148,759,1027,197,3237,B,3711,5109,160853,45848,115005,41066,3636,180,989,8352,156699,156699,9341,156699,109,0
MN,4270,52144,0,268,712,104,274,180,197,1336,A,200,712,56414,39620,407151,38775,1900,149,512,1979,56414,56414,2491,56414,21,52
MO,6321,53129,0,884,5109,379,759,180,197,0,A,218,5109,64187,7361,56736,38775,1900,149,184,1110,59450,59450,1294,59450,10,0
MP,14,51,0,961,5109,379,759,180,197,11,,2,5109,485619,39620,407151,38775,1900,149,0,0,65,65,0,65,0,0
MS,5153,50236,0,595,946,156,759,78,197,0,A,201,946,485619,39620,407151,38775,1900,149,259,1295,55389,55389,1554,55389,8,36
MT,442,11433,0,13,59,379,759,180,197,306,A,14,59,485619,39620,407151,38775,1900,149,3,289,11875,11875,292,11875,0,0
NC,7608,88577,0,486,5109,379,759,180,197,0,A,253,5109,485619,39620,407151,38775,1900,149,388,5461,96185,96185,5849,96185,11,0
ND,709,15621,0,18,65,379,759,180,197,269,B,15,65,485619,39620,407151,38775,1900,149,30,711,16330,16330,741,16330,1,3
NE,1813,15547,0,961,5109,379,759,180,197,0,A,45,5109,485619,39620,407151,38775,1900,149,91,590,17360,17360,681,17360,7,0
NH,1588,14424,265,91,213,379,759,180,197,550,B,48,213,485619,39620,407151,38775,1900,149,97,874,16277,16012,971,16012,6,7
NJ,99989,100159,0,7240,5109,1990,759,1462,197,0,A,5368,5109,485619,39620,407151,38775,1900,149,4124,4365,200148,200148,8489,200148,305,0
NM,2210,39022,0,121,331,379,759,180,197,547,A,71,331,485619,39620,407151,38775,1900,149,138,217,41232,41232,355,41232,6,25
NV,4208,30541,0,961,5109,379,759,180,197,0,A,210,5109,485619,39620,407151,38775,1900,149,127,734,34749,34749,861,34749,9,0
NY,263460,432460,0,15021,70182,4597,759,180,197,44244,A,15740,70182,485619,39620,407151,38775,1900,149,6244,19694,695920,695920,25938,695920,438,1409
OH,14694,88183,0,961,2960,379,900,180,197,0,B,656,2960,485619,39620,407151,14142,618,38,577,3794,102877,102877,4371,102877,46,78
OK,3017,43019,0,284,622,156,759,180,197,1884,B,179,622,485619,39620,407151,38775,1900,149,123,0,46036,46036,123,46036,9,34
OR,2127,41849,0,304,512,74,759,36,197,0,A,83,512,485619,39620,407151,38775,1900,149,68,2723,43976,43976,2791,43976,5,24
PA,37053,142061,0,2750,5109,379,759,679,197,0,A,1421,5109,485619,39620,407151,38775,1900,149,1369,5789,179114,179114,7158,179114,-201,0
PR,915,9313,1951,154,5109,379,759,180,197,0,A,69,5109,485619,39620,407151,38775,1900,149,0,471,12179,10228,471,10228,2,0
RI,6773,36423,0,316,757,72,759,45,197,342,B,213,757,49123,7263,41860,6773,1900,149,419,1895,43196,43196,2314,43196,12,40
SC,4917,39546,0,961,837,379,759,180,197,3317,B,150,837,485619,39620,407151,38775,1900,149,156,1196,44463,44463,1352,44463,10,0
SD,1956,12109,0,58,119,379,759,180,197,1064,A,9,119,485619,39620,407151,38775,1900,149,98,521,14065,14065,619,14065,1,8
TN,8266,114834,0,488,793,379,759,180,197,4193,A,170,793,485619,39620,407151,38775,1900,149,424,7696,123100,123100,8120,123100,4,18
TX,21944,203134,0,1649,5109,379,759,180,197,8025,A,561,5109,485619,39620,407151,21944,1900,149,875,7420,225078,225078,8295,225078,18,0
UT,3612,77015,0,961,301,379,759,180,197,1050,A,35,301,485619,39620,407151,3612,1900,149,167,4000,80627,80627,4167,80627,1,13
VA,10998,53891,492,1379,1753,400,759,249,197,1567,A,372,1753,485619,39620,407151,10627,370,2,732,3379,65381,64889,4111,64889,23,94
VI,54,583,31,961,5109,379,759,180,197,48,,3,5109,485619,39620,407151,38775,1900,149,0,0,668,637,0,637,0,0
VT,834,12420,0,44,5109,379,759,180,197,0,A,43,5109,485619,39620,407151,834,1900,149,3,323,13254,13254,326,13254,3,0
WA,14628,160115,0,544,5109,151,759,180,197,0,C,654,5109,485619,39620,407151,13726,1900,149,253,4085,174743,174743,4338,174743,7,0
WI,6011,51456,201,349,1318,146,342,180,197,0,A,257,1318,485619,39620,407151,5052,1900,149,245,1954,57668,57467,2199,57467,11,16
WV,967,26938,0,108,5109,44,759,24,197,380,B,29,5109,485619,39620,407151,38775,1900,149,28,2041,27905,27905,2069,27905,3,0
WY,326,7241,0,961,52,379,759,180,197,275,A,7,52,485619,39620,407151,325,1900,149,4,-60,7567,7567,-56,7567,1,0
AK,335,11824,0,39,36,379,759,180,197,196,A,9,36,12159,39620,407151,335,1900,149,6,1034,12159,12159,1040,12159,0,0
AL,5465,43295,0,440,730,379,288,180,170,0,B,194,730,485619,39620,407151,5465,1900,149,234,0,48760,48760,234,48760,17,31
AR,2276,27437,0,97,291,379,759,23,57,863,A,42,291,485619,39620,407151,2276,1900,149,49,2223,29713,29713,2272,29713,-1,0
AS,0,3,17,961,5109,379,759,180,197,0,,1400,5109,485619,39620,407151,0,1900,149,0,0,20,3,0,3,0,0
AZ,5459,51142,0,664,1528,300,759,195,197,1265,B,229,1528,56601,39620,407151,38775,1900,149,208,1241,56601,56601,1449,56601,21,44
CA,35396,429931,0,4984,5109,1551,759,180,197,0,B,1354,5109,465327,39620,407151,38775,1900,149,2135,163092,465327,465327,165227,465327,86,0
CO,10447,38257,0,851,2003,379,759,180,197,0,A,486,2003,485619,39620,407151,38775,1900,149,341,897,48704,48704,1238,48704,37,123
CT,22469,47449,0,1972,5109,379,759,180,197,0,A,1544,5109,69918,39620,407151,38775,1036,149,2109,3617,69918,69918,5726,69918,121,0
DC,3206,12296,0,402,5109,120,759,69,197,645,A,127,5109,485619,39620,407151,38775,1900,149,108,455,15502,15502,563,15502,15,0
DE,3200,13353,0,269,5109,379,759,180,197,599,A,117,5109,485619,39620,407151,38775,103,14,269,418,16553,16553,687,16553,13,0
FL,28309,260318,1258,961,4469,379,759,180,197,0,A,910,4469,485619,39620,407151,38775,1900,149,814,10754,289885,288627,11568,288627,54,234
GA,20740,73332,0,961,3959,379,759,180,197,0,A,836,3959,94072,39620,407151,38775,1900,149,859,5073,94072,94072,5932,94072,37,180
GU,134,1086,0,3,5109,2,759,180,197,119,,5,5109,485619,39620,407151,38775,1900,149,1,53,1220,1220,54,1220,0,0
HI,586,24760,0,961,56,379,759,180,197,437,A,12,56,485619,39620,407151,38775,1900,149,2,648,25346,25346,650,25346,2,1
IA,3748,24496,0,272,5109,92,759,57,197,1428,A,90,5109,485619,39620,407151,3748,1900,149,107,522,28244,28244,629,28244,7,0
ID,1766,16404,0,54,158,379,58,180,197,710,A,51,158,18170,39620,407151,38775,1900,149,30,333,18170,18170,363,18170,3,1
IL,35108,129238,0,4665,5109,1220,759,747,197,0,A,1565,5109,485619,39620,407151,38775,1900,149,2049,7300,164346,164346,9349,164346,97,0
IN,12438,57032,0,961,5109,633,759,334,197,0,B,661,5109,485619,39620,407151,38775,1900,149,341,1865,69470,69470,2206,69470,31,0
KS,2211,17992,0,961,432,379,759,180,197,0,B,110,432,485619,39620,407151,38775,1900,149,186,916,20203,20203,1102,20203,3,13
KY,3192,30136,0,286,1076,165,558,180,197,1266,A,171,1076,485619,39620,407151,38775,1900,149,142,366,33328,33328,508,33328,17,17
LA,25258,111588,0,1747,5109,379,759,287,197,14927,A,1473,5109,485619,39620,407151,38775,1900,149,404,0,136846,136846,404,136846,68,0
MA,44913,144789,0,3890,4256,1050,759,180,197,0,B,2597,4256,485619,39620,407151,38775,1900,149,1745,3345,189702,189702,5090,189702,148,247
MD,14775,61754,0,1432,3325,527,759,180,197,981,A,779,3325,485619,39620,407151,14775,738,41,582,2312,76529,76529,2894,76529,47,167
ME,907,16784,0,42,144,18,759,10,197,455,A,39,144,485619,39620,407151,38775,1900,149,19,2708,17691,17691,2727,17691,3,5
MI,40705,106653,0,3305,5109,1350,759,1065,197,3237,B,3602,5109,151154,44501,106653,40145,3531,174,1116,6986,147358,147358,8102,147358,131,0
MN,3758,50165,0,240,660,107,262,180,197,1138,A,179,660,53923,39620,407151,38775,1900,149,306,1824,53923,53923,2130,53923,19,31
MO,6137,52019,0,1001,5109,379,759,180,197,0,A,208,5109,61646,7085,54480,38775,1900,149,196,840,58156,58156,1036,58156,19,0
MP,14,51,0,961,5109,379,759,180,197,11,,2,5109,485619,39620,407151,38775,1900,149,0,0,65,65,0,65,0,0
MS,4894,48941,0,628,910,162,759,86,197,0,A,193,910,485619,39620,407151,38775,1900,149,178,1293,53835,53835,1471,53835,10,52
MT,439,11144,0,13,59,379,759,180,197,296,A,14,59,485619,39620,407151,38775,1900,149,2,340,11583,11583,342,11583,2,0
NC,7220,83116,0,434,5109,379,759,180,197,0,A,242,5109,485619,39620,407151,38775,1900,149,269,6736,90336,90336,7005,90336,29,0
ND,679,14910,0,23,62,379,759,180,197,229,B,14,62,485619,39620,407151,38775,1900,149,35,567,15589,15589,602,15589,1,8
NE,1722,14957,0,961,5109,379,759,180,197,0,A,38,5109,485619,39620,407151,38775,1900,149,74,233,16679,16679,307,16679,5,0
NH,1491,13550,225,94,206,379,759,180,197,546,B,42,206,485619,39620,407151,38775,1900,149,0,702,15266,15041,702,15041,0,0
NJ,95865,95794,0,7210,5109,1983,759,1570,197,0,A,5063,5109,485619,39620,407151,38775,1900,149,3478,3355,191659,191659,6833,191659,310,0
NM,2072,38805,0,119,306,379,759,180,197,529,A,65,306,485619,39620,407151,38775,1900,149,101,2021,40877,40877,2122,40877,7,15
NV,4081,29807,0,961,5109,379,759,180,197,0,A,201,5109,485619,39620,407151,38775,1900,149,144,689,33888,33888,833,33888,8,0
NY,257216,412766,0,15599,68773,4690,759,180,197,42308,A,15302,68773,485619,39620,407151,38775,1900,149,5526,15131,669982,669982,20657,669982,474,1502
OH,14117,84389,0,961,2882,379,880,180,197,0,B,610,2882,485619,39620,407151,13609,584,26,392,3400,98506,98506,3792,98506,53,103
OK,2894,43019,0,298,588,147,759,180,197,1772,B,170,588,485619,39620,407151,38775,1900,149,87,1482,45913,45913,1569,45913,6,27
OR,2059,39126,0,302,488,67,759,35,197,0,A,78,488,485619,39620,407151,38775,1900,149,57,0,41185,41185,57,41185,0,17
PA,35684,136272,0,2764,5109,379,759,685,197,0,A,1622,5109,485619,39620,407151,38775,1900,149,1156,3949,171956,171956,5105,171956,58,0
PR,915,8842,1954,140,5109,379,759,180,197,0,A,67,5109,485619,39620,407151,38775,1900,149,-383,53,11711,9757,-330,9757,3,0
RI,6354,34528,0,314,717,71,759,44,197,315,B,201,717,46170,6781,39389,6354,1900,149,382,1922,40882,40882,2304,40882,15,43
SC,4761,38350,0,961,837,379,759,180,197,3317,B,140,837,485619,39620,407151,38775,1900,149,322,1512,43111,43111,1834,43111,16,61
SD,1858,11588,0,62,111,379,759,180,197,937,A,8,111,485619,39620,407151,38775,1900,149,103,528,13446,13446,631,13446,0,11
TN,7842,107138,0,441,775,379,759,180,197,4012,A,166,775,485619,39620,407151,38775,1900,149,448,6350,114980,114980,6798,114980,9,15
TX,21069,195714,0,1678,5109,379,759,180,197,7341,A,543,5109,485619,39620,407151,21069,1900,149,873,10511,216783,216783,11384,216783,26,0
UT,3445,73015,0,961,288,379,759,180,197,970,A,34,288,485619,39620,407151,3445,1900,149,149,3953,76460,76460,4102,76460,2,11
VA,10266,50512,477,1374,1659,419,759,244,197,1497,A,349,1659,485619,39620,407151,9952,347,2,636,1788,61255,60778,2424,60778,25,78
VI,54,583,31,961,5109,379,759,180,197,48,,3,5109,485619,39620,407151,38775,1900,149,0,9,668,637,9,637,0,0
VT,831,12097,0,37,5109,379,759,180,197,0,A,40,5109,485619,39620,407151,831,1900,149,3,330,12928,12928,333,12928,0,0
WA,14375,156030,0,543,5109,161,759,180,197,0,C,647,5109,485619,39620,407151,13452,1900,149,242,4182,170405,170405,4424,170405,7,0
WI,5766,49502,229,355,1302,139,324,180,197,0,A,246,1302,485619,39620,407151,4845,1900,149,257,1661,55497,55268,1918,55268,4,50
WV,939,24897,0,103,5109,41,759,23,197,330,B,26,5109,485619,39620,407151,38775,1900,149,25,3048,25836,25836,3073,25836,0,0
WY,322,7301,0,19,52,379,759,180,197,254,A,6,52,485619,39620,407151,322,1900,149,2,0,7623,7623,2,7623,0,0
AK,329,10790,0,42,36,379,759,180,197,168,A,9,36,11119,39620,407151,329,1900,149,8,987,11119,11119,995,11119,0,0
AL,5231,43295,0,401,699,379,260,180,157,0,B,177,699,485619,39620,407151,5231,1900,149,206,2420,48526,48526,2626,48526,10,58
AR,2227,25214,0,86,291,379,759,27,57,809,A,43,291,485619,39620,407151,2227,1900,149,304,584,27441,27441,888,27441,1,0
AS,0,3,17,961,5109,379,759,180,197,0,,1400,5109,485619,39620,407151,0,1900,149,0,0,20,3,0,3,0,0
AZ,5251,49901,0,637,1484,285,759,181,197,1155,B,208,1484,55152,39620,407151,38775,1900,149,187,465,55152,55152,652,55152,21,30
CA,33261,266839,0,4886,5109,1502,759,180,197,0,B,1268,5109,300100,39620,407151,38775,1900,149,2283,7317,300100,300100,9600,300100,60,0
CO,10106,37360,0,861,1880,379,759,180,197,0,A,449,1880,485619,39620,407151,38775,1900,149,376,895,47466,47466,1271,47466,27,67
CT,20360,43832,0,1949,5109,379,759,180,197,0,A,1423,5109,64192,39620,407151,38775,971,149,545,841,64192,64192,1386,64192,92,0
DC,3098,11841,0,402,5109,120,759,69,197,636,A,112,5109,485619,39620,407151,38775,1900,149,171,655,14939,14939,826,14939,7,0
DE,2931,12935,0,263,5109,379,759,180,197,565,A,104,5109,485619,39620,407151,38775,92,12,186,427,15866,15866,613,15866,5,0
FL,27495,249564,1203,961,4235,379,759,180,197,0,A,856,4235,485619,39620,407151,38775,1900,149,835,9999,278262,277059,10834,277059,50,225
GA,19881,68259,0,961,3779,379,759,180,197,0,A,799,3779,88140,39620,407151,38775,1900,149,934,2878,88140,88140,3812,88140,66,229
GU,133,1033,0,3,5109,2,759,180,197,114,,5,5109,485619,39620,407151,38775,1900,149,0,42,1166,1166,42,1166,0,0
HI,584,24112,0,961,55,379,759,180,197,423,A,10,55,485619,39620,407151,38775,1900,149,4,517,24696,24696,521,24696,0,3
IA,3641,23974,0,214,5109,89,759,60,197,1293,A,83,5109,485619,39620,407151,3641,1900,149,482,1313,27615,27615,1795,27615,4,0
ID,1736,16071,0,69,157,379,58,180,197,660,A,48,157,17807,39620,407151,38775,1900,149,64,298,17807,17807,362,17807,3,6
IL,33059,121938,0,4776,5109,1226,759,781,197,0,A,1468,5109,485619,39620,407151,38775,1900,149,1551,5088,154997,154997,6639,154997,119,0
IN,12097,55167,0,961,5109,676,759,368,197,0,B,630,5109,485619,39620,407151,38775,1900,149,411,2214,67264,67264,2625,67264,61,0
KS,2025,17076,0,961,419,379,759,180,197,0,B,107,419,485619,39620,407151,38775,1900,149,39,301,19101,19101,340,19101,7,14
KY,3050,29770,0,263,1059,147,582,180,197,1174,A,154,1059,485619,39620,407151,38775,1900,149,90,158,32820,32820,248,32820,6,0
LA,24854,111588,0,1798,5109,379,759,297,197,0,A,1405,5109,485619,39620,407151,38775,1900,149,331,0,136442,136442,331,136442,77,0
MA,43168,141444,0,3977,4009,1040,759,180,197,0,B,2449,4009,485619,39620,407151,38775,1900,149,1752,5398,184612,184612,7150,184612,146,137
MD,14193,59442,0,1433,3158,526,759,180,197,930,A,732,3158,485619,39620,407151,14193,692,40,509,1729,73635,73635,2238,73635,49,144
ME,888,14076,0,40,139,16,759,8,197,443,A,36,139,485619,39620,407151,38775,1900,149,13,0,14964,14964,13,14964,1,1
MI,39589,99667,0,3357,5109,1346,759,1107,197,3237,B,3471,5109,142813,43146,99667,39267,3428,171,1095,6274,139256,139256,7369,139256,124,0
MN,3452,48341,0,237,629,117,253,180,197,1094,A,160,629,51793,39620,407151,38775,1900,149,262,1487,51793,51793,1749,51793,17,27
MO,5941,51179,0,1001,5109,379,759,180,197,0,A,189,5109,59056,6778,52207,38775,1900,149,134,973,57120,57120,1107,57120,12,0
MP,14,51,0,961,5109,379,759,180,197,11,,2,5109,485619,39620,407151,38775,1900,149,0,0,65,65,0,65,0,0
MS,4716,47648,0,548,858,146,759,89,197,0,A,183,858,485619,39620,407151,38775,1900,149,204,726,52364,52364,930,52364,14,39
MT,437,10804,0,14,59,379,759,180,197,273,A,12,59,485619,39620,407151,38775,1900,149,4,186,11241,11241,190,11241,2,2
NC,6951,76380,0,427,5109,379,759,180,197,0,A,213,5109,485619,39620,407151,38775,1900,149,187,3660,83331,83331,3847,83331,34,0
ND,644,14343,0,17,54,379,759,180,197,214,B,13,54,485619,39620,407151,38775,1900,149,17,223,14987,14987,240,14987,0,1
NE,1648,14724,0,961,5109,379,759,180,197,0,A,33,5109,485619,39620,407151,38775,1900,149,174,518,16372,16372,692,16372,5,0
NH,1491,12848,244,78,206,379,759,180,197,521,B,42,206,485619,39620,407151,38775,1900,149,99,122,14583,14339,221,14339,1,8
NJ,92387,92439,0,7594,5109,1930,759,1501,197,0,A,4753,5109,485619,39620,407151,38775,1900,149,3581,3188,184826,184826,6769,184826,376,0
NM,1971,36784,0,116,291,379,759,180,197,501,A,58,291,485619,39620,407151,38775,1900,149,126,1587,38755,38755,1713,38755,3,17
NV,3937,29118,0,961,5109,379,759,180,197,0,A,193,5109,485619,39620,407151,38775,1900,149,107,601,33055,33055,708,33055,13,0
NY,251690,397635,0,16135,67271,4729,759,180,197,40482,A,14828,67271,485619,39620,407151,38775,1900,149,4178,11286,649325,649325,15464,649325,481,1302
OH,13725,80989,0,961,2779,379,838,180,197,0,B,557,2779,485619,39620,407151,13250,538,19,806,3069,94714,94714,3875,94714,48,126
OK,2807,41537,0,346,561,164,759,180,197,1702,B,164,561,485619,39620,407151,38775,1900,149,127,8571,44344,44344,8698,44344,21,20
OR,2002,39126,0,297,471,70,759,35,197,0,A,78,471,485619,39620,407151,38775,1900,149,46,1037,41128,41128,1083,41128,3,6
PA,34528,132323,0,2743,5109,379,759,673,197,0,A,1564,5109,485619,39620,407151,38775,1900,149,1296,2603,166851,166851,3899,166851,360,0
PR,1298,8789,1761,117,5109,379,759,180,197,0,A,64,5109,485619,39620,407151,38775,1900,149,46,303,11848,10087,349,10087,1,0
RI,5972,32606,0,309,674,67,759,43,197,315,B,186,674,43352,6361,36991,5972,1900,149,387,1723,38578,38578,2110,38578,11,45
SC,4439,36838,0,961,776,379,759,180,197,2063,B,124,776,485619,39620,407151,38775,1900,149,62,735,41277,41277,797,41277,4,0
SD,1755,11060,0,65,100,379,759,180,197,824,A,8,100,485619,39620,407151,38775,1900,149,70,419,12815,12815,489,12815,1,13
TN,7394,100788,0,523,760,379,759,180,197,3828,A,157,760,485619,39620,407151,38775,1900,149,156,7337,108182,108182,7493,108182,5,30
TX,20196,185203,0,1419,5109,379,759,180,197,6486,A,517,5109,485619,39620,407151,20196,1900,149,738,14267,205399,205399,15005,205399,22,0
UT,3296,69062,0,961,277,379,759,180,197,888,A,32,277,485619,39620,407151,3296,1900,149,83,3964,72358,72358,4047,72358,4,9
VA,9630,48724,477,1331,1581,403,759,251,197,1418,A,324,1581,485619,39620,407151,9451,321,3,640,979,58831,58354,1619,58354,24,81
VI,54,574,35,961,5109,379,759,180,197,48,,3,5109,485619,39620,407151,38775,1900,149,1,20,663,628,21,628,0,0
VT,828,11767,0,41,5109,379,759,180,197,0,A,40,5109,485619,39620,407151,828,1900,149,8,96,12595,12595,104,12595,2,0
WA,14133,151848,0,503,5109,161,759,180,197,0,C,640,5109,485619,39620,407151,13170,1900,149,243,3959,165981,165981,4202,165981,11,0
WI,5509,47841,219,358,1252,137,324,180,197,0,A,242,1252,485619,39620,407151,4620,1900,149,156,1238,53569,53350,1394,53350,12,41
WV,914,21849,0,85,5109,42,759,24,197,330,B,26,5109,485619,39620,407151,38775,1900,149,12,596,22763,22763,608,22763,2,0
WY,320,7301,0,19,52,379,759,180,197,237,A,6,52,485619,39620,407151,317,1900,149,7,228,7621,7621,235,7621,4,1
AK,321,9803,0,46,36,379,759,180,197,161,A,9,36,10124,39620,407151,321,1900,149,2,227,10124,10124,229,10124,0,0
AL,5025,40875,0,397,641,379,260,180,157,0,B,167,641,485619,39620,407151,5025,1900,149,188,0,45900,45900,188,45900,13,0
AR,1923,24630,0,93,291,379,759,24,57,749,A,42,291,485619,39620,407151,1923,1900,149,142,2202,26553,26553,2344,26553,2,0
AS,0,3,17,961,5109,379,759,180,197,0,,1400,5109,485619,39620,407151,0,1900,149,0,0,20,3,0,3,0,0
AZ,5064,49436,0,637,1454,285,759,181,197,1155,B,187,1454,54500,39620,407151,38775,1900,149,135,1375,54500,54500,1510,54500,3,67
CA,30978,259522,0,4674,5109,1480,759,180,197,0,B,1208,5109,290500,39620,407151,38775,1900,149,645,8955,290500,290500,9600,290500,42,0
CO,9730,36465,0,874,1813,379,759,180,197,0,A,422,1813,485619,39620,407151,38775,1900,149,297,1292,46195,46195,1589,46195,11,16
CT,19815,42991,0,1919,5109,379,759,180,197,0,A,1331,5109,62806,39620,407151,38775,868,149,2265,2328,62806,62806,4593,62806,245,0
DC,2927,11186,0,402,5109,120,759,69,197,630,A,105,5109,485619,39620,407151,38775,1900,149,134,280,14113,14113,414,14113,9,0
DE,2745,12508,0,256,5109,379,759,180,197,495,A,99,5109,485619,39620,407151,38775,89,10,207,252,15253,15253,459,15253,9,0
FL,26660,239565,1104,961,4010,379,759,180,197,0,A,806,4010,485619,39620,407151,38775,1900,149,664,9482,267329,266225,10146,266225,25,80
GA,18947,65381,0,961,3550,379,759,180,197,0,A,733,3550,84328,39620,407151,38775,1900,149,646,3749,84328,84328,4395,84328,46,86
GU,133,991,0,3,5109,2,759,180,197,112,,5,5109,485619,39620,407151,38775,1900,149,0,48,1124,1124,48,1124,0,0
HI,580,23595,0,961,52,379,759,180,197,414,A,10,52,485619,39620,407151,38775,1900,149,6,699,24175,24175,705,24175,1,1
IA,3159,22661,0,214,5109,91,759,58,197,1235,A,79,5109,485619,39620,407151,3159,1900,149,257,1013,25820,25820,1270,25820,4,0
ID,1672,15773,0,53,151,379,53,180,197,585,A,45,151,17445,39620,407151,38775,1900,149,4,0,17445,17445,4,17445,1,0
IL,31508,116850,0,4599,5109,1239,759,757,197,0,A,1349,5109,485619,39620,407151,38775,1900,149,1151,3889,148358,148358,5040,148358,59,0
IN,11686,52953,0,961,5109,669,759,353,197,0,B,569,5109,485619,39620,407151,38775,1900,149,476,3021,64639,64639,3497,64639,7,0
KS,1986,16775,0,961,405,379,759,180,197,0,B,100,405,485619,39620,407151,38775,1900,149,137,494,18761,18761,631,18761,8,15
KY,2960,29612,0,274,1059,155,534,180,197,1174,A,148,1059,485619,39620,407151,38775,1900,149,253,94,32572,32572,347,32572,4,0
LA,24523,111588,0,1794,5109,379,759,332,197,0,A,1328,5109,485619,39620,407151,38775,1900,149,595,168,136111,136111,763,136111,32,0
MA,41416,136046,0,3872,3872,987,759,180,197,0,B,2303,3872,485619,39620,407151,38775,1900,149,1596,6751,177462,177462,8347,177462,157,83
MD,13684,57713,0,961,3014,379,759,180,197,917,A,683,3014,485619,39620,407151,13684,644,39,854,2652,71397,71397,3506,71397,57,128
ME,875,14076,0,39,138,16,759,9,197,414,A,35,138,485619,39620,407151,38775,1900,149,8,0,14951,14951,8,14951,1,2
MI,38494,93393,0,3374,5109,1346,759,1102,197,3237,B,3347,5109,135204,41811,93393,38208,3300,169,937,3635,131887,131887,4572,131887,111,0
MN,3190,46854,0,237,602,126,241,180,197,1059,A,143,602,50044,39620,407151,38775,1900,149,276,566,50044,50044,842,50044,9,28
MO,5807,50206,0,873,5109,379,759,180,197,0,A,177,5109,58076,6628,51379,38775,1900,149,140,1964,56013,56013,2104,56013,1,0
MP,14,51,0,961,5109,379,759,180,197,11,,2,5109,485619,39620,407151,38775,1900,149,0,9,65,65,9,65,0,0
MS,4512,46922,0,548,819,146,759,89,197,0,A,169,819,485619,39620,407151,38775,1900,149,238,12131,51434,51434,12369,51434,10,11
MT,433,10618,0,19,57,379,759,180,197,243,A,10,57,485619,39620,407151,38775,1900,149,0,153,11051,11051,153,11051,0,2
NC,6764,72720,0,373,5109,379,759,180,197,0,A,179,5109,485619,39620,407151,38775,1900,149,271,441,79484,79484,712,79484,7,0
ND,627,14120,0,17,53,379,759,180,197,189,B,13,53,485619,39620,407151,38775,1900,149,42,1075,14747,14747,1117,14747,3,2
NE,1474,14206,0,961,5109,379,759,180,197,0,A,28,5109,485619,39620,407151,38775,1900,149,187,918,15680,15680,1105,15680,0,0
NH,1392,12726,298,79,198,379,759,180,197,521,B,41,198,485619,39620,407151,38775,1900,149,50,644,14416,14118,694,14118,3,6
NJ,88806,89251,0,6986,5109,2018,759,1594,197,0,A,4377,5109,485619,39620,407151,38775,1900,149,3505,3864,178057,178057,7369,178057,175,0
NM,1845,35197,0,103,274,379,759,180,197,487,A,55,274,485619,39620,407151,38775,1900,149,47,363,37042,37042,410,37042,2,16
NV,3830,28517,0,961,5109,379,759,180,197,0,A,180,5109,485619,39620,407151,38775,1900,149,102,647,32347,32347,749,32347,8,0
NY,247512,386349,0,16103,65969,4814,759,180,197,39085,A,14347,65969,485619,39620,407151,38775,1900,149,4726,11580,633861,633861,16306,633861,478,1419
OH,12919,77920,0,961,2653,379,798,180,197,0,B,509,2653,485619,39620,407151,12516,491,18,1317,2223,90839,90839,3540,90839,38,88
OK,2680,32966,0,307,541,136,759,180,197,1614,B,143,541,485619,39620,407151,38775,1900,149,81,0,35646,35646,81,35646,3,0
OR,1956,38089,0,303,465,74,759,35,197,0,A,75,465,485619,39620,407151,38775,1900,149,46,961,40045,40045,1007,40045,1,9
PA,33232,129720,0,2701,5109,379,759,659,197,0,A,1204,5109,485619,39620,407151,38775,1900,149,948,3150,162952,162952,4098,162952,92,0
PR,1252,8486,1895,151,5109,379,759,180,197,0,A,63,5109,485619,39620,407151,38775,1900,149,39,206,11633,9738,245,9738,1,0
RI,5585,30883,0,297,629,62,759,45,197,267,B,175,629,40793,5916,34877,5585,1900,149,378,1594,36468,36468,1972,36468,11,24
SC,4377,36103,0,961,776,379,759,180,197,2063,B,120,776,485619,39620,407151,38775,1900,149,0,0,40480,40480,0,40480,0,0
SD,1685,10641,0,961,87,379,759,180,197,709,A,7,87,485619,39620,407151,38775,1900,149,50,214,12326,12326,264,12326,0,13
TN,7238,93451,0,505,730,379,759,180,197,3575,A,152,730,485619,39620,407151,38775,1900,149,168,3423,100689,100689,3591,100689,4,6
TX,19458,170936,0,1411,5109,379,759,180,197,5706,A,495,5109,485619,39620,407151,19458,1900,149,535,7149,190394,190394,7684,190394,18,0
UT,3213,65098,0,961,268,379,759,180,197,776,A,28,268,485619,39620,407151,3213,1900,149,144,4612,68311,68311,4756,68311,1,9
VA,8990,47745,468,1296,1500,396,759,237,197,1324,A,300,1500,485619,39620,407151,38775,1900,149,453,1549,57203,56735,2002,56735,23,78
VI,53,554,18,961,5109,379,759,180,197,48,,3,5109,485619,39620,407151,38775,1900,149,0,6,625,607,6,607,0,0
VT,820,11671,0,49,5109,379,759,180,197,15,A,38,5109,485619,39620,407151,820,1900,149,3,221,12491,12491,224,12491,0,0
WA,13890,147889,0,403,5109,122,759,180,197,0,C,629,5109,485619,39620,407151,12901,1900,149,307,4081,161779,161779,4388,161779,14,0
WI,5353,46603,237,406,1211,168,307,180,197,0,A,230,1211,485619,39620,407151,4499,1900,149,177,1280,52193,51956,1457,51956,10,21
WV,902,21253,0,77,5109,37,759,23,197,290,B,24,5109,485619,39620,407151,38775,1900,149,39,2085,22155,22155,2124,22155,6,0
WY,313,7073,0,19,51,379,759,180,197,233,A,2,51,485619,39620,407151,313,1900,149,4,101,7386,7386,105,7386,0,1
AK,319,9576,0,37,36,379,759,180,197,153,A,9,36,9895,39620,407151,319,1900,149,5,235,9895,9895,240,9895,0,0
AL,4837,40875,0,360,641,379,260,180,157,0,B,154,641,485619,39620,407151,4837,1900,149,182,2992,45712,45712,3174,45712,8,21
AR,1781,22428,0,88,291,379,759,25,57,721,A,40,291,485619,39620,407151,1781,1900,149,42,26,24209,24209,68,24209,2,0
AS,0,3,17,961,5109,379,759,180,197,0,,1400,5109,485619,39620,407151,0,1900,149,0,0,20,3,0,3,0,0
AZ,4929,48061,0,631,1387,283,759,187,197,994,B,184,1387,52990,39620,407151,38775,1900,149,210,1735,52990,52990,1945,52990,7,46
CA,30333,250567,7200,4731,5109,1457,759,180,197,0,B,1166,5109,280900,39620,407151,38775,1900,149,1370,19864,288100,280900,21234,280900,94,0
CO,9433,35173,0,874,1797,379,759,180,197,0,A,411,1797,485619,39620,407151,38775,1900,149,386,913,44606,44606,1299,44606,20,42
CT,17550,40663,0,1938,5109,379,759,180,197,0,A,1086,5109,59759,39620,407151,38775,671,149,741,2010,58213,58213,2751,58213,50,0
DC,2793,10906,0,313,5109,105,759,79,197,622,A,96,5109,485619,39620,407151,38775,1900,149,127,304,13699,13699,431,13699,5,0
DE,2538,12256,0,249,5109,379,759,180,197,466,A,90,5109,485619,39620,407151,38775,80,10,215,562,14794,14794,777,14794,4,0
FL,25996,230083,1179,961,3930,379,759,180,197,0,A,781,3930,485619,39620,407151,38775,1900,149,727,8825,257258,256079,9552,256079,27,88
GA,18301,61632,0,961,3464,379,759,180,197,0,A,687,3464,79933,39620,407151,38775,1900,149,632,5093,79933,79933,5725,79933,14,44
GU,133,943,0,6,5109,2,759,180,197,112,,5,5109,485619,39620,407151,38775,1900,149,0,0,1076,1076,0,1076,0,0
HI,574,22896,0,961,51,379,759,180,197,410,A,9,51,485619,39620,407151,38775,1900,149,21,1106,23470,23470,1127,23470,0,3
IA,2902,21648,0,198,5109,86,759,54,197,1171,A,75,5109,485619,39620,407151,2902,1900,149,389,1214,24550,24550,1603,24550,1,0
ID,1668,15773,0,43,151,379,53,180,197,520,A,44,151,17441,39620,407151,38775,1900,149,13,481,17441,17441,494,17441,1,0
IL,30357,112961,0,4314,5109,1196,759,749,197,0,A,1290,5109,485619,39620,407151,38775,1900,149,1197,4717,143318,143318,5914,143318,31,0
IN,11210,49932,0,961,5109,649,759,342,197,0,B,562,5109,485619,39620,407151,38775,1900,149,569,3700,61142,61142,4269,61142,17,0
KS,1849,16281,0,961,390,379,759,180,197,0,B,92,390,485619,39620,407151,38775,1900,149,59,395,18130,18130,454,18130,6,7
KY,2707,29518,0,274,1059,155,534,180,197,1174,A,144,1059,485619,39620,407151,38775,1900,149,185,1444,32225,32225,1629,32225,7,51
LA,23928,111420,0,1748,5109,379,759,349,197,0,A,1296,5109,485619,39620,407151,38775,1900,149,348,-2999,135348,135348,-2651,135348,29,0
MA,39820,129295,0,3789,3789,987,759,180,197,0,B,2146,3789,485619,39620,407151,38775,1900,149,2293,4691,169115,169115,6984,169115,163,61
MD,12830,55061,0,961,2886,379,759,180,197,914,A,626,2886,485619,39620,407151,12830,592,34,522,1999,67891,67891,2521,67891,44,129
ME,867,14076,0,46,136,18,759,9,197,393,A,34,136,485619,39620,407151,38775,1900,149,20,0,14943,14943,20,14943,2,0
MI,37557,89758,0,3403,5109,1344,759,1115,197,3237,B,3236,5109,130677,40919,89758,37170,3178,160,528,2644,127315,127315,3172,127315,129,0
MN,2914,46288,0,228,574,116,226,180,197,1026,A,134,574,49202,39620,407151,38775,1900,149,126,1106,49202,49202,1232,49202,13,13
MO,5667,48242,0,875,5109,379,759,180,197,0,A,176,5109,56834,6457,50308,38775,1900,149,150,0,53909,53909,150,53909,1,0
MP,14,42,4,961,5109,379,759,180,197,9,,2,5109,485619,39620,407151,38775,1900,149,0,0,60,56,0,56,0,0
MS,4274,34791,0,961,808,138,759,79,197,0,A,159,808,485619,39620,407151,38775,1900,149,300,0,39065,39065,300,39065,7,26
MT,433,10465,0,18,55,379,759,180,197,243,A,10,55,485619,39620,407151,38775,1900,149,7,322,10898,10898,329,10898,0,0
NC,6493,72279,0,465,5109,379,759,180,197,0,A,172,5109,485619,39620,407151,38775,1900,149,353,2208,78772,78772,2561,78772,8,0
ND,585,13045,0,15,51,379,759,180,197,189,B,10,51,485619,39620,407151,38775,1900,149,57,610,13630,13630,667,13630,1,4
NE,1287,13288,0,961,5109,379,759,180,197,0,A,28,5109,485619,39620,407151,38775,1900,149,149,749,14575,14575,898,14575,4,0
NH,1342,12082,316,85,192,379,759,180,197,513,B,38,192,485619,39620,407151,38775,1900,149,55,517,13740,13424,572,13424,1,2
NJ,85301,85387,0,7494,5109,1940,759,1628,197,0,A,4202,5109,485619,39620,407151,38775,1900,149,3881,4271,170688,170688,8152,170688,132,0
NM,1798,34834,0,92,258,379,759,180,197,465,A,53,258,485619,39620,407151,38775,1900,149,87,932,36632,36632,1019,36632,2,16
NV,3728,27870,0,961,5109,379,759,180,197,0,A,172,5109,485619,39620,407151,38775,1900,149,102,745,31598,31598,847,31598,4,0
NY,242786,374769,0,16213,64550,4878,759,180,197,37596,A,13869,64550,485619,39620,407151,38775,1900,149,6054,14969,617555,617555,21023,617555,507,1447
OH,11602,75697,0,961,2565,379,765,180,197,0,B,471,2565,485619,39620,407151,11292,453,18,1380,6878,87299,87299,8258,87299,20,46
OK,2599,32966,0,307,541,136,759,180,197,1575,B,140,541,485619,39620,407151,38775,1900,149,29,0,35565,35565,29,35565,1,0
OR,1910,37128,0,290,456,74,759,37,197,0,A,74,456,485619,39620,407151,38775,1900,149,66,1389,39038,39038,1455,39038,2,7
PA,32284,126570,0,2634,5109,379,759,657,197,0,A,1112,5109,485619,39620,407151,38775,1900,149,1215,3674,158854,158854,4889,158854,276,0
PR,1213,8280,1839,160,5109,379,759,180,197,0,A,62,5109,485619,39620,407151,38775,1900,149,95,225,11332,9493,320,9493,2,0
RI,5207,29289,0,298,605,66,759,37,197,244,B,164,605,38488,5520,32968,5207,1900,149,339,1762,34496,34496,2101,34496,14,27
SC,4377,36103,0,961,776,379,759,180,197,2633,B,120,776,485619,39620,407151,38775,1900,149,131,1516,40480,40480,1647,40480,1,0
SD,1635,10427,0,961,74,379,759,180,197,646,A,7,74,485619,39620,407151,38775,1900,149,93,309,12062,12062,402,12062,0,6
TN,7070,90028,0,393,724,379,759,180,197,3344,A,148,724,485619,39620,407151,38775,1900,149,308,6204,97098,97098,6512,97098,3,5
TX,18923,163787,0,1471,5109,379,759,180,197,5334,A,477,5109,485619,39620,407151,18923,1900,149,663,5808,182710,182710,6471,182710,24,0
UT,3069,60486,0,961,259,379,759,180,197,679,A,27,259,485619,39620,407151,3069,1900,149,138,3473,63555,63555,3611,63555,2,8
VA,8537,46196,499,1319,1422,388,759,231,197,1267,A,277,1422,485619,39620,407151,38775,1900,149,484,2318,55232,54733,2802,54733,19,126
VI,53,548,22,961,5109,379,759,180,197,48,,3,5109,485619,39620,407151,38775,1900,149,0,158,623,601,158,601,0,0
VT,817,11450,0,53,5109,379,759,180,197,15,A,38,5109,485619,39620,407151,817,1900,149,4,238,12267,12267,242,12267,0,0
WA,13583,143808,0,586,5109,193,759,180,197,0,C,615,5109,485619,39620,407151,12567,1900,149,176,1501,157391,157391,1677,157391,17,0
WI,5176,45323,248,397,1190,162,307,180,197,0,A,220,1190,485619,39620,407151,4346,1900,149,163,1361,50747,50499,1524,50499,9,14
WV,863,19168,0,72,5109,37,759,25,197,265,B,18,5109,485619,39620,407151,38775,1900,149,78,513,20031,20031,591,20031,2,0
WY,309,6972,0,19,50,379,759,180,197,227,A,2,50,485619,39620,407151,309,1900,149,4,755,7281,7281,759,7281,0,0
AK,314,9341,0,39,36,379,759,180,197,147,A,9,36,9655,39620,407151,314,1900,149,5,200,9655,9655,205,9655,0,0
AL,4655,37883,0,359,620,379,247,180,148,0,B,146,620,485619,39620,407151,4655,1900,149,125,4565,42538,42538,4690,42538,2,26
AR,1739,22402,0,86,291,379,759,22,57,703,A,38,291,485619,39620,407151,1739,1900,149,44,603,24141,24141,647,24141,1,291
AS,0,3,17,961,5109,379,759,180,197,0,,1400,5109,485619,39620,407151,0,1900,149,0,0,20,3,0,3,0,0
AZ,4719,46326,0,566,1341,285,759,178,197,539,B,177,1341,51045,39620,407151,38775,1900,149,212,1603,51045,51045,1815,51045,8,52
CA,28963,230703,7200,4936,5109,1490,759,180,197,0,B,1072,5109,259666,39620,407151,38775,1900,149,1435,6617,266866,259666,8052,259666,87,0
CO,9047,34260,0,843,1755,379,759,180,197,0,A,391,1755,485619,39620,407151,38775,1900,149,372,1105,43307,43307,1477,43307,17,62
CT,16809,38653,0,1946,5109,379,759,180,197,0,A,1036,5109,58213,39620,407151,38775,602,149,0,0,55462,55462,0,55462,0,0
DC,2666,10602,0,313,5109,105,759,79,197,608,A,91,5109,485619,39620,407151,38775,1900,149,190,435,13268,13268,625,13268,5,0
DE,2323,11694,0,224,5109,379,759,180,197,423,A,86,5109,485619,39620,407151,38775,77,9,0,0,14017,14017,0,14017,10,0
FL,25269,221258,0,961,3842,379,759,180,197,0,A,754,3842,485619,39620,407151,38775,1900,149,1150,10540,246527,246527,11690,246527,55,177
GA,17669,56539,0,961,3420,379,759,180,197,0,A,673,3420,74208,39620,407151,38775,1900,149,475,2049,74208,74208,2524,74208,23,96
GU,133,943,0,6,5109,2,759,180,197,110,,5,5109,485619,39620,407151,38775,1900,149,0,3,1076,1076,3,1076,0,0
HI,553,21790,0,961,48,379,759,180,197,390,A,9,48,485619,39620,407151,38775,1900,149,12,474,22343,22343,486,22343,0,3
IA,2513,20434,0,193,5109,84,759,51,197,1095,A,74,5109,485619,39620,407151,2513,1900,149,181,974,22947,22947,1155,22947,10,0
ID,1655,15292,0,53,151,379,53,180,197,453,A,43,151,16947,39620,407151,38775,1900,149,46,249,16947,16947,295,16947,2,3
IL,29160,108244,0,4340,5109,1192,759,740,197,0,A,1259,5109,485619,39620,407151,38775,1900,149,1585,5656,137404,137404,7241,137404,125,0
IN,10641,46232,0,961,5109,663,759,360,197,0,B,545,5109,485619,39620,407151,38775,1900,149,487,1601,56873,56873,2088,56873,26,0
KS,1790,15886,0,961,383,379,759,180,197,0,B,86,383,485619,39620,407151,38775,1900,149,85,690,17676,17676,775,17676,2,8
KY,2522,28074,0,360,1008,227,514,180,197,979,A,137,1008,485619,39620,407151,38775,1900,149,93,756,30596,30596,849,30596,8,37
LA,23580,114419,0,1761,5109,379,759,347,197,0,A,1267,5109,485619,39620,407151,38775,1900,149,462,5550,137999,137999,6012,137999,54,0
MA,37527,124604,0,3728,3728,987,759,180,197,0,B,1983,3728,485619,39620,407151,38775,1900,149,2402,7409,162131,162131,9811,162131,161,-28
MD,12308,53062,0,961,2757,379,759,180,197,771,A,582,2757,485619,39620,407151,12308,550,32,736,2625,65370,65370,3361,65370,41,145
ME,847,14076,0,49,136,20,759,12,197,382,A,32,136,485619,39620,407151,38775,1900,149,20,0,14923,14923,20,14923,3,3
MI,37029,87114,0,3634,5109,1423,759,1203,197,3237,B,3107,5109,127391,40277,87114,36293,3076,152,709,3846,124143,124143,4555,124143,123,0
MN,2788,45182,0,239,561,111,215,180,197,997,A,121,561,47970,39620,407151,38775,1900,149,120,1362,47970,47970,1482,47970,10,43
MO,5517,48242,0,875,5109,379,759,180,197,0,A,175,5109,54507,6260,48182,38775,1900,149,234,1808,53759,53759,2042,53759,10,0
MP,14,42,4,961,5109,379,759,180,197,9,,2,5109,485619,39620,407151,38775,1900,149,1,0,60,56,1,56,0,0
MS,3974,34791,0,961,782,154,759,99,197,0,A,152,782,485619,39620,407151,38775,1900,149,181,0,38765,38765,181,38765,12,46
MT,426,10143,0,17,55,379,759,180,197,234,A,10,55,485619,39620,407151,38775,1900,149,4,321,10569,10569,325,10569,2,1
NC,6140,70071,0,388,5109,379,759,180,197,0,A,164,5109,485619,39620,407151,38775,1900,149,281,2949,76211,76211,3230,76211,12,0
ND,528,12435,0,13,47,379,759,180,197,183,B,9,47,485619,39620,407151,38775,1900,149,89,532,12963,12963,621,12963,0,0
NE,1138,12539,0,961,5109,379,759,180,197,0,A,24,5109,485619,39620,407151,38775,1900,149,72,501,13677,13677,573,13677,0,0
NH,1287,11565,174,86,190,379,759,180,197,468,B,37,190,485619,39620,407151,38775,1900,149,0,144,13026,12852,144,12852,0,0
NJ,81420,81116,0,7718,5109,2024,759,1641,197,0,A,4070,5109,485619,39620,407151,38775,1900,149,2953,2134,162536,162536,5087,162536,230,0
NM,1711,33902,0,96,242,379,759,180,197,382,A,51,242,485619,39620,407151,38775,1900,149,114,1011,35613,35613,1125,35613,7,12
NV,3626,27125,0,961,5109,379,759,180,197,0,A,168,5109,485619,39620,407151,38775,1900,149,102,887,30751,30751,989,30751,6,0
NY,236732,359800,0,16967,63103,4996,759,180,197,35458,A,13362,63103,485619,39620,407151,38775,1900,149,7090,16219,596532,596532,23309,596532,540,1983
OH,10222,68819,0,961,2519,379,760,180,197,0,B,451,2519,485619,39620,407151,9939,434,17,1115,0,79041,79041,1115,79041,33,95
OK,2570,32966,0,307,541,136,759,180,197,1515,B,139,541,485619,39620,407151,38775,1900,149,105,1811,35536,35536,1916,35536,3,13
OR,1844,35739,0,290,449,74,759,37,197,0,A,72,449,485619,39620,407151,38775,1900,149,59,1203,37583,37583,1262,37583,2,22
PA,31069,122896,0,2613,5109,379,759,660,197,0,A,836,5109,485619,39620,407151,38775,1900,149,1628,4964,153965,153965,6592,153965,80,0
PR,1118,8055,1760,165,5109,379,759,180,197,0,A,60,5109,485619,39620,407151,38775,1900,149,50,191,10933,9173,241,9173,2,0
RI,4868,27527,0,293,578,67,759,43,197,217,B,150,578,36047,5138,30909,4868,1900,149,283,1370,32395,32395,1653,32395,32,247
SC,4246,34587,0,961,776,379,759,180,197,2633,B,119,776,485619,39620,407151,38775,1900,149,315,2234,38833,38833,2549,38833,10,101
SD,1542,10118,1,961,68,379,759,180,197,552,A,7,68,485619,39620,407151,38775,1900,149,131,467,11661,11660,598,11660,0,5
TN,6762,83824,0,593,719,379,759,180,197,3234,A,145,719,485619,39620,407151,38775,1900,149,173,3140,90586,90586,3313,90586,3,8
TX,18260,157979,0,1321,5109,379,759,180,197,4806,A,453,5109,485619,39620,407151,18260,1900,149,889,5814,176239,176239,6703,176239,25,0
UT,2931,57013,0,961,251,379,759,180,197,565,A,25,251,485619,39620,407151,2931,1900,149,126,4047,59944,59944,4173,59944,2,7
VA,8053,43878,486,1307,1296,398,759,230,197,1228,A,258,1296,485619,39620,407151,38775,1900,149,562,2372,52417,51931,2934,51931,27,75
VI,53,390,35,961,5109,379,759,180,197,46,,3,5109,485619,39620,407151,38775,1900,149,2,17,478,443,19,443,1,0
VT,813,11212,0,56,5109,379,759,180,197,15,A,38,5109,485619,39620,407151,813,1900,149,11,399,12025,12025,410,12025,3,0
WA,13407,142307,0,518,5109,155,759,180,197,0,C,598,5109,485619,39620,407151,12471,1900,149,233,2013,155714,155714,2246,155714,13,0
WI,5013,43962,229,361,1176,135,307,180,197,0,A,211,1176,485619,39620,407151,4199,1900,149,174,1597,49204,48975,1771,48975,6,23
WV,785,18655,0,83,5109,40,759,27,197,255,B,16,5109,485619,39620,407151,38775,1900,149,31,728,19440,19440,759,19440,3,0
WY,305,6217,0,19,50,379,759,180,197,206,A,2,50,485619,39620,407151,305,1900,149,9,86,6522,6522,95,6522,0,7
AK,309,9141,0,961,36,379,759,180,197,128,A,9,36,9450,39620,407151,309,1900,149,9,706,9450,9450,715,9450,0,1
AL,4530,33318,0,364,594,379,247,180,148,0,B,144,594,485619,39620,407151,4530,1900,149,185,1272,37848,37848,1457,37848,11,41
AR,1695,21799,0,83,5109,379,759,21,197,593,A,37,5109,485619,39620,407151,1695,1900,149,75,744,23494,23494,819,23494,0,0
AS,0,3,17,961,5109,379,759,180,197,0,,1400,5109,485619,39620,407151,0,1900,149,0,0,20,3,0,3,0,0
AZ,4507,44723,0,566,1289,285,759,178,197,539,B,169,1289,49230,39620,407151,38775,1900,149,273,1559,49230,49230,1832,49230,19,31
CA,27528,224086,7200,4892,5109,1484,759,180,197,0,B,985,5109,251614,39620,407151,38775,1900,149,1346,3868,258814,251614,5214,251614,95,0
CO,8675,33155,0,858,1693,379,759,180,197,0,A,374,1693,485619,39620,407151,38775,1900,149,395,902,41830,41830,1297,41830,17,57
CT,16809,38653,0,1946,5109,379,759,180,197,0,A,1036,5109,55462,39620,407151,38775,554,149,925,1415,55462,55462,2340,55462,65,0
DC,2476,10167,0,313,5109,105,759,79,197,573,A,86,5109,485619,39620,407151,38775,1900,149,126,367,12643,12643,493,12643,5,0
DE,2323,11694,0,224,5109,379,759,180,197,423,A,76,5109,485619,39620,407151,38775,67,9,248,419,14017,14017,667,14017,6,0
FL,24119,210718,1285,961,3665,379,759,180,197,0,A,699,3665,485619,39620,407151,38775,1900,149,1222,14367,236122,234837,15589,234837,53,205
GA,17194,54490,0,961,3324,379,759,180,197,0,A,650,3324,71684,39620,407151,38775,1900,149,1525,2220,71684,71684,3745,71684,63,216
GU,133,940,0,6,5109,2,759,180,197,97,,5,5109,485619,39620,407151,38775,1900,149,0,70,1073,1073,70,1073,0,0
HI,541,21316,0,961,45,379,759,180,197,374,A,9,45,485619,39620,407151,38775,1900,149,11,1146,21857,21857,1157,21857,0,0
IA,2332,19460,0,183,5109,88,759,52,197,1007,A,64,5109,485619,39620,407151,2332,1900,149,191,926,21792,21792,1117,21792,4,0
ID,1609,15043,0,58,148,379,51,180,197,390,A,41,148,16652,39620,407151,38775,1900,149,22,388,16652,16652,410,16652,0,5
IL,27575,102588,0,4454,5109,1196,759,777,197,0,A,1134,5109,485619,39620,407151,38775,1900,149,1842,5732,130163,130163,7574,130163,62,0
IN,10154,44631,0,961,5109,638,759,417,197,0,B,519,5109,485619,39620,407151,38775,1900,149,612,3058,54785,54785,3670,54785,42,0
KS,1705,15196,0,961,375,379,759,180,197,0,B,84,375,485619,39620,407151,38775,1900,149,117,662,16901,16901,779,16901,4,16
KY,2429,27318,0,477,971,333,506,180,197,956,A,129,971,485619,39620,407151,38775,1900,149,138,1285,29747,29747,1423,29747,7,164
LA,23118,108869,0,1868,5109,379,759,363,197,0,A,1213,5109,485619,39620,407151,38775,1900,149,586,4815,131987,131987,5401,131987,57,0
MA,35125,117195,0,3756,3756,987,759,180,197,0,B,1822,3756,485619,39620,407151,38775,1900,149,2633,7097,152320,152320,9730,152320,155,30
MD,11572,50437,0,961,2612,379,759,180,197,736,A,541,2612,485619,39620,407151,11572,512,29,788,2378,62009,62009,3166,62009,42,161
ME,827,14076,0,55,133,28,759,8,197,352,A,29,133,485619,39620,407151,38775,1900,149,31,0,14903,14903,31,14903,2,3
MI,36320,83268,0,3674,5109,1428,759,1167,197,629,B,2984,5109,122507,39239,83268,35789,2955,148,865,4994,119588,119588,5859,119588,143,0
MN,2668,43820,0,223,518,106,202,180,197,955,A,111,518,46488,39620,407151,38775,1900,149,182,1284,46488,46488,1466,46488,17,43
MO,5283,46434,0,1043,5109,379,759,180,197,0,A,165,5109,52444,6022,46360,38775,1900,149,172,897,51717,51717,1069,51717,13,0
MP,13,42,4,961,5109,379,759,180,197,0,,2,5109,485619,39620,407151,38775,1900,149,0,15,59,55,15,55,0,0
MS,3793,34791,0,961,736,154,759,99,197,0,A,140,736,485619,39620,407151,38775,1900,149,169,0,38584,38584,169,38584,11,54
MT,422,9822,0,21,54,379,759,180,197,233,A,8,54,485619,39620,407151,38775,1900,149,7,301,10244,10244,308,10244,1,2
NC,5859,67122,0,429,5109,379,759,180,197,0,A,152,5109,485619,39620,407151,38775,1900,149,394,1670,72981,72981,2064,72981,21,0
ND,439,11903,0,16,47,379,759,180,197,172,B,9,47,485619,39620,407151,38775,1900,149,46,592,12342,12342,638,12342,0,2
NE,1066,12038,0,961,5109,379,759,180,197,0,A,24,5109,485619,39620,407151,38775,1900,149,114,696,13104,13104,810,13104,3,0
NH,1287,11421,174,74,190,379,759,180,197,455,B,37,190,485619,39620,407151,38775,1900,149,148,394,12882,12708,542,12708,5,12
NJ,78467,78982,0,8011,5109,1961,759,1594,197,0,A,3840,5109,485619,39620,407151,38775,1900,149,3150,2469,157449,157449,5619,157449,322,0
NM,1597,32891,0,90,230,379,759,180,197,353,A,44,230,485619,39620,407151,38775,1900,149,113,981,34488,34488,1094,34488,8,15
NV,3524,26238,0,961,5109,379,759,180,197,0,A,162,5109,485619,39620,407151,38775,1900,149,203,1108,29762,29762,1311,29762,4,0
NY,229642,343581,0,17316,61120,5039,759,180,197,33392,A,12822,61120,485619,39620,407151,38775,1900,149,7358,15286,573223,573223,22644,573223,630,2068
OH,9107,68819,0,961,2424,379,740,180,197,0,B,418,2424,485619,39620,407151,8858,401,17,693,2393,77926,77926,3086,77926,29,93
OK,2465,31155,0,325,528,155,759,180,197,1331,B,136,528,485619,39620,407151,38775,1900,149,108,2613,33620,33620,2721,33620,5,0
OR,1785,34536,0,301,427,69,759,41,197,0,A,70,427,485619,39620,407151,38775,1900,149,49,1334,36321,36321,1383,36321,6,13
PA,29441,117932,0,2603,5109,379,759,661,197,0,A,756,5109,485619,39620,407151,38775,1900,149,1706,4197,147373,147373,5903,147373,49,0
PR,1068,7864,1478,961,5109,379,759,180,197,0,A,58,5109,485619,39620,407151,38775,1900,149,25,549,10410,8932,574,8932,2,0
RI,4585,26157,0,252,331,62,759,43,197,196,B,118,331,33997,4816,29181,4585,1900,149,290,1500,30742,30742,1790,30742,13,0
SC,3931,32353,0,961,675,379,759,180,197,0,B,109,675,485619,39620,407151,38775,1900,149,275,1276,36284,36284,1551,36284,2,0
SD,1411,9651,0,961,63,379,759,180,197,457,A,7,63,485619,39620,407151,38775,1900,149,100,412,11062,11062,512,11062,0,8
TN,6589,80684,0,465,711,379,759,180,197,3017,A,142,711,485619,39620,407151,38775,1900,149,327,1897,87273,87273,2224,87273,1,20
TX,17371,152165,0,1522,5109,379,759,180,197,4190,A,428,5109,485619,39620,407151,17371,1900,149,916,10073,169536,169536,10989,169536,35,0
UT,2805,52966,0,961,244,379,759,180,197,443,A,23,244,485619,39620,407151,2805,1900,149,122,5971,55771,55771,6093,55771,2,6
VA,7491,41506,499,1308,1221,400,759,224,197,1110,A,231,1221,485619,39620,407151,38775,1900,149,602,1951,49496,48997,2553,48997,23,107
VI,51,373,34,961,5109,379,759,180,197,46,,2,5109,485619,39620,407151,38775,1900,149,0,16,458,424,16,424,1,0
VT,802,10813,0,32,5109,379,759,180,197,15,A,35,5109,485619,39620,407151,802,1900,149,10,554,11615,11615,564,11615,0,0
WA,13174,140294,0,622,5109,195,759,180,197,0,C,585,5109,485619,39620,407151,12297,1900,149,302,4150,153468,153468,4452,153468,14,0
WI,4839,42365,198,361,1153,141,306,348,197,0,A,205,1153,485619,39620,407151,4045,1900,149,203,1391,47402,47204,1594,47204,8,32
WV,754,17927,0,85,5109,34,759,24,197,223,B,13,5109,485619,39620,407151,38775,1900,149,15,360,18681,18681,375,18681,0,0
WY,296,6131,0,19,43,379,759,180,197,148,A,2,43,485619,39620,407151,296,1900,149,0,0,6427,6427,0,6427,0,0
AK,300,8435,0,961,35,379,759,180,197,110,A,9,35,8735,39620,407151,300,1900,149,7,64,8735,8735,71,8735,0,1
AL,4345,32046,0,360,553,379,227,180,137,0,B,133,553,485619,39620,407151,4345,1900,149,232,2082,36391,36391,2314,36391,12,28
AR,1620,21055,0,85,5109,379,759,21,197,548,A,37,5109,485619,39620,407151,1620,1900,149,51,790,22675,22675,841,22675,4,-130
AS,0,3,17,961,5109,379,759,180,197,0,,1400,5109,485619,39620,407151,0,1900,149,0,0,20,3,0,3,0,0
AZ,4234,43164,0,578,1258,278,759,188,197,460,B,150,1258,47398,39620,407151,38775,1900,149,272,1816,47398,47398,2088,47398,8,45
CA,26182,220218,13200,5031,5109,1568,759,180,197,0,B,890,5109,246400,39620,407151,38775,1900,149,1758,28156,259600,246400,29914,246400,69,0
CO,8280,32253,0,859,1636,379,759,180,197,0,A,357,1636,485619,39620,407151,38775,1900,149,339,614,40533,40533,953,40533,28,80
CT,15884,37238,0,1926,5109,379,759,180,197,0,A,971,5109,53122,39620,407151,38775,494,149,1129,1850,53122,53122,2979,53122,103,0
DC,2350,9800,0,313,5109,105,759,79,197,552,A,81,5109,485619,39620,407151,38775,1900,149,153,472,12150,12150,625,12150,9,0
DE,2075,11275,0,209,5109,379,759,180,197,378,A,70,5109,485619,39620,407151,38775,61,9,61,187,13350,13350,248,13350,3,0
FL,22897,196351,1325,961,3460,379,759,180,197,0,A,646,3460,485619,39620,407151,38775,1900,149,386,5353,220573,219248,5739,219248,37,116
GA,15669,52270,0,961,3108,379,759,180,197,0,A,587,3108,67939,39620,407151,38775,1900,149,682,3167,67939,67939,3849,67939,35,186
GU,133,870,0,9,5109,379,759,180,197,86,,5,5109,485619,39620,407151,38775,1900,149,0,27,1003,1003,27,1003,0,0
HI,530,20170,0,961,45,379,759,180,197,359,A,9,45,485619,39620,407151,38775,1900,149,13,884,20700,20700,897,20700,0,0
IA,2141,18534,0,175,5109,84,759,48,197,987,A,60,5109,485619,39620,407151,2141,1900,149,146,660,20675,20675,806,20675,7,0
ID,1587,14655,0,70,143,379,46,180,197,0,A,41,143,16242,39620,407151,38775,1900,149,123,721,16242,16242,844,16242,2,2
IL,25733,96856,0,4423,5109,1248,759,797,197,0,A,1072,5109,485619,39620,407151,38775,1900,149,1140,4520,122589,122589,5660,122589,124,0
IN,9542,41573,0,961,5109,696,759,426,197,0,B,477,5109,485619,39620,407151,38775,1900,149,587,2132,51115,51115,2719,51115,41,0
KS,1588,14534,0,961,359,379,759,180,197,0,B,80,359,485619,39620,407151,38775,1900,149,94,1360,16122,16122,1454,16122,4,17
KY,2291,26033,0,412,807,252,367,180,197,862,A,122,807,485619,39620,407151,38775,1900,149,81,546,28324,28324,627,28324,7,120
LA,22532,104054,0,1914,5109,379,759,396,197,0,A,1156,5109,485619,39620,407151,38775,1900,149,581,4077,126586,126586,4658,126586,53,0
MA,32492,110098,0,3726,3726,973,759,180,197,0,B,1667,3726,485619,39620,407151,38775,1900,149,2522,7308,142590,142590,9830,142590,165,89
MD,10784,48059,0,961,2451,379,759,180,197,736,A,499,2451,485619,39620,407151,10784,471,28,752,2328,58843,58843,3080,58843,30,220
ME,796,14076,0,47,130,20,759,7,197,333,A,27,130,485619,39620,407151,38775,1900,149,26,0,14872,14872,26,14872,3,4
MI,35455,78274,0,3809,5109,1447,759,1211,197,617,B,2841,5109,116440,38166,78274,35118,2836,140,922,4446,113729,113729,5368,113729,169,0
MN,2486,42536,0,213,475,103,188,180,197,926,A,94,475,45022,39620,407151,38775,1900,149,165,1291,45022,45022,1456,45022,7,30
MO,5111,45537,0,1043,5109,379,759,180,197,0,A,152,5109,50402,5781,44563,38775,1900,149,216,1420,50648,50648,1636,50648,5,0
MP,13,27,7,961,5109,379,759,180,197,0,,2,5109,485619,39620,407151,38775,1900,149,0,0,47,40,0,40,0,0
MS,3624,34791,0,961,682,154,759,99,197,0,A,129,682,485619,39620,407151,38775,1900,149,264,0,38415,38415,264,38415,7,37
MT,415,9521,0,21,52,379,759,180,197,218,A,7,52,485619,39620,407151,38775,1900,149,11,342,9936,9936,353,9936,0,1
NC,5465,65452,0,452,5109,379,759,180,197,0,A,131,5109,485619,39620,407151,38775,1900,149,342,2748,70917,70917,3090,70917,14,0
ND,393,11311,0,14,45,379,759,180,197,163,B,9,45,485619,39620,407151,38775,1900,149,28,359,11704,11704,387,11704,0,1
NE,952,11342,0,961,5109,379,759,180,197,0,A,21,5109,485619,39620,407151,38775,1900,149,51,514,12294,12294,565,12294,1,0
NH,1139,11027,121,70,178,379,759,180,197,365,B,32,178,485619,39620,407151,38775,1900,149,0,0,12287,12166,0,12166,0,0
NJ,75317,76513,0,8224,5109,2014,759,1645,197,0,A,3518,5109,485619,39620,407151,38775,1900,149,4287,3522,151830,151830,7809,151830,362,0
NM,1484,31910,0,90,215,379,759,180,197,353,A,36,215,485619,39620,407151,38775,1900,149,77,467,33394,33394,544,33394,0,34
NV,3321,25130,0,961,5109,379,759,180,197,0,A,158,5109,485619,39620,407151,38775,1900,149,110,686,28451,28451,796,28451,8,0
NY,222284,328295,0,17735,59052,5071,759,180,197,30800,A,12192,59052,485619,39620,407151,38775,1900,149,8505,16062,550579,550579,24567,550579,606,2084
OH,8414,66426,0,961,2331,379,707,180,197,0,B,389,2331,485619,39620,407151,8239,373,16,623,2665,74840,74840,3288,74840,28,94
OK,2357,28542,0,236,528,163,759,180,197,1240,B,131,528,485619,39620,407151,38775,1900,149,94,1586,30899,30899,1680,30899,8,18
OR,1736,33202,0,307,414,89,759,43,197,0,A,64,414,485619,39620,407151,38775,1900,149,73,1514,34938,34938,1587,34938,6,13
PA,27735,113735,0,2512,5109,379,759,675,197,0,A,707,5109,485619,39620,407151,38775,1900,149,1245,2641,141470,141470,3886,141470,60,0
PR,1043,7315,1465,961,5109,379,759,180,197,0,A,56,5109,485619,39620,407151,38775,1900,149,69,490,9823,8358,559,8358,5,0
RI,4295,24657,0,245,331,61,759,43,197,182,B,105,331,31866,4508,27358,4295,1900,149,392,2090,28952,28952,2482,28952,18,0
SC,3656,31077,0,961,675,379,759,180,197,0,B,107,675,485619,39620,407151,38775,1900,149,0,0,34733,34733,0,34733,0,0
SD,1311,9239,2,961,55,379,759,180,197,373,A,7,55,485619,39620,407151,38775,1900,149,143,548,10552,10550,691,10550,1,4
TN,6262,78787,0,444,691,379,759,180,197,2786,A,141,691,485619,39620,407151,38775,1900,149,183,3970,85049,85049,4153,85049,6,28
TX,16455,142092,0,1459,5109,379,759,180,197,3677,A,393,5109,485619,39620,407151,16455,1900,149,963,5774,158547,158547,6737,158547,29,0
UT,2683,46995,0,961,238,379,759,180,197,357,A,21,238,485619,39620,407151,2683,1900,149,141,1923,49678,49678,2064,49678,1,17
VA,6889,39555,537,1337,1114,427,759,238,197,951,A,208,1114,485619,39620,407151,38775,1900,149,389,1886,46981,46444,2275,46444,13,66
VI,51,357,35,961,5109,379,759,180,197,46,,1,5109,485619,39620,407151,38775,1900,149,0,26,443,408,26,408,0,0
VT,792,10259,0,58,5109,379,759,180,197,15,A,35,5109,485619,39620,407151,792,1900,149,13,346,11051,11051,359,11051,5,0
WA,12872,136144,0,595,5109,196,759,180,197,0,C,571,5109,485619,39620,407151,11950,1900,149,253,4095,149016,149016,4348,149016,20,0
WI,4636,40974,218,394,1121,147,299,180,197,0,A,197,1121,485619,39620,407151,3875,1900,149,183,1648,45828,45610,1831,45610,15,30
WV,739,17567,0,85,5109,34,759,24,197,223,B,13,5109,485619,39620,407151,38775,1900,149,37,613,18306,18306,650,18306,3,-164
WY,296,6131,0,19,43,379,759,180,197,148,A,2,43,485619,39620,407151,288,1900,149,9,89,6427,6427,98,6427,0,0
AK,293,8371,0,961,34,379,759,180,197,106,A,9,34,8664,39620,407151,293,1900,149,8,308,8664,8664,316,8664,0,2
AL,4113,29964,0,402,525,379,219,180,134,0,B,121,525,485619,39620,407151,4113,1900,149,237,723,34077,34077,960,34077,11,32
AR,1569,20265,0,83,130,379,43,26,39,489,A,33,130,485619,39620,407151,1569,1900,149,89,614,21834,21834,703,21834,3,0
AS,0,3,17,961,5109,379,759,180,197,0,,1400,5109,485619,39620,407151,0,1900,149,0,0,20,3,0,3,0,0
AZ,3962,41348,0,590,1213,286,759,202,197,385,B,142,1213,45310,39620,407151,38775,1900,149,156,1058,45310,45310,1214,45310,11,42
CA,24424,192062,13200,5163,5109,1175,759,180,197,0,B,821,5109,216486,39620,407151,38775,1900,149,1086,13192,229686,216486,14278,216486,63,0
CO,7941,31639,0,878,1556,379,759,180,197,0,A,329,1556,485619,39620,407151,38775,1900,149,250,588,39580,39580,838,39580,21,63
CT,14755,35388,0,1908,5109,379,759,180,197,0,A,868,5109,50143,39620,407151,38775,448,149,766,3536,50143,50143,4302,50143,197,0
DC,2197,9328,0,313,5109,105,759,79,197,530,A,72,5109,485619,39620,407151,38775,1900,149,139,102,11525,11525,241,11525,5,0
DE,2014,11088,0,208,5109,379,759,180,197,354,A,67,5109,485619,39620,407151,38775,59,8,253,545,13102,13102,798,13102,7,0
FL,22511,190998,1335,961,3344,379,759,180,197,0,A,609,3344,485619,39620,407151,38775,1900,149,1144,9185,214844,213509,10329,213509,72,284
GA,14987,49103,0,961,2922,379,759,180,197,0,A,552,2922,64090,39620,407151,38775,1900,149,764,1531,64090,64090,2295,64090,51,153
GU,133,843,0,9,5109,2,759,2,197,73,,5,5109,485619,39620,407151,38775,1900,149,0,32,976,976,32,976,0,0
HI,517,19286,0,961,45,379,759,180,197,333,A,9,45,485619,39620,407151,38775,1900,149,13,370,19803,19803,383,19803,0,1
IA,1995,17874,0,171,5109,78,759,43,197,908,A,53,5109,485619,39620,407151,1995,1900,149,96,888,19869,19869,984,19869,4,0
ID,1464,13934,0,66,141,379,43,180,197,0,A,39,141,15398,39620,407151,38775,1900,149,11,273,15398,15398,284,15398,6,6
IL,24593,92336,0,4283,5109,1189,759,796,197,0,A,948,5109,485619,39620,407151,38775,1900,149,1346,4967,116929,116929,6313,116929,80,0
IN,8955,39441,0,961,5109,737,759,422,197,0,B,436,5109,485619,39620,407151,38775,1900,149,428,1951,48396,48396,2379,48396,48,0
KS,1494,13174,0,961,342,379,759,180,197,0,B,76,342,485619,39620,407151,38775,1900,149,68,453,14668,14668,521,14668,7,15
KY,2210,25487,0,305,687,137,263,180,197,653,A,115,687,485619,39620,407151,38775,1900,149,162,852,27697,27697,1014,27697,11,14
LA,21951,99977,0,1943,5109,379,759,425,197,0,A,1103,5109,485619,39620,407151,38775,1900,149,433,3073,121928,121928,3506,121928,90,0
MA,29970,102790,0,3637,3637,973,759,180,197,0,B,1502,3637,485619,39620,407151,38775,1900,149,1861,3970,132760,132760,5831,132760,173,21
MD,10032,45731,0,961,2231,379,759,180,197,607,A,469,2231,485619,39620,407151,10032,441,28,560,1470,55763,55763,2030,55763,48,109
ME,770,14076,0,48,126,22,759,9,197,305,A,24,126,485619,39620,407151,38775,1900,149,36,2468,14846,14846,2504,14846,4,2
MI,34533,73828,0,3918,5109,1468,759,1212,197,452,B,2672,5109,110766,36938,73828,34298,2701,135,920,3153,108361,108361,4073,108361,140,0
MN,2321,41245,0,197,445,93,175,180,197,853,A,87,445,43566,39620,407151,38775,1900,149,156,1540,43566,43566,1696,43566,8,40
MO,4895,44117,0,1024,5109,379,759,180,197,0,A,147,5109,48233,5546,42635,38775,1900,149,209,825,49012,49012,1034,49012,14,0
MP,13,27,7,961,5109,379,759,180,197,0,,2,5109,485619,39620,407151,38775,1900,149,0,0,47,40,0,40,0,0
MS,3360,34791,0,961,645,154,759,99,197,0,A,122,645,485619,39620,407151,38775,1900,149,273,0,38151,38151,273,38151,11,49
MT,404,9179,0,21,51,379,759,180,197,209,A,7,51,485619,39620,407151,38775,1900,149,5,344,9583,9583,349,9583,0,1
NC,5123,62704,0,431,5109,379,759,180,197,0,A,117,5109,485619,39620,407151,38775,1900,149,99,2689,67827,67827,2788,67827,9,0
ND,365,10952,0,13,44,379,759,180,197,142,B,9,44,485619,39620,407151,38775,1900,149,24,377,11317,11317,401,11317,0,2
NE,901,10828,0,961,5109,379,759,180,197,0,A,20,5109,485619,39620,407151,38775,1900,149,30,342,11729,11729,372,11729,2,0
NH,1139,11027,121,70,178,379,759,180,197,365,B,32,178,485619,39620,407151,38775,1900,149,119,437,12287,12166,556,12166,9,26
NJ,71030,72991,0,8270,5109,1980,759,1705,197,0,A,3156,5109,485619,39620,407151,38775,1900,149,2206,2041,144021,144021,4247,144021,351,0
NM,1407,31443,0,87,181,379,759,180,197,340,A,36,181,485619,39620,407151,38775,1900,149,62,818,32850,32850,880,32850,5,0
NV,3211,24444,0,961,5109,379,759,180,197,0,A,150,5109,485619,39620,407151,38775,1900,149,123,871,27655,27655,994,27655,9,0
NY,213779,312233,0,18335,56968,5205,759,180,197,28004,A,11586,56968,485619,39620,407151,38775,1900,149,11571,15298,526012,526012,26869,526012,752,2315
OH,7791,63761,0,961,2237,379,677,180,197,0,B,361,2237,485619,39620,407151,7628,346,15,511,3040,71552,71552,3551,71552,37,81
OK,2263,26956,0,194,510,107,759,180,197,1115,B,123,510,485619,39620,407151,38775,1900,149,79,871,29219,29219,950,29219,15,22
OR,1663,31688,0,305,401,95,759,43,197,0,A,58,401,485619,39620,407151,38775,1900,149,30,958,33351,33351,988,33351,3,20
PA,26490,111094,0,2395,5109,379,759,668,197,0,A,647,5109,485619,39620,407151,38775,1900,149,1145,2808,137584,137584,3953,137584,63,0
PR,974,6825,1410,961,5109,379,759,180,197,0,A,51,5109,485619,39620,407151,38775,1900,149,51,541,9209,7799,592,7799,6,0
RI,3903,22567,0,229,331,54,759,44,197,168,B,87,331,28917,4059,24858,3903,1900,149,307,1577,26470,26470,1884,26470,7,0
SC,3656,31077,0,961,675,379,759,180,197,0,B,107,675,485619,39620,407151,38775,1900,149,103,758,34733,34733,861,34733,10,0
SD,1168,8691,0,961,51,379,759,180,197,329,A,6,51,485619,39620,407151,38775,1900,149,180,383,9859,9859,563,9859,0,6
TN,6079,74817,0,412,663,379,759,180,197,2196,A,135,663,485619,39620,407151,38775,1900,149,256,1809,80896,80896,2065,80896,11,30
TX,15492,136318,0,1538,5109,379,759,180,197,3150,A,364,5109,485619,39620,407151,15492,1900,149,868,4475,151810,151810,5343,151810,46,0
UT,2542,45072,0,961,221,379,759,180,197,218,A,20,221,485619,39620,407151,2542,1900,149,130,1008,47614,47614,1138,47614,1,8
VA,6500,37669,496,1298,1048,394,759,234,197,752,A,195,1048,485619,39620,407151,38775,1900,149,329,1077,44665,44169,1406,44169,41,1048
VI,51,331,35,961,5109,379,759,180,197,44,,1,5109,485619,39620,407151,38775,1900,149,0,5,417,382,5,382,0,0
VT,779,9913,0,63,5109,379,759,180,197,15,A,30,5109,485619,39620,407151,779,1900,149,9,422,10692,10692,431,10692,1,0
WA,12619,132049,0,645,5109,194,759,180,197,0,C,551,5109,485619,39620,407151,11640,1900,149,316,3830,144668,144668,4146,144668,9,0
WI,4453,39326,280,406,1091,163,290,180,197,0,A,182,1091,485619,39620,407151,3721,1900,149,207,1329,44059,43779,1536,43779,12,42
WV,702,16954,0,82,164,36,73,23,50,211,B,10,164,485619,39620,407151,38775,1900,149,62,556,17656,17656,618,17656,1,0
WY,287,6042,0,961,43,379,759,180,197,129,A,2,43,485619,39620,407151,282,1900,149,12,353,6329,6329,365,6329,1,0
AK,285,8063,0,961,32,379,759,180,197,98,A,9,32,8348,39620,407151,285,1900,149,8,510,8348,8348,518,8348,1,0
AL,3876,29241,0,380,493,379,210,180,132,0,B,110,493,485619,39620,407151,3876,1900,149,142,3793,33117,33117,3935,33117,11,36
AR,1480,19651,0,81,130,379,43,29,39,427,A,30,130,485619,39620,407151,1480,1900,149,70,257,21131,21131,327,21131,0,0
AS,0,3,17,961,5109,379,759,180,197,0,,1400,5109,485619,39620,407151,0,1900,149,0,0,20,3,0,3,0,0
AZ,3806,40290,0,580,1171,286,759,216,197,249,B,131,1171,44096,39620,407151,38775,1900,149,104,645,44096,44096,749,44096,9,49
CA,23338,178870,13200,5163,5109,1552,759,180,197,0,B,758,5109,202208,39620,407151,38775,1900,149,990,10336,215408,202208,11326,202208,71,0
CO,7691,31051,0,888,1493,379,759,180,197,0,A,308,1493,485619,39620,407151,38775,1900,149,7,1201,38742,38742,1208,38742,4,21
CT,13989,31852,0,1779,5109,379,759,180,197,0,A,671,5109,45841,39620,407151,38775,380,149,608,924,45841,45841,1532,45841,69,0
DC,2058,9226,0,295,5109,95,759,31,197,518,A,67,5109,485619,39620,407151,38775,1900,149,103,247,11284,11284,350,11284,14,0
DE,1761,10543,0,204,5109,379,759,180,197,277,A,60,5109,485619,39620,407151,38775,53,7,136,348,12304,12304,484,12304,7,0
FL,21367,181813,1275,961,3060,379,759,180,197,0,A,537,3060,485619,39620,407151,38775,1900,149,766,6207,204455,203180,6973,203180,54,227
GA,14223,47572,0,961,2769,379,759,180,197,0,A,501,2769,61795,39620,407151,38775,1900,149,908,3866,61795,61795,4774,61795,37,180
GU,133,811,0,13,5109,2,759,2,197,66,,5,5109,485619,39620,407151,38775,1900,149,0,41,944,944,41,944,0,0
HI,504,18916,0,961,44,379,759,180,197,315,A,9,44,485619,39620,407151,38775,1900,149,5,571,19420,19420,576,19420,0,0
IA,1899,16986,0,163,5109,73,759,41,197,741,A,49,5109,485619,39620,407151,1899,1900,149,189,0,18885,18885,189,18885,6,0
ID,1453,13661,0,59,135,379,38,180,197,0,A,33,135,15114,39620,407151,38775,1900,149,27,206,15114,15114,233,15114,6,3
IL,23247,87369,0,4283,5109,1189,759,796,197,0,A,868,5109,485619,39620,407151,38775,1900,149,1222,3626,110616,110616,4848,110616,74,0
IN,8527,37490,0,961,5109,721,759,435,197,0,B,388,5109,485619,39620,407151,38775,1900,149,291,1187,46017,46017,1478,46017,38,0
KS,1426,12721,0,961,327,379,759,180,197,0,B,69,327,485619,39620,407151,38775,1900,149,50,233,14147,14147,283,14147,7,18
KY,2048,24635,0,299,673,136,259,180,197,629,A,104,673,485619,39620,407151,38775,1900,149,85,732,26683,26683,817,26683,7,6
LA,21518,96904,0,1977,5109,379,759,436,197,0,A,1013,5109,485619,39620,407151,38775,1900,149,502,9829,118422,118422,10331,118422,129,0
MA,28109,98820,0,3616,3616,379,759,180,197,0,B,1329,3616,485619,39620,407151,38775,1900,149,1315,3320,126929,126929,4635,126929,118,131
MD,9472,44261,0,961,2122,379,759,180,197,607,A,421,2122,485619,39620,407151,38775,396,25,536,1446,53733,53733,1982,53733,37,147
ME,734,11608,0,58,124,21,759,9,197,292,A,20,124,485619,39620,407151,38775,1900,149,36,0,12342,12342,36,12342,1,0
MI,33613,70675,0,3910,5109,1497,759,1235,197,452,B,2532,5109,106183,35508,70675,33448,2537,131,911,3612,104288,104288,4523,104288,141,0
MN,2165,39705,0,177,405,75,155,180,197,830,A,79,405,41870,39620,407151,38775,1900,149,153,1038,41870,41870,1191,41870,9,44
MO,4686,43292,0,1041,5109,379,759,180,197,0,A,133,5109,45977,5262,40667,38775,1900,149,298,2252,47978,47978,2550,47978,19,0
MP,13,27,7,961,5109,379,759,180,197,0,,2,5109,485619,39620,407151,38775,1900,149,2,0,47,40,2,40,0,0
MS,3087,34791,0,961,596,154,759,99,197,0,A,111,596,485619,39620,407151,38775,1900,149,145,6749,37878,37878,6894,37878,13,47
MT,399,8835,0,24,50,379,759,180,197,197,A,7,50,485619,39620,407151,38775,1900,149,5,131,9234,9234,136,9234,0,3
NC,5024,60015,0,418,5109,379,759,180,197,0,A,108,5109,485619,39620,407151,38775,1900,149,208,1443,65039,65039,1651,65039,22,0
ND,341,10575,0,13,42,379,759,180,197,138,B,9,42,485619,39620,407151,38775,1900,149,10,125,10916,10916,135,10916,1,2
NE,871,10486,0,961,5109,379,759,180,197,0,A,18,5109,485619,39620,407151,38775,1900,149,57,328,11357,11357,385,11357,1,0
NH,1020,10590,25,72,152,379,759,180,197,249,B,23,152,485619,39620,407151,38775,1900,149,35,368,11635,11610,403,11610,0,0
NJ,68824,70950,0,8185,5109,2051,759,1626,197,0,A,2805,5109,485619,39620,407151,38775,1900,149,4240,6065,139774,139774,10305,139774,362,0
NM,1345,30625,0,87,181,379,759,180,197,304,A,31,181,485619,39620,407151,38775,1900,149,100,1355,31970,31970,1455,31970,5,181
NV,3088,23573,0,961,5109,379,759,180,197,0,A,141,5109,485619,39620,407151,38775,1900,149,117,1080,26661,26661,1197,26661,8,0
NY,202208,296935,0,18697,54653,5225,759,180,197,25589,A,10834,54653,485619,39620,407151,38775,1900,149,7177,13609,499143,499143,20786,499143,778,1717
OH,7280,60721,0,961,2156,379,654,180,197,0,B,324,2156,485619,39620,407151,7153,309,15,305,2584,68001,68001,2889,68001,50,123
OK,2184,26085,0,194,488,107,759,180,197,1060,B,108,488,485619,39620,407151,38775,1900,149,115,5295,28269,28269,5410,28269,9,31
OR,1633,30730,0,311,381,88,759,44,197,0,A,55,381,485619,39620,407151,38775,1900,149,49,1193,32363,32363,1242,32363,2,12
PA,25345,108286,0,2317,5109,379,759,675,197,0,A,584,5109,485619,39620,407151,38775,1900,149,1146,2693,133631,133631,3839,133631,60,0
PR,923,6284,1322,961,5109,379,759,180,197,0,A,45,5109,485619,39620,407151,38775,1900,149,20,324,8529,7207,344,7207,0,0
RI,3596,20990,0,213,331,48,759,180,197,135,B,80,331,26761,3706,23055,3596,1900,149,267,1559,24586,24586,1826,24586,7,0
SC,3553,30319,0,961,675,379,759,180,197,0,B,97,675,485619,39620,407151,38775,1900,149,234,2213,33872,33872,2447,33872,15,179
SD,988,8308,0,961,45,379,759,180,197,261,A,6,45,485619,39620,407151,38775,1900,149,120,174,9296,9296,294,9296,0,1
TN,5823,73008,0,443,633,379,759,180,197,1969,A,124,633,485619,39620,407151,38775,1900,149,213,2423,78831,78831,2636,78831,15,54
TX,14624,131843,0,1409,5109,379,759,180,197,2580,A,318,5109,485619,39620,407151,14624,1900,149,718,12523,146467,146467,13241,146467,31,0
UT,2412,44064,0,961,213,379,759,180,197,218,A,19,213,485619,39620,407151,2412,1900,149,49,640,46476,46476,689,46476,1,12
VA,6171,36592,469,1282,5109,422,759,276,197,721,A,154,5109,485619,39620,407151,38775,1900,149,424,938,43232,42763,1362,42763,5,0
VI,51,326,23,961,5109,379,759,180,197,44,,1,5109,485619,39620,407151,38775,1900,149,0,4,400,377,4,377,0,0
VT,770,9491,0,64,5109,379,759,180,197,15,A,29,5109,485619,39620,407151,770,1900,149,9,216,10261,10261,225,10261,1,0
WA,12303,128219,0,387,5109,98,759,180,197,0,C,542,5109,485619,39620,407151,11310,1900,149,224,4085,140522,140522,4309,140522,16,0
WI,4246,37997,277,432,1049,161,283,180,197,0,A,170,1049,485619,39620,407151,3555,1900,149,166,1228,42520,42243,1394,42243,16,56
WV,640,16398,0,87,164,38,73,25,50,147,B,9,164,485619,39620,407151,38775,1900,149,14,369,17038,17038,383,17038,0,0
WY,275,5689,0,961,43,379,759,180,197,140,A,1,43,485619,39620,407151,275,1900,149,0,0,5964,5964,0,5964,0,2
AK,277,7553,0,961,32,379,759,180,197,85,A,8,32,7830,39620,407151,277,1900,149,5,-213,7830,7830,-208,7830,0,1
AL,3734,25448,0,380,457,379,189,180,119,0,B,99,457,485619,39620,407151,3734,1900,149,209,7390,29182,29182,7599,29182,6,20
AR,1410,19394,0,74,130,379,43,28,39,391,A,30,130,485619,39620,407151,1410,1900,149,130,952,20804,20804,1082,20804,3,0
AS,0,3,0,961,5109,379,759,180,197,0,,1400,5109,485619,39620,407151,0,1900,149,0,0,3,3,0,3,0,0
AZ,3702,39645,0,525,1122,286,759,195,197,0,B,122,1122,43347,39620,407151,38775,1900,149,163,1075,43347,43347,1238,43347,7,48
CA,22348,168534,13200,3015,5109,1178,759,180,197,0,B,687,5109,190882,39620,407151,38775,1900,149,554,0,204082,190882,554,190882,36,0
CO,7684,29850,0,842,1472,379,759,180,197,0,A,304,1472,485619,39620,407151,38775,1900,149,791,1870,37534,37534,2661,37534,30,96
CT,13381,30928,0,1760,5109,379,759,180,197,0,A,602,5109,44309,39620,407151,38775,277,149,1346,1743,44309,44309,3089,44309,48,0
DC,1955,8979,0,295,5109,95,759,31,197,507,A,53,5109,485619,39620,407151,38775,1900,149,80,214,10934,10934,294,10934,3,0
DE,1625,10195,0,201,5109,379,759,180,197,213,A,53,5109,485619,39620,407151,38775,47,6,146,571,11820,11820,717,11820,5,0
FL,20601,175606,1789,961,2833,379,759,180,197,0,A,483,2833,485619,39620,407151,38775,1900,149,1246,12208,197996,196207,13454,196207,18,61
GA,13315,43706,0,961,2589,379,759,180,197,0,A,464,2589,57021,39620,407151,38775,1900,149,863,1705,57021,57021,2568,57021,31,84
GU,133,770,0,12,5109,2,759,2,197,58,,5,5109,485619,39620,407151,38775,1900,149,0,77,903,903,77,903,0,0
HI,499,18345,0,961,44,379,6,180,2,310,A,9,44,485619,39620,407151,38775,1900,149,13,863,18844,18844,876,18844,1,0
IA,1710,16986,0,142,5109,70,759,41,197,741,A,43,5109,485619,39620,407151,1710,1900,149,123,981,18696,18696,1104,18696,2,0
ID,1426,13455,0,62,132,379,38,180,197,0,A,27,132,14881,39620,407151,38775,1900,149,19,554,14881,14881,573,14881,0,1
IL,22025,83743,0,3680,5109,1166,759,821,197,0,A,794,5109,485619,39620,407151,38775,1900,149,1173,3860,105768,105768,5033,105768,74,0
IN,8236,36303,0,961,5109,740,759,459,197,0,B,350,5109,485619,39620,407151,38775,1900,149,308,1742,44539,44539,2050,44539,7,0
KS,1376,12488,0,961,309,379,759,180,197,0,B,62,309,485619,39620,407151,38775,1900,149,39,572,13864,13864,611,13864,6,11
KY,1963,23903,0,289,667,136,256,180,197,607,A,97,667,485619,39620,407151,38775,1900,149,123,1176,25866,25866,1299,25866,3,208
LA,21016,87075,0,2134,5109,379,759,461,197,0,A,884,5109,485619,39620,407151,38775,1900,149,421,3625,108091,108091,4046,108091,44,0
MA,26794,95500,0,3485,3485,379,759,180,197,0,B,1211,3485,485619,39620,407151,38775,1900,149,1413,4037,122294,122294,5450,122294,155,971
MD,8936,42815,0,961,1975,379,759,180,197,603,A,384,1975,485619,39620,407151,38775,360,24,711,1276,51751,51751,1987,51751,49,115
ME,698,11608,0,22,124,379,759,180,197,273,A,19,124,485619,39620,407151,38775,1900,149,65,5520,12306,12306,5585,12306,0,4
MI,32702,67063,0,3986,5109,1570,759,1365,197,447,B,2391,5109,101183,34120,67063,32572,2401,122,1036,2508,99765,99765,3544,99765,142,0
MN,2012,38667,0,157,361,74,146,180,197,772,A,70,361,40679,39620,407151,38775,1900,149,148,637,40679,40679,785,40679,0,0
MO,4388,41040,0,988,5109,379,759,180,197,0,A,114,5109,45189,5165,39977,38775,1900,149,228,0,45428,45428,228,45428,4,0
MP,11,27,9,961,5109,379,759,180,197,0,,2,5109,485619,39620,407151,38775,1900,149,0,0,47,38,0,38,0,0
MS,2942,28042,0,961,549,124,759,84,197,0,A,98,549,485619,39620,407151,38775,1900,149,161,9410,30984,30984,9571,30984,2,1
MT,394,8704,0,21,47,379,759,180,197,171,A,7,47,485619,39620,407151,38775,1900,149,7,178,9098,9098,185,9098,1,0
NC,4816,58572,0,313,5109,379,759,180,197,0,A,86,5109,485619,39620,407151,38775,1900,149,296,953,63388,63388,1249,63388,5,0
ND,331,10450,0,13,40,379,759,180,197,127,B,8,40,485619,39620,407151,38775,1900,149,23,408,10781,10781,431,10781,0,1
NE,814,10158,0,961,5109,379,759,180,197,0,A,17,5109,485619,39620,407151,38775,1900,149,23,258,10972,10972,281,10972,0,0
NH,985,10222,125,961,152,379,759,180,197,239,B,23,152,485619,39620,407151,38775,1900,149,56,226,11332,11207,282,11207,0,6
NJ,64584,64885,0,7781,5109,1886,759,1611,197,0,A,2443,5109,485619,39620,407151,38775,1900,149,2734,0,129469,129469,2734,129469,93,0
NM,1245,29270,0,80,5109,379,759,180,197,295,A,26,5109,485619,39620,407151,38775,1900,149,71,1752,30515,30515,1823,30515,6,0
NV,2971,22493,0,961,5109,379,759,180,197,0,A,133,5109,485619,39620,407151,38775,1900,149,135,718,25464,25464,853,25464,5,0
NY,195031,283326,0,18825,52936,5156,759,180,197,23887,A,10056,52936,485619,39620,407151,38775,1900,149,6337,10419,478357,478357,16756,478357,671,2017
OH,6975,58137,0,961,2033,379,613,180,197,0,B,274,2033,485619,39620,407151,6881,268,6,371,1498,65112,65112,1869,65112,21,85
OK,2069,20790,0,383,457,191,759,180,197,865,B,99,457,485619,39620,407151,38775,1900,149,99,0,22859,22859,99,22859,3,11
OR,1584,29537,0,321,369,96,759,50,197,0,A,53,369,485619,39620,407151,38775,1900,149,57,1306,31121,31121,1363,31121,1,10
PA,24199,105593,0,2243,5109,379,759,669,197,0,A,524,5109,485619,39620,407151,38775,1900,149,1366,3536,129792,129792,4902,129792,17,0
PR,903,5960,1288,961,5109,379,759,180,197,0,A,45,5109,485619,39620,407151,38775,1900,149,6,141,8151,6863,147,6863,1,0
RI,3329,19431,0,197,331,50,759,26,197,135,B,73,331,24684,3417,21267,3329,1900,149,187,853,22760,22760,1040,22760,10,331
SC,3319,28106,0,961,496,379,759,180,197,0,B,82,496,485619,39620,407151,38775,1900,149,0,0,31425,31425,0,31425,0,0
SD,868,8134,0,961,44,379,759,180,197,207,A,6,44,485619,39620,407151,38775,1900,149,138,311,9002,9002,449,9002,0,1
TN,5610,70585,0,458,579,379,759,180,197,1671,A,109,579,485619,39620,407151,38775,1900,149,302,5216,76195,76195,5518,76195,8,12
TX,13906,119320,0,1176,5109,379,759,180,197,2269,A,287,5109,485619,39620,407151,13906,1900,149,422,8271,133226,133226,8693,133226,16,0
UT,2363,43424,0,961,201,379,759,180,197,218,A,18,201,485619,39620,407151,2363,1900,149,60,1493,45787,45787,1553,45787,0,6
VA,5747,35654,473,1238,5109,428,759,302,197,0,A,149,5109,485619,39620,407151,38775,1900,149,473,943,41874,41401,1416,41401,8,0
VI,51,322,2,961,5109,379,759,180,197,43,,1,5109,485619,39620,407151,38775,1900,149,0,23,375,373,23,373,0,0
VT,761,9275,0,33,5109,379,759,180,197,15,A,28,5109,485619,39620,407151,761,1900,149,7,551,10036,10036,558,10036,1,0
WA,12079,124134,0,527,5109,166,759,180,197,0,C,526,5109,485619,39620,407151,11011,1900,149,304,3916,136213,136213,4220,136213,17,0
WI,4080,36769,273,442,993,175,264,180,197,0,A,154,993,485619,39620,407151,3428,1900,149,116,853,41122,40849,969,40849,10,19
WV,626,16029,0,95,164,43,73,23,50,85,B,9,164,485619,39620,407151,38775,1900,149,15,383,16655,16655,398,16655,1,164
WY,275,5689,0,961,41,379,759,180,197,138,A,1,41,485619,39620,407151,270,1900,149,14,491,5964,5964,505,5964,1,1
AK,272,7766,0,961,31,379,759,180,197,66,A,8,31,8038,39620,407151,272,1900,149,15,291,8038,8038,306,8038,0,0
AL,3525,18058,0,290,437,379,189,180,119,0,B,93,437,485619,39620,407151,3525,1900,149,334,0,21583,21583,334,21583,2,35
AR,1280,18442,0,74,130,379,43,30,39,367,A,27,130,485619,39620,407151,1280,1900,149,54,1090,19722,19722,1144,19722,3,0
AS,0,3,2,961,5109,379,759,180,197,0,,1400,5109,485619,39620,407151,0,1900,149,0,0,5,3,0,3,0,0
AZ,3539,38570,0,961,1074,379,759,180,197,0,B,115,1074,42109,39620,407151,38775,1900,149,146,1433,42109,42109,1579,42109,7,37
CA,21794,168534,13200,5234,5109,1539,759,180,197,0,B,651,5109,190328,39620,407151,38775,1900,149,1179,15930,203528,190328,17109,190328,42,0
CO,6893,27980,0,822,1376,379,759,180,197,0,A,274,1376,485619,39620,407151,38775,1900,149,383,1837,34873,34873,2220,34873,24,64
CT,12035,29185,0,1654,5109,379,759,180,197,0,A,554,5109,41220,39620,407151,38775,277,149,525,864,41220,41220,1389,41220,60,0
DC,1875,8765,0,961,5109,379,759,180,197,493,A,50,5109,485619,39620,407151,38775,1900,149,97,504,10640,10640,601,10640,3,0
DE,1479,9624,0,190,5109,379,759,180,197,191,A,48,5109,485619,39620,407151,38775,42,6,0,0,11103,11103,0,11103,5,0
FL,19355,163398,1297,961,2772,379,759,180,197,0,A,465,2772,485619,39620,407151,38775,1900,149,861,8959,184050,182753,9820,182753,27,111
GA,12452,42001,0,961,2505,379,759,180,197,0,A,433,2505,54453,39620,407151,38775,1900,149,293,2445,54453,54453,2738,54453,5,26
GU,133,693,0,13,5109,2,759,2,197,58,,5,5109,485619,39620,407151,38775,1900,149,0,0,826,826,0,826,0,0
HI,486,17482,0,961,44,379,6,180,2,300,A,8,44,485619,39620,407151,38775,1900,149,21,416,17968,17968,437,17968,0,1
IA,1587,16005,0,129,5109,55,759,30,197,674,A,41,5109,485619,39620,407151,1587,1900,149,77,383,17592,17592,460,17592,7,0
ID,1407,12901,0,63,131,379,38,180,197,0,A,27,131,14308,39620,407151,38775,1900,149,11,533,14308,14308,544,14308,2,3
IL,20852,79883,0,3680,5109,1166,759,821,197,0,A,720,5109,485619,39620,407151,38775,1900,149,1672,6914,100735,100735,8586,100735,43,0
IN,7928,34561,0,961,5109,820,759,497,197,0,B,343,5109,485619,39620,407151,38775,1900,149,493,2781,42489,42489,3274,42489,13,0
KS,1337,11916,0,961,298,379,759,180,197,0,B,56,298,485619,39620,407151,38775,1900,149,69,841,13253,13253,910,13253,1,5
KY,1840,22727,0,271,459,105,177,180,197,464,A,94,459,485619,39620,407151,38775,1900,149,147,132,24567,24567,279,24567,4,0
LA,20595,83450,0,2084,5109,379,759,458,197,0,A,840,5109,485619,39620,407151,38775,1900,149,581,6549,104045,104045,7130,104045,34,0
MA,25381,91463,0,2514,2514,379,759,180,197,0,B,1056,2514,485619,39620,407151,38775,1900,149,2615,5348,116844,116844,7963,116844,110,7
MD,8225,41539,0,961,1860,379,759,180,197,456,A,335,1860,485619,39620,407151,38775,317,18,531,1995,49764,49764,2526,49764,37,151
ME,633,6088,0,961,120,379,759,180,197,266,A,19,120,485619,39620,407151,38775,1900,149,17,0,6721,6721,17,6721,0,6
MI,31666,64555,0,3636,5109,1582,759,1441,197,433,B,2249,5109,97593,33038,64555,31715,2269,113,686,2314,96221,96221,3000,96221,168,0
MN,1864,38030,0,157,361,74,146,180,197,772,A,70,361,39894,39620,407151,38775,1900,149,58,1132,39894,39894,1190,39894,6,21
MO,4160,41040,0,988,5109,379,759,180,197,0,A,110,5109,44241,5060,39135,38775,1900,149,136,1892,45200,45200,2028,45200,1,0
MP,11,27,9,961,5109,379,759,180,197,0,,2,5109,485619,39620,407151,38775,1900,149,0,0,47,38,0,38,0,0
MS,2781,18632,0,961,548,379,759,180,197,0,A,96,548,485619,39620,407151,38775,1900,149,139,0,21413,21413,139,21413,3,20
MT,387,8526,0,22,47,379,759,180,197,169,A,6,47,485619,39620,407151,38775,1900,149,10,322,8913,8913,332,8913,0,1
NC,4520,57619,0,331,5109,379,759,180,197,0,A,81,5109,485619,39620,407151,38775,1900,149,208,1538,62139,62139,1746,62139,1,0
ND,308,10042,0,12,39,379,759,180,197,121,B,8,39,485619,39620,407151,38775,1900,149,15,255,10350,10350,270,10350,1,3
NE,791,9900,0,961,5109,379,759,180,197,0,A,17,5109,485619,39620,407151,38775,1900,149,91,615,10691,10691,706,10691,0,0
NH,929,9996,119,961,146,379,759,180,197,236,B,23,146,485619,39620,407151,38775,1900,149,44,388,11044,10925,432,10925,1,12
NJ,61850,64885,0,7604,5109,1914,759,1644,197,0,A,2350,5109,485619,39620,407151,38775,1900,149,3699,2843,126735,126735,6542,126735,167,0
NM,1174,27518,0,78,5109,379,759,18,197,235,A,20,5109,485619,39620,407151,38775,1900,149,83,1511,28692,28692,1594,28692,1,0
NV,2836,21775,0,282,5109,379,759,180,197,0,A,128,5109,485619,39620,407151,38775,1900,149,136,888,24611,24611,1024,24611,3,0
NY,188694,272907,0,18707,50919,5198,759,180,197,23887,A,9385,50919,485619,39620,407151,38775,1900,149,8236,12385,461601,461601,20621,461601,758,2622
OH,6604,56639,0,961,1948,379,595,180,197,0,B,253,1948,485619,39620,407151,6518,248,5,354,2418,63243,63243,2772,63243,6,89
OK,1970,20790,0,383,446,191,759,180,197,865,B,96,446,485619,39620,407151,38775,1900,149,102,0,22760,22760,102,22760,2,0
OR,1527,28231,0,295,359,81,759,52,197,0,A,52,359,485619,39620,407151,38775,1900,149,156,2378,29758,29758,2534,29758,4,21
PA,22833,102057,0,2097,5109,379,759,649,197,0,A,507,5109,485619,39620,407151,38775,1900,149,1178,3559,124890,124890,4737,124890,13,0
PR,897,5819,1251,961,5109,379,759,180,197,0,A,44,5109,485619,39620,407151,38775,1900,149,109,236,7967,6716,345,6716,2,0
RI,3142,18578,0,201,5109,50,759,26,197,35,B,63,5109,23584,3255,20329,3142,1900,149,289,1448,21720,21720,1737,21720,7,0
SC,3319,28106,0,961,496,379,759,180,197,0,B,82,496,485619,39620,407151,38775,1900,149,112,1220,31425,31425,1332,31425,2,0
SD,730,7823,0,961,43,379,759,180,197,197,A,6,43,485619,39620,407151,38775,1900,149,104,445,8553,8553,549,8553,0,10
TN,5308,65369,0,324,567,379,759,180,197,1504,A,101,567,485619,39620,407151,38775,1900,149,194,3655,70677,70677,3849,70677,0,11
TX,13484,111049,0,1338,5109,379,759,180,197,2014,A,271,5109,485619,39620,407151,13484,1900,149,923,3077,124533,124533,4000,124533,17,0
UT,2303,41931,0,961,195,379,759,180,197,0,A,18,195,485619,39620,407151,2303,1900,149,97,1591,44234,44234,1688,44234,0,5
VA,5274,34711,521,751,5109,440,759,294,197,0,A,141,5109,485619,39620,407151,38775,1900,149,197,1789,40506,39985,1986,39985,11,0
VI,51,299,20,3,5109,379,759,180,197,43,,1,5109,485619,39620,407151,38775,1900,149,0,0,370,350,0,350,0,0
VT,754,8724,0,34,5109,379,759,180,197,15,A,27,5109,485619,39620,407151,754,1900,149,21,661,9478,9478,682,9478,2,0
WA,11775,120218,0,642,5109,191,759,180,197,0,C,509,5109,485619,39620,407151,10643,1900,149,170,1261,131993,131993,1431,131993,15,0
WI,3964,35916,0,442,974,179,261,180,197,0,A,144,974,485619,39620,407151,3341,1900,149,142,1236,39880,39880,1378,39880,7,24
WV,611,15646,0,81,5109,36,759,24,197,83,B,8,5109,485619,39620,407151,38775,1900,149,34,771,16257,16257,805,16257,3,0
WY,261,5198,0,961,40,379,759,180,197,137,A,0,40,485619,39620,407151,261,1900,149,0,0,5459,5459,0,5459,0,3
AK,257,7475,0,961,31,379,759,180,197,63,A,8,31,7732,39620,407151,257,1900,149,11,289,7732,7732,300,7732,1,3
AL,3191,18058,0,343,402,379,177,180,113,0,B,91,402,485619,39620,407151,3191,1900,149,223,0,21249,21249,223,21249,11,34
AR,1226,17352,0,86,130,379,43,33,39,340,A,24,130,485619,39620,407151,1226,1900,149,55,1403,18578,18578,1458,18578,1,0
AS,0,3,2,961,5109,379,759,180,197,0,,1400,5109,485619,39620,407151,0,1900,149,0,0,5,3,0,3,0,0
AZ,3393,37137,0,961,1037,379,759,180,197,0,B,108,1037,40530,39620,407151,38775,1900,149,281,2515,40530,40530,2796,40530,11,42
CA,20615,152604,13200,5236,5109,1591,759,180,197,0,B,609,5109,173219,39620,407151,38775,1900,149,1143,7213,186419,173219,8356,173219,68,0
CO,6510,26143,0,841,1312,379,759,180,197,0,A,250,1312,485619,39620,407151,38775,1900,149,0,0,32653,32653,0,32653,0,0
CT,11510,28321,0,1593,5109,379,759,180,197,0,A,494,5109,39831,39620,407151,38775,206,149,972,2571,39831,39831,3543,39831,46,0
DC,1778,8261,0,961,5109,379,759,180,197,447,A,47,5109,485619,39620,407151,38775,1900,149,118,566,10039,10039,684,10039,9,0
DE,1479,9624,0,190,5109,379,759,180,197,191,A,43,5109,485619,39620,407151,38775,37,6,153,-791,11103,11103,-638,11103,7,0
FL,18494,154439,1418,961,2661,379,759,180,197,0,A,438,2661,485619,39620,407151,38775,1900,149,963,9140,174351,172933,10103,172933,48,174
GA,12159,39556,0,961,2479,379,759,180,197,0,A,428,2479,51715,39620,407151,38775,1900,149,676,4892,51715,51715,5568,51715,12,128
GU,133,693,0,14,5109,2,759,2,197,58,,5,5109,485619,39620,407151,38775,1900,149,3,31,826,826,34,826,1,0
HI,465,17066,0,961,43,379,6,180,2,284,A,8,43,485619,39620,407151,38775,1900,149,23,1359,17531,17531,1382,17531,2,1
IA,1510,15622,0,118,5109,55,759,30,197,585,A,34,5109,485619,39620,407151,1510,1900,149,122,1057,17132,17132,1179,17132,3,0
ID,1396,12368,0,61,128,379,35,180,197,0,A,25,128,13764,39620,407151,38775,1900,149,43,627,13764,13764,670,13764,1,1
IL,19180,72969,0,3680,5109,1166,759,821,197,0,A,677,5109,485619,39620,407151,38775,1900,149,1293,3329,92149,92149,4622,92149,81,0
IN,7435,31780,0,961,5109,820,759,497,197,0,B,330,5109,485619,39620,407151,38775,1900,149,528,3647,39215,39215,4175,39215,30,0
KS,1268,11075,0,961,293,379,759,180,197,0,B,55,293,485619,39620,407151,38775,1900,149,102,827,12343,12343,929,12343,5,19
KY,1693,22595,0,271,459,105,177,180,197,464,A,90,459,485619,39620,407151,38775,1900,149,0,0,24288,24288,0,24288,0,0
LA,20014,76901,0,2067,5109,379,759,470,197,0,A,806,5109,485619,39620,407151,38775,1900,149,761,3874,96915,96915,4635,96915,51,0
MA,22766,86115,0,2507,2507,379,759,180,197,0,B,946,2507,485619,39620,407151,38775,1900,149,1888,4551,108881,108881,6439,108881,114,72
MD,7694,39544,0,961,1709,379,759,180,197,431,A,298,1709,485619,39620,407151,38775,286,12,726,2064,47238,47238,2790,47238,43,296
ME,616,6088,0,961,114,379,759,180,197,256,A,19,114,485619,39620,407151,38775,1900,149,30,0,6704,6704,30,6704,2,3
MI,30980,62241,0,3636,5109,1582,759,1441,197,595,B,2081,5109,94307,32066,62241,30727,2136,103,808,2644,93221,93221,3452,93221,164,0
MN,1806,36898,0,145,340,69,138,180,197,729,A,64,340,38704,39620,407151,38775,1900,149,74,1552,38704,38704,1626,38704,7,23
MO,4024,39148,0,506,5109,379,759,180,197,0,A,109,5109,42151,4818,37292,38775,1900,149,225,2207,43172,43172,2432,43172,13,0
MP,11,27,9,961,5109,379,759,180,197,0,,2,5109,485619,39620,407151,38775,1900,149,0,0,47,38,0,38,0,0
MS,2642,18632,0,961,528,379,759,180,197,0,A,93,528,485619,39620,407151,38775,1900,149,173,0,21274,21274,173,21274,11,46
MT,377,8204,0,21,46,379,759,180,197,169,A,6,46,485619,39620,407151,38775,1900,149,12,272,8581,8581,284,8581,0,5
NC,4312,56081,0,362,5109,379,759,180,197,0,A,80,5109,485619,39620,407151,38775,1900,149,404,2344,60393,60393,2748,60393,6,0
ND,293,9787,0,10,36,379,759,180,197,119,B,7,36,485619,39620,407151,38775,1900,149,15,457,10080,10080,472,10080,1,0
NE,700,9285,0,961,5109,379,759,180,197,0,A,17,5109,485619,39620,407151,38775,1900,149,65,566,9985,9985,631,9985,2,0
NH,885,9608,93,961,134,379,759,180,197,234,B,22,134,485619,39620,407151,38775,1900,149,66,469,10586,10493,535,10493,1,10
NJ,58151,62042,0,7618,5109,1746,759,1650,197,0,A,2183,5109,485619,39620,407151,38775,1900,149,3563,3107,120193,120193,6670,120193,251,0
NM,1091,26007,0,75,5109,379,759,18,197,235,A,19,5109,485619,39620,407151,38775,1900,149,0,0,27098,27098,0,27098,0,0
NV,2700,20887,0,282,5109,379,759,180,197,0,A,125,5109,485619,39620,407151,38775,1900,149,116,722,23587,23587,838,23587,5,0
NY,180458,260522,0,18654,48297,5009,759,180,197,22025,A,8627,48297,485619,39620,407151,38775,1900,149,9946,13149,440980,440980,23095,440980,783,2529
OH,6250,54221,0,961,1859,379,572,180,197,0,B,247,1859,485619,39620,407151,6187,242,5,372,1526,60471,60471,1898,60471,16,104
OK,1868,20790,0,383,446,191,759,180,197,865,B,94,446,485619,39620,407151,38775,1900,149,74,420,22658,22658,494,22658,6,18
OR,1371,25853,0,140,338,58,759,46,197,0,A,48,338,485619,39620,407151,38775,1900,149,50,1547,27224,27224,1597,27224,4,12
PA,21655,98498,0,2115,5109,379,759,639,197,0,A,494,5109,485619,39620,407151,38775,1900,149,1676,5458,120153,120153,7134,120153,78,0
PR,788,5583,1332,961,5109,379,759,180,197,0,A,42,5109,485619,39620,407151,38775,1900,149,63,462,7703,6371,525,6371,3,0
RI,2853,17130,0,183,5109,50,759,26,197,35,B,56,5109,21595,2940,18655,2853,1900,149,280,1727,19983,19983,2007,19983,7,0
SC,3207,26886,0,961,496,379,759,180,197,0,B,80,496,485619,39620,407151,38775,1900,149,142,1768,30093,30093,1910,30093,8,0
SD,626,7378,2,961,33,379,759,180,197,189,A,6,33,485619,39620,407151,38775,1900,149,90,267,8006,8004,357,8004,0,4
TN,5114,61714,0,411,556,379,759,180,197,1386,A,101,556,485619,39620,407151,38775,1900,149,252,3777,66828,66828,4029,66828,3,20
TX,12561,107972,0,1514,5109,379,759,180,197,1617,A,254,5109,485619,39620,407151,12561,1900,149,890,3925,120533,120533,4815,120533,28,0
UT,2206,40340,0,961,190,379,759,180,197,0,A,18,190,485619,39620,407151,2206,1900,149,104,1680,42546,42546,1784,42546,1,7
VA,5077,32922,517,1252,5109,426,759,283,197,0,A,130,5109,485619,39620,407151,38775,1900,149,568,1972,38516,37999,2540,37999,9,-772
VI,51,299,20,3,5109,379,759,180,197,43,,1,5109,485619,39620,407151,38775,1900,149,1,26,370,350,27,350,0,0
VT,733,8063,0,77,5109,379,759,180,197,15,A,25,5109,485619,39620,407151,733,1900,149,20,561,8796,8796,581,8796,1,0
WA,11605,118957,0,649,5109,191,759,180,197,0,C,494,5109,485619,39620,407151,10554,1900,149,210,1866,130562,130562,2076,130562,18,0
WI,3822,34680,0,444,950,179,257,180,197,0,A,137,950,485619,39620,407151,3213,1900,149,157,1455,38502,38502,1612,38502,9,46
WV,577,14875,0,85,5109,40,759,22,197,63,B,5,5109,485619,39620,407151,38775,1900,149,23,874,15452,15452,897,15452,0,0
WY,261,5198,0,961,37,379,759,180,197,129,A,0,37,485619,39620,407151,253,1900,149,8,462,5459,5459,470,5459,0,0
AK,246,7186,0,961,28,379,759,180,197,55,A,7,28,7432,39620,407151,246,1900,149,11,198,7432,7432,209,7432,0,1
AL,2968,18058,0,350,368,379,759,180,197,0,B,80,368,485619,39620,407151,2968,1900,149,199,0,21026,21026,199,21026,6,35
AR,1171,15949,0,86,130,379,43,33,39,312,A,23,130,485619,39620,407151,1171,1900,149,52,2117,17120,17120,2169,17120,2,0
AS,0,3,2,961,5109,379,759,180,197,0,,0,5109,485619,39620,407151,0,1900,149,0,0,5,3,0,3,0,0
AZ,3112,34622,0,961,995,379,759,180,197,0,B,97,995,37734,39620,407151,38775,1900,149,94,462,37734,37734,556,37734,8,45
CA,19472,145391,13900,2897,5109,1145,759,180,197,0,B,541,5109,164863,39620,407151,38775,1900,149,1163,200,178763,164863,1363,164863,49,0
CO,6510,26143,0,842,1312,379,759,180,197,0,A,250,1312,485619,39620,407151,38775,1900,149,855,2599,32653,32653,3454,32653,57,150
CT,10538,25750,0,1562,5109,379,759,180,197,0,A,448,5109,36288,39620,407151,38775,189,149,754,2032,36288,36288,2786,36288,68,0
DC,1660,7695,0,961,5109,379,759,180,197,426,A,38,5109,485619,39620,407151,38775,1900,149,137,494,9355,9355,631,9355,6,0
DE,1326,10415,0,181,5109,379,759,180,197,177,A,36,5109,485619,39620,407151,38775,30,6,119,1732,11741,11741,1851,11741,2,0
FL,17531,145299,1411,961,2487,379,759,180,197,0,A,390,2487,485619,39620,407151,38775,1900,149,1167,9114,164241,162830,10281,162830,36,219
GA,11483,34664,0,961,2351,379,759,180,197,0,A,416,2351,46147,39620,407151,38775,1900,149,917,4145,46147,46147,5062,46147,37,192
GU,130,662,0,14,5109,2,759,2,197,41,,4,5109,485619,39620,407151,38775,1900,149,2,69,792,792,71,792,0,0
HI,442,15707,0,961,42,379,6,180,2,251,A,6,42,485619,39620,407151,38775,1900,149,7,391,16149,16149,398,16149,1,0
IA,1388,14565,0,125,5109,55,759,30,197,506,A,31,5109,485619,39620,407151,1388,1900,149,118,862,15953,15953,980,15953,2,0
ID,1353,11741,0,67,127,379,33,180,197,0,A,24,127,13094,39620,407151,38775,1900,149,121,442,13094,13094,563,13094,6,14
IL,17887,69640,0,3680,5109,1166,759,821,197,0,A,596,5109,485619,39620,407151,38775,1900,149,1465,5205,87527,87527,6670,87527,68,0
IN,6907,28133,0,961,5109,820,759,497,197,0,B,300,5109,485619,39620,407151,38775,1900,149,556,2351,35040,35040,2907,35040,55,0
KS,1166,10248,0,961,274,379,759,180,197,0,B,50,274,485619,39620,407151,38775,1900,149,60,579,11414,11414,639,11414,8,11
KY,1693,22595,0,271,459,105,177,180,197,464,A,90,459,485619,39620,407151,38775,1900,149,347,2140,24288,24288,2487,24288,17,459
LA,19253,73027,0,2054,5109,379,759,479,197,0,A,755,5109,485619,39620,407151,38775,1900,149,970,4391,92280,92280,5361,92280,53,0
MA,20878,81564,0,2435,2435,379,759,180,197,0,B,832,2435,485619,39620,407151,38775,1900,149,2035,5418,102442,102442,7453,102442,107,133
MD,6968,37480,0,961,1413,379,759,180,197,397,A,255,1413,485619,39620,407151,38775,244,11,783,2136,44448,44448,2919,44448,34,65
ME,586,6088,0,961,111,379,759,180,197,246,A,17,111,485619,39620,407151,38775,1900,149,26,0,6674,6674,26,6674,1,6
MI,30172,59597,0,3823,5109,1663,759,1394,197,56,B,1917,5109,90552,30955,59597,30085,1978,95,1076,3167,89769,89769,4243,89769,161,0
MN,1732,35346,0,143,317,64,131,180,197,675,A,57,317,37078,39620,407151,38775,1900,149,95,1664,37078,37078,1759,37078,7,24
MO,3799,36941,0,568,5109,379,759,180,197,0,A,96,5109,40173,4603,35533,38775,1900,149,260,1986,40740,40740,2246,40740,19,0
MP,11,27,9,961,5109,379,759,180,197,0,,2,5109,485619,39620,407151,38775,1900,149,0,0,47,38,0,38,0,0
MS,2469,18632,0,961,482,379,759,180,197,0,A,82,482,485619,39620,407151,38775,1900,149,209,0,21101,21101,209,21101,6,41
MT,365,7932,0,29,41,379,759,180,197,165,A,6,41,485619,39620,407151,38775,1900,149,11,426,8297,8297,437,8297,0,5
NC,3908,53737,0,423,5109,379,759,180,197,0,A,74,5109,485619,39620,407151,38775,1900,149,257,9579,57645,57645,9836,57645,9,0
ND,278,9330,0,13,36,379,759,180,197,105,B,6,36,485619,39620,407151,38775,1900,149,9,609,9608,9608,618,9608,1,2
NE,635,8719,0,961,5109,379,759,180,197,0,A,15,5109,485619,39620,407151,38775,1900,149,68,603,9354,9354,671,9354,1,0
NH,819,9139,155,961,124,379,759,180,197,234,B,21,124,485619,39620,407151,38775,1900,149,31,376,10113,9958,407,9958,3,6
NJ,54588,58935,0,7570,5109,1679,759,1663,197,682,A,1932,5109,485619,39620,407151,38775,1900,149,3561,2770,113523,113523,6331,113523,232,0
NM,1091,26007,0,73,5109,379,759,18,197,217,A,19,5109,485619,39620,407151,38775,1900,149,226,3065,27098,27098,3291,27098,3,0
NV,2584,20165,0,282,5109,379,759,180,197,0,A,120,5109,485619,39620,407151,38775,1900,149,128,850,22749,22749,978,22749,10,0
NY,170512,247373,0,18569,45768,4908,759,180,197,20249,A,7844,45768,485619,39620,407151,38775,1900,149,10575,15761,417885,417885,26336,417885,777,2916
OH,5878,52695,0,961,1755,379,548,180,197,0,B,231,1755,485619,39620,407151,5836,227,4,366,2222,58573,58573,2588,58573,18,143
OK,1794,20370,0,186,428,122,759,180,197,790,B,88,428,485619,39620,407151,38775,1900,149,110,1775,22164,22164,1885,22164,8,13
OR,1321,24306,0,146,326,66,759,54,197,0,A,44,326,485619,39620,407151,38775,1900,149,0,0,25627,25627,0,25627,0,0
PA,19979,93040,0,2072,5109,379,759,611,197,0,A,416,5109,485619,39620,407151,38775,1900,149,1751,5666,113019,113019,7417,113019,78,0
PR,725,5121,1392,961,5109,379,759,180,197,0,A,39,5109,485619,39620,407151,38775,1900,149,42,418,7238,5846,460,5846,6,0
RI,2573,15403,0,169,5109,45,759,26,197,35,B,49,5109,19385,2641,16744,2573,1900,149,404,2374,17976,17976,2778,17976,6,0
SC,3065,25118,0,961,496,379,759,180,197,0,B,72,496,485619,39620,407151,38775,1900,149,273,543,28183,28183,816,28183,5,255
SD,536,7111,0,961,29,379,759,180,197,177,A,6,29,485619,39620,407151,38775,1900,149,89,411,7647,7647,500,7647,0,2
TN,4862,57937,0,561,536,379,759,180,197,1145,A,98,536,485619,39620,407151,38775,1900,149,228,2722,62799,62799,2950,62799,4,31
TX,11671,104047,0,1532,5109,379,759,180,197,1366,A,226,5109,485619,39620,407151,11671,1900,149,1441,8143,115718,115718,9584,115718,27,0
UT,2102,38660,0,961,183,379,759,180,197,0,A,17,183,485619,39620,407151,2102,1900,149,126,2263,40762,40762,2389,40762,4,15
VA,4509,30950,521,1238,772,457,759,287,197,0,A,121,772,485619,39620,407151,38775,1900,149,467,1966,35980,35459,2433,35459,12,87
VI,50,273,45,3,5109,379,759,180,197,43,,1,5109,485619,39620,407151,38775,1900,149,4,22,368,323,26,323,0,0
VT,713,7502,0,32,5109,379,759,180,197,15,A,24,5109,485619,39620,407151,713,1900,149,33,284,8215,8215,317,8215,1,0
WA,11395,117091,0,642,5109,191,759,180,197,0,C,476,5109,485619,39620,407151,10399,1900,149,277,4022,128486,128486,4299,128486,17,0
WI,3665,33225,0,961,904,190,247,180,197,0,A,128,904,485619,39620,407151,3068,1900,149,222,1801,36890,36890,2023,36890,17,61
WV,554,14001,0,85,5109,20,759,22,197,63,B,5,5109,485619,39620,407151,38775,1900,149,31,661,14555,14555,692,14555,0,0
WY,253,4736,0,961,37,379,759,180,197,105,A,0,37,485619,39620,407151,239,1900,149,23,816,4989,4989,839,4989,0,3
AK,235,6988,0,961,27,379,759,180,197,49,A,7,27,7223,39620,407151,235,1900,149,9,146,7223,7223,155,7223,0,0
AL,2769,18058,0,324,333,379,759,180,197,0,B,74,333,485619,39620,407151,2769,1900,149,400,1305,20827,20827,1705,20827,8,19
AR,1119,13832,0,73,130,379,43,31,39,288,A,21,130,485619,39620,407151,1119,1900,149,119,302,14951,14951,421,14951,3,0
AS,0,3,2,961,5109,379,759,180,197,0,,0,5109,485619,39620,407151,0,1900,149,0,0,5,3,0,3,0,0
AZ,3018,34160,0,961,950,379,759,180,197,0,B,89,950,37178,39620,407151,38775,1900,149,292,2322,37178,37178,2614,37178,9,44
CA,18309,145191,14100,2825,5109,1132,759,180,197,0,B,492,5109,163500,39620,407151,38775,1900,149,1352,17884,177600,163500,19236,163500,50,0
CO,5655,23544,0,848,1162,379,759,180,197,0,A,193,1162,485619,39620,407151,38775,1900,149,226,879,29199,29199,1105,29199,14,83
CT,9784,23718,0,1464,5109,379,759,180,197,0,A,380,5109,33502,39620,407151,38775,165,149,2003,2463,33502,33502,4466,33502,103,0
DC,1523,7201,0,961,5109,379,759,180,197,393,A,32,5109,485619,39620,407151,38775,1900,149,83,358,8724,8724,441,8724,5,0
DE,1207,8683,0,201,5109,379,759,180,197,173,A,34,5109,485619,39620,407151,38775,28,6,279,1055,9890,9890,1334,9890,2,0
FL,16364,136185,1395,961,2268,379,759,180,197,0,A,354,2268,485619,39620,407151,38775,1900,149,909,8506,153944,152549,9415,152549,45,206
GA,10566,30519,0,961,2159,379,759,180,197,0,A,379,2159,41085,39620,407151,38775,1900,149,665,1633,41085,41085,2298,41085,17,166
GU,128,593,0,14,5109,2,759,2,197,33,,4,5109,485619,39620,407151,38775,1900,149,3,31,721,721,34,721,0,0
HI,435,15316,0,961,42,379,6,180,197,113,A,5,42,485619,39620,407151,38775,1900,149,25,577,15751,15751,602,15751,0,0
IA,1270,13703,0,122,5109,379,759,180,197,476,A,29,5109,485619,39620,407151,1270,1900,149,125,882,14973,14973,1007,14973,2,-193
ID,1232,11299,0,70,113,379,29,180,197,0,A,18,113,12531,39620,407151,38775,1900,149,22,611,12531,12531,633,12531,3,20
IL,16422,64435,0,3680,5109,1166,759,821,197,0,A,528,5109,485619,39620,407151,38775,1900,149,1344,4447,80857,80857,5791,80857,66,0
IN,6351,25782,0,961,5109,924,759,507,197,0,B,245,5109,485619,39620,407151,38775,1900,149,408,856,32133,32133,1264,32133,42,0
KS,1106,9669,0,961,263,379,759,180,197,0,B,42,263,485619,39620,407151,38775,1900,149,60,532,10775,10775,592,10775,4,40
KY,1346,20455,0,961,5109,379,759,180,197,0,A,73,5109,485619,39620,407151,38775,1900,149,197,0,21801,21801,197,21801,8,0
LA,18283,68636,0,2014,5109,379,759,473,197,0,A,702,5109,485619,39620,407151,38775,1900,149,1253,4260,86919,86919,5513,86919,50,0
MA,18843,76146,0,2302,2302,379,759,180,197,0,B,725,2302,485619,39620,407151,38775,1900,149,2151,5297,94989,94989,7448,94989,110,183
MD,6185,35344,0,961,1348,379,759,180,197,376,A,221,1348,485619,39620,407151,38775,210,11,656,2411,41529,41529,3067,41529,30,138
ME,560,6088,0,961,105,379,759,180,197,202,A,16,105,485619,39620,407151,38775,1900,149,23,0,6648,6648,23,6648,2,4
MI,29096,56430,0,3826,5109,1628,759,1434,197,56,B,1756,5109,85972,29542,56430,29327,1822,88,1032,3254,85526,85526,4286,85526,156,0
MN,1637,33682,0,145,293,63,119,180,197,625,A,50,293,35319,39620,407151,38775,1900,149,103,1728,35319,35319,1831,35319,11,22
MO,3539,34955,0,568,5109,379,759,180,197,0,A,77,5109,37902,4348,33518,38775,1900,149,212,4172,38494,38494,4384,38494,19,0
MP,11,27,9,961,5109,379,759,180,197,0,,2,5109,485619,39620,407151,38775,1900,149,0,0,47,38,0,38,0,0
MS,2260,18632,0,961,441,379,759,180,197,0,A,76,441,485619,39620,407151,38775,1900,149,257,0,20892,20892,257,20892,9,31
MT,354,7506,0,13,36,379,759,180,197,157,A,6,36,485619,39620,407151,38775,1900,149,22,440,7860,7860,462,7860,0,5
NC,3651,44158,0,398,5109,379,759,180,197,0,A,65,5109,485619,39620,407151,38775,1900,149,225,4597,47809,47809,4822,47809,12,0
ND,269,8721,0,14,34,379,759,180,197,101,B,5,34,485619,39620,407151,38775,1900,149,18,420,8990,8990,438,8990,1,0
NE,567,8116,0,961,5109,379,759,180,197,0,A,14,5109,485619,39620,407151,38775,1900,149,48,674,8683,8683,722,8683,2,0
NH,788,8763,143,961,118,379,759,180,197,227,B,18,118,485619,39620,407151,38775,1900,149,0,374,9694,9551,374,9551,0,0
NJ,51027,56165,0,7363,5109,1523,759,1551,197,0,A,1700,5109,485619,39620,407151,38775,1900,149,3590,3186,107192,107192,6776,107192,196,0
NM,865,22942,0,59,5109,379,759,18,197,201,A,16,5109,485619,39620,407151,38775,1900,149,71,1491,23807,23807,1562,23807,3,0
NV,2456,19315,0,282,5109,379,759,180,197,0,A,110,5109,485619,39620,407151,38775,1900,149,138,1067,21771,21771,1205,21771,9,0
NY,159937,231612,0,18279,42852,4925,759,180,197,18297,A,7067,42852,485619,39620,407151,38775,1900,149,10621,15775,391549,391549,26396,391549,799,2870
OH,5512,50473,0,961,1612,379,497,180,197,0,B,213,1612,485619,39620,407151,5512,1900,149,364,2280,55985,55985,2644,55985,20,117
OK,1684,18595,0,188,415,120,759,180,197,686,B,80,415,485619,39620,407151,38775,1900,149,160,6774,20279,20279,6934,20279,1,25
OR,1321,24306,0,146,326,66,759,54,197,0,A,44,326,485619,39620,407151,38775,1900,149,82,981,25627,25627,1063,25627,11,2
PA,18228,87374,0,2051,5109,379,759,592,197,0,A,338,5109,485619,39620,407151,38775,1900,149,1989,5075,105602,105602,7064,105602,29,0
PR,683,4703,1304,961,5109,379,759,180,197,0,A,33,5109,485619,39620,407151,38775,1900,149,63,437,6690,5386,500,5386,9,0
RI,2169,13029,0,160,5109,45,759,26,197,35,B,43,5109,16388,2221,14167,2169,1900,149,279,1362,15198,15198,1641,15198,8,0
SC,2792,24575,0,961,241,379,759,180,197,0,B,67,241,485619,39620,407151,38775,1900,149,240,2493,27367,27367,2733,27367,4,0
SD,447,6700,0,961,27,379,759,180,197,161,A,6,27,485619,39620,407151,38775,1900,149,54,345,7147,7147,399,7147,0,1
TN,4634,55215,0,639,505,379,759,180,197,921,A,94,505,485619,39620,407151,38775,1900,149,272,2959,59849,59849,3231,59849,15,56
TX,10230,95904,0,1439,5109,379,759,180,197,1101,A,199,5109,485619,39620,407151,10230,1900,149,877,8999,106134,106134,9876,106134,22,0
UT,1976,36397,0,961,168,379,759,180,197,0,A,13,168,485619,39620,407151,1976,1900,149,130,2127,38373,38373,2257,38373,0,10
VA,4042,28984,627,669,685,469,759,285,197,0,A,109,685,485619,39620,407151,38775,1900,149,397,1984,33653,33026,2381,33026,34,70
VI,46,251,42,961,5109,379,759,180,197,39,,1,5109,485619,39620,407151,38775,1900,149,1,9,339,297,10,297,0,0
VT,680,7218,0,33,5109,379,759,180,197,15,A,23,5109,485619,39620,407151,680,1900,149,49,217,7898,7898,266,7898,0,-50
WA,11118,113069,0,650,5109,191,759,180,197,0,A,459,5109,485619,39620,407151,10092,1900,149,287,4019,124187,124187,4306,124187,16,0
WI,3443,31424,0,961,843,379,230,180,197,0,A,111,843,485619,39620,407151,2885,1900,149,164,1309,34867,34867,1473,34867,12,53
WV,523,13340,0,961,5109,379,759,180,197,0,B,5,5109,485619,39620,407151,38775,1900,149,61,1257,13863,13863,1318,13863,1,0
WY,230,3920,0,961,34,379,759,180,197,94,A,0,34,485619,39620,407151,230,1900,149,9,77,4150,4150,86,4150,0,1
AK,226,6842,0,961,27,379,759,180,197,32,A,7,27,7068,39620,407151,226,1900,149,13,142,7068,7068,155,7068,1,4
AL,2369,16753,0,308,314,379,759,180,197,0,B,66,314,485619,39620,407151,2369,1900,149,250,3956,19122,19122,4206,19122,10,43
AR,1000,13530,0,76,130,379,43,30,39,208,A,18,130,485619,39620,407151,1000,1900,149,54,838,14530,14530,892,14530,2,-18
AS,0,3,2,961,5109,379,759,180,197,0,,0,5109,485619,39620,407151,0,1900,149,0,0,5,3,0,3,0,0
AZ,2726,31838,0,961,906,379,759,180,197,0,B,80,906,34564,39620,407151,38775,1900,149,151,1038,34564,34564,1189,34564,7,53
CA,16957,127307,14600,2714,5109,1154,759,180,197,0,B,442,5109,144264,39620,407151,38775,1900,149,1092,11943,158864,144264,13035,144264,68,0
CO,5429,22665,0,833,1079,379,759,180,197,0,A,179,1079,485619,39620,407151,38775,1900,149,257,962,28094,28094,1219,28094,29,85
CT,7781,21255,0,1308,5109,379,759,180,197,0,A,277,5109,31700,39620,407151,38775,131,149,0,0,29036,29036,0,29036,0,0
DC,1440,6843,0,961,5109,379,759,180,197,361,A,27,5109,485619,39620,407151,38775,1900,149,229,231,8283,8283,460,8283,5,0
DE,928,7628,0,147,5109,379,759,180,197,144,A,32,5109,485619,39620,407151,38775,27,5,0,0,8556,8556,0,8556,4,0
FL,15455,127679,1324,961,2062,379,759,180,197,0,A,309,2062,485619,39620,407151,38775,1900,149,708,4264,144458,143134,4972,143134,13,63
GA,9901,28886,0,961,1993,379,759,180,197,0,A,362,1993,38787,39620,407151,38775,1900,149,1083,3991,38787,38787,5074,38787,33,219
GU,125,562,0,21,5109,2,759,2,197,31,,4,5109,485619,39620,407151,38775,1900,149,4,33,687,687,37,687,0,0
HI,410,14739,0,961,42,379,6,180,197,113,A,5,42,485619,39620,407151,38775,1900,149,23,1584,15149,15149,1607,15149,0,16
IA,1145,12821,0,122,193,379,759,180,197,431,A,27,193,485619,39620,407151,1145,1900,149,97,1151,13966,13966,1248,13966,1,0
ID,1210,10688,0,62,93,379,24,180,197,0,A,15,93,11898,39620,407151,38775,1900,149,40,612,11898,11898,652,11898,2,10
IL,15078,59988,0,3680,5109,1166,759,821,197,0,A,462,5109,485619,39620,407151,38775,1900,149,1529,4805,75066,75066,6334,75066,82,0
IN,5943,24926,0,961,5109,924,759,507,197,0,B,203,5109,485619,39620,407151,38775,1900,149,436,1669,30869,30869,2105,30869,30,0
KS,1046,9137,0,961,223,379,759,180,197,0,B,38,223,485619,39620,407151,38775,1900,149,146,523,10183,10183,669,10183,11,0
KY,1149,20455,0,961,5109,379,759,180,197,0,A,65,5109,485619,39620,407151,38775,1900,149,141,1508,21604,21604,1649,21604,6,0
LA,17030,64376,0,1983,5109,379,759,490,197,0,A,652,5109,485619,39620,407151,38775,1900,149,746,6005,81406,81406,6751,81406,70,0
MA,16692,70849,0,2119,2119,379,759,180,197,0,B,615,2119,485619,39620,407151,38775,1900,149,1588,4579,87541,87541,6167,87541,100,288
MD,5529,32933,0,961,1210,379,759,180,197,365,A,191,1210,485619,39620,407151,38775,181,10,1158,5677,38462,38462,6835,38462,31,104
ME,537,6088,0,961,101,379,759,180,197,187,A,14,101,485619,39620,407151,38775,1900,149,18,0,6625,6625,18,6625,2,2
MI,28064,53176,0,961,5109,379,759,180,197,56,B,1600,5109,81186,28010,53176,28303,1668,78,1100,2832,81240,81240,3932,81240,151,0
MN,1534,31954,0,135,271,64,105,180,197,593,A,39,271,33488,39620,407151,38775,1900,149,102,1351,33488,33488,1453,33488,5,29
MO,3327,30783,0,519,5109,379,759,180,197,0,A,58,5109,35599,4106,31459,38775,1900,149,290,1851,34110,34110,2141,34110,5,0
MP,11,27,9,961,5109,379,759,180,197,0,,2,5109,485619,39620,407151,38775,1900,149,3,12,47,38,15,38,0,0
MS,2003,18632,0,961,410,379,759,180,197,0,A,67,410,485619,39620,407151,38775,1900,149,88,0,20635,20635,88,20635,8,33
MT,332,7066,0,961,31,379,759,180,197,135,A,6,31,485619,39620,407151,38775,1900,149,13,400,7398,7398,413,7398,0,3
NC,3426,39561,0,386,5109,379,759,180,197,0,A,53,5109,485619,39620,407151,38775,1900,149,205,1700,42987,42987,1905,42987,7,0
ND,251,8301,0,16,34,379,759,180,197,98,B,4,34,485619,39620,407151,38775,1900,149,14,835,8552,8552,849,8552,0,1
NE,519,7442,0,961,5109,379,759,180,197,0,A,12,5109,485619,39620,407151,38775,1900,149,72,631,7961,7961,703,7961,2,0
NH,788,8389,89,961,118,379,759,180,197,211,B,18,118,485619,39620,407151,38775,1900,149,73,370,9266,9177,443,9177,9,15
NJ,47437,52979,0,7026,5109,1617,759,1576,197,0,A,1504,5109,485619,39620,407151,38775,1900,149,3021,2421,100416,100416,5442,100416,272,0
NM,794,21451,0,51,5109,379,759,18,197,171,A,13,5109,485619,39620,407151,38775,1900,149,108,312,22245,22245,420,22245,1,0
NV,2318,18248,0,282,5109,379,759,180,197,0,A,101,5109,485619,39620,407151,38775,1900,149,231,1696,20566,20566,1927,20566,10,0
NY,149316,215837,0,18079,39982,4841,759,180,197,16353,A,6268,39982,485619,39620,407151,38775,1900,149,10453,14642,365153,365153,25095,365153,779,3050
OH,5148,48193,0,961,1495,379,472,180,197,0,B,193,1495,485619,39620,407151,5148,1900,149,366,2137,53341,53341,2503,53341,26,141
OK,1524,11821,0,188,390,120,759,180,197,686,B,79,390,485619,39620,407151,38775,1900,149,52,0,13345,13345,52,13345,12,14
OR,1239,23325,0,156,324,61,759,58,69,0,A,33,324,485619,39620,407151,38775,1900,149,58,1499,24564,24564,1557,24564,0,0
PA,16239,82299,0,1898,5109,379,759,603,197,0,A,309,5109,485619,39620,407151,38775,1900,149,1680,5580,98538,98538,7260,98538,69,0
PR,620,4266,1160,961,5109,379,759,180,197,0,A,24,5109,485619,39620,407151,38775,1900,149,47,300,6046,4886,347,4886,1,0
RI,1890,11667,0,143,5109,45,759,26,197,35,B,35,5109,14583,1937,12646,1890,1900,149,273,1572,13557,13557,1845,13557,5,0
SC,2552,22082,0,961,241,379,759,180,197,0,B,63,241,485619,39620,407151,38775,1900,149,135,819,24634,24634,954,24634,12,0
SD,393,6355,0,961,26,379,759,180,197,146,A,6,26,485619,39620,407151,38775,1900,149,73,407,6748,6748,480,6748,0,3
TN,4362,52256,0,708,449,379,759,180,197,592,A,79,449,485619,39620,407151,38775,1900,149,224,3520,56618,56618,3744,56618,7,41
TX,9353,86905,0,1491,5109,379,759,180,197,38,A,177,5109,485619,39620,407151,9353,1900,149,1091,6518,96258,96258,7609,96258,23,0
UT,1846,34270,0,961,158,379,759,180,197,0,A,13,158,485619,39620,407151,1846,1900,149,108,1361,36116,36116,1469,36116,0,10
VA,3645,27000,0,961,615,379,145,180,108,0,A,75,615,485619,39620,407151,38775,1900,149,312,1688,30645,30645,2000,30645,12,52
VI,45,242,35,961,5109,379,759,180,197,39,,1,5109,485619,39620,407151,38775,1900,149,2,20,322,287,22,287,0,0
VT,631,7001,0,35,50,379,759,180,197,15,A,23,50,485619,39620,407151,631,1900,149,23,356,7632,7632,379,7632,0,5
WA,10831,109050,0,655,5109,186,759,180,197,0,A,443,5109,485619,39620,407151,9728,1900,149,284,4520,119881,119881,4804,119881,14,0
WI,3279,30115,0,961,790,379,218,180,197,0,A,99,790,485619,39620,407151,2756,1900,149,215,1603,33394,33394,1818,33394,7,45
WV,462,12083,0,961,5109,379,759,180,197,0,B,4,5109,485619,39620,407151,38775,1900,149,50,436,12545,12545,486,12545,0,0
WY,221,3843,0,961,33,379,759,180,197,62,A,0,33,485619,39620,407151,220,1900,149,5,54,4064,4064,59,4064,0,0
AK,213,6700,0,961,23,379,759,180,197,29,A,6,23,6913,39620,407151,213,1900,149,22,8,6913,6913,30,6913,0,0
AL,2119,12797,0,302,271,379,759,180,197,0,B,56,271,485619,39620,407151,2119,1900,149,151,0,14916,14916,151,14916,6,31
AR,946,12692,0,74,148,379,759,26,43,142,A,16,148,485619,39620,407151,946,1900,149,71,722,13638,13638,793,13638,0,11
AS,0,3,2,961,5109,379,759,180,197,0,,0,5109,485619,39620,407151,0,1900,149,0,0,5,3,0,3,0,0
AZ,2575,30800,0,961,853,379,759,180,197,0,B,73,853,33375,39620,407151,38775,1900,149,119,722,33375,33375,841,33375,8,34
CA,15865,115364,14100,2611,5109,1108,759,180,197,0,B,374,5109,131229,39620,407151,38775,1900,149,1529,12269,145329,131229,13798,131229,31,0
CO,5172,21703,0,786,994,379,759,180,197,0,A,150,994,485619,39620,407151,38775,1900,149,222,880,26875,26875,1102,26875,10,70
CT,7781,21255,0,1308,5109,379,759,180,197,0,A,277,5109,29036,39620,407151,38775,112,149,875,1475,29036,29036,2350,29036,71,0
DC,1211,6612,0,961,5109,379,759,180,197,318,A,22,5109,485619,39620,407151,38775,1900,149,114,256,7823,7823,370,7823,-2,0
DE,928,7628,0,147,5109,379,759,180,197,144,A,28,5109,485619,39620,407151,38775,23,5,255,1307,8556,8556,1562,8556,4,0
FL,14747,123415,1407,961,1999,379,759,180,197,0,A,296,1999,485619,39620,407151,38775,1900,149,1423,13465,139569,138162,14888,138162,60,317
GA,8818,24895,0,961,1774,379,759,180,197,0,A,329,1774,33713,39620,407151,38775,1900,149,1504,935,33713,33713,2439,33713,100,442
GU,121,529,0,21,5109,2,759,2,197,27,,4,5109,485619,39620,407151,38775,1900,149,8,24,650,650,32,650,0,0
HI,387,13155,0,961,26,379,6,180,197,89,A,5,26,485619,39620,407151,38775,1900,149,16,0,13542,13542,16,13542,1,5
IA,1048,11670,0,104,193,379,759,180,197,341,A,26,193,485619,39620,407151,1048,1900,149,102,1017,12718,12718,1119,12718,1,14
ID,1170,10076,0,67,83,379,21,180,197,0,A,13,83,11246,39620,407151,38775,1900,149,69,182,11246,11246,251,11246,3,6
IL,13549,55183,0,3680,5109,1166,759,821,197,0,A,380,5109,485619,39620,407151,38775,1900,149,1287,4503,68732,68732,5790,68732,73,0
IN,5507,23257,0,961,5109,924,759,507,197,0,B,173,5109,485619,39620,407151,38775,1900,149,563,2010,28764,28764,2573,28764,34,0
KS,900,8614,0,961,223,379,759,180,197,0,B,27,223,485619,39620,407151,38775,1900,149,55,375,9514,9514,430,9514,2,25
KY,1008,18947,0,961,5109,379,759,180,197,0,A,59,5109,485619,39620,407151,38775,1900,149,53,1135,19955,19955,1188,19955,14,0
LA,16284,58371,0,1996,5109,379,759,519,197,0,A,582,5109,485619,39620,407151,38775,1900,149,1417,4072,74655,74655,5489,74655,70,0
MA,15104,66270,0,1831,1831,379,759,180,197,0,B,515,1831,485619,39620,407151,38775,1900,149,1365,3550,81374,81374,4915,81374,67,164
MD,4371,27256,0,961,1106,379,759,180,197,288,A,160,1106,485619,39620,407151,38775,152,8,326,1684,31627,31627,2010,31627,22,47
ME,519,6088,0,961,99,379,759,180,197,176,A,12,99,485619,39620,407151,38775,1900,149,20,0,6607,6607,20,6607,2,7
MI,26964,50344,0,961,5109,379,759,180,197,56,B,1449,5109,77133,26789,50344,27334,1522,72,1179,3082,77308,77308,4261,77308,158,0
MN,1432,30603,0,120,242,64,100,180,197,515,A,34,242,32035,39620,407151,38775,1900,149,102,1448,32035,32035,1550,32035,4,19
MO,3037,28932,0,508,5109,379,759,180,197,0,A,53,5109,32855,3786,29042,38775,1900,149,315,1819,31969,31969,2134,31969,14,0
MP,8,15,0,961,5109,379,759,180,197,0,,2,5109,485619,39620,407151,38775,1900,149,0,2,23,23,2,23,1,0
MS,1915,18632,0,961,377,379,759,180,197,0,A,59,377,485619,39620,407151,38775,1900,149,177,0,20547,20547,177,20547,8,-98
MT,319,6666,0,961,28,379,759,180,197,0,A,6,28,485619,39620,407151,38775,1900,149,20,175,6985,6985,195,6985,0,4
NC,3221,37861,0,354,5109,379,759,180,197,0,A,46,5109,485619,39620,407151,38775,1900,149,351,5,41082,41082,356,41082,13,0
ND,237,7466,0,18,33,379,759,180,197,82,B,4,33,485619,39620,407151,38775,1900,149,12,478,7703,7703,490,7703,1,1
NE,447,6811,0,961,5109,379,759,180,197,0,A,10,5109,485619,39620,407151,38775,1900,149,38,433,7258,7258,471,7258,2,0
NH,715,8019,49,961,103,379,759,180,197,151,B,9,103,485619,39620,407151,38775,1900,149,46,318,8783,8734,364,8734,0,11
NJ,44416,50558,0,7017,5109,1651,759,1540,197,0,A,1232,5109,485619,39620,407151,38775,1900,149,3326,2616,94974,94974,5942,94974,229,0
NM,686,21139,0,48,5109,379,759,18,197,133,A,12,5109,485619,39620,407151,38775,1900,149,62,2627,21825,21825,2689,21825,0,0
NV,2087,16552,0,282,5109,379,759,180,197,0,A,91,5109,485619,39620,407151,38775,1900,149,134,876,18639,18639,1010,18639,12,0
NY,138863,201195,0,17493,36932,4539,759,180,197,14590,A,5489,36932,485619,39620,407151,38775,1900,149,8174,11073,340058,340058,19247,340058,731,2555
OH,4782,46056,0,961,1354,379,417,180,197,0,B,167,1354,485619,39620,407151,4782,1900,149,332,2128,50838,50838,2460,50838,25,140
OK,1472,11821,0,186,376,137,759,180,197,612,B,67,376,485619,39620,407151,38775,1900,149,145,10399,13293,13293,10544,13293,16,36
OR,1181,21826,0,961,324,379,759,69,197,0,A,33,324,485619,39620,407151,38775,1900,149,49,1157,23007,23007,1206,23007,6,66
PA,14559,76719,0,1665,5109,379,759,548,197,0,A,240,5109,485619,39620,407151,38775,1900,149,1579,5845,91278,91278,7424,91278,78,-1145
PR,573,3966,968,961,5109,379,759,180,197,0,A,23,5109,485619,39620,407151,38775,1900,149,60,534,5507,4539,594,4539,2,0
RI,1617,10095,0,123,5109,40,759,26,197,35,B,30,5109,12570,1647,10923,1617,1900,149,261,1486,11712,11712,1747,11712,3,0
SC,2417,21263,0,961,241,379,759,180,197,0,B,51,241,485619,39620,407151,38775,1900,149,368,4336,23680,23680,4704,23680,7,0
SD,320,5948,2,961,23,379,759,180,197,98,A,6,23,485619,39620,407151,38775,1900,149,32,216,6270,6268,248,6268,2,0
TN,4138,48736,0,802,408,379,759,180,197,466,A,72,408,485619,39620,407151,38775,1900,149,336,5188,52874,52874,5524,52874,7,56
TX,8262,80387,0,1252,5109,379,759,180,197,38,A,154,5109,485619,39620,407151,8262,1900,149,986,2306,88649,88649,3292,88649,14,0
UT,1738,32909,0,961,148,379,759,180,197,0,A,13,148,485619,39620,407151,1738,1900,149,63,1190,34647,34647,1253,34647,0,10
VA,3333,25312,0,961,563,379,145,180,108,0,A,63,563,485619,39620,407151,38775,1900,149,455,3669,28645,28645,4124,28645,9,66
VI,43,222,20,961,5109,379,759,180,197,36,,1,5109,485619,39620,407151,38775,1900,149,0,0,285,265,0,265,0,0
VT,608,6645,0,29,45,379,759,180,197,15,A,23,45,485619,39620,407151,608,1900,149,33,484,7253,7253,517,7253,0,0
WA,10547,104530,0,641,5109,190,759,180,197,0,A,429,5109,485619,39620,407151,9384,1900,149,265,4964,115077,115077,5229,115077,22,0
WI,3064,28512,0,961,745,379,200,180,197,0,A,92,745,485619,39620,407151,2578,1900,149,198,1938,31576,31576,2136,31576,15,77
WV,412,11647,0,961,5109,379,759,180,197,0,B,4,5109,485619,39620,407151,38775,1900,149,67,2052,12059,12059,2119,12059,0,0
WY,216,3789,0,961,33,379,759,180,197,62,A,0,33,485619,39620,407151,210,1900,149,6,70,4005,4005,76,4005,0,10
AK,191,6692,0,961,23,379,759,180,197,0,A,6,23,6883,39620,407151,191,1900,149,6,593,6883,6883,599,6883,0,3
AL,1968,12797,0,297,240,379,759,180,197,0,B,50,240,485619,39620,407151,1968,1900,149,172,1515,14765,14765,1687,14765,5,9
AR,875,11970,0,74,137,379,759,22,39,102,A,16,137,485619,39620,407151,875,1900,149,45,1558,12845,12845,1603,12845,0,7
AS,0,3,2,961,5109,379,759,180,197,0,,0,5109,485619,39620,407151,0,1900,149,0,0,5,3,0,3,0,0
AZ,2456,30078,0,961,819,379,759,180,197,0,B,65,819,32534,39620,407151,38775,1900,149,187,4937,32534,32534,5124,32534,1,59
CA,14336,103095,15000,2509,5109,1085,759,180,197,0,B,343,5109,117431,39620,407151,38775,1900,149,898,0,132431,117431,898,117431,24,0
CO,4950,20823,0,786,924,379,759,180,197,0,A,140,924,485619,39620,407151,38775,1900,149,385,1488,25773,25773,1873,25773,14,49
CT,6906,19780,0,1221,5109,379,759,180,197,0,A,206,5109,26686,39620,407151,38775,85,149,1231,2185,26686,26686,3416,26686,17,0
DC,1097,6356,0,961,5109,379,759,180,197,287,A,24,5109,485619,39620,407151,38775,1900,149,99,520,7453,7453,619,7453,2,0
DE,673,6321,0,101,5109,379,759,180,197,71,A,24,5109,485619,39620,407151,38775,20,4,0,0,6994,6994,0,6994,5,0
FL,13324,109950,1142,961,1682,379,759,180,197,0,A,236,1682,485619,39620,407151,38775,1900,149,1173,8697,124416,123274,9870,123274,18,110
GA,7314,23960,0,961,1332,379,759,180,197,0,A,229,1332,31274,39620,407151,38775,1900,149,667,2775,31274,31274,3442,31274,18,49
GU,113,505,0,21,5109,2,759,180,197,25,,4,5109,485619,39620,407151,38775,1900,149,1,12,618,618,13,618,0,0
HI,371,13155,0,961,21,379,6,180,197,85,A,4,21,485619,39620,407151,38775,1900,149,20,551,13526,13526,571,13526,0,2
IA,946,10653,0,99,179,379,759,180,197,284,A,25,179,485619,39620,407151,946,1900,149,78,680,11599,11599,758,11599,3,14
ID,1101,9894,0,62,77,379,16,180,197,0,A,10,77,10995,39620,407151,38775,1900,149,24,710,10995,10995,734,10995,0,11
IL,12262,50680,0,961,5109,379,759,180,197,0,A,307,5109,485619,39620,407151,38775,1900,149,1006,2953,62942,62942,3959,62942,33,0
IN,4944,21247,0,961,5109,924,759,507,197,0,B,139,5109,485619,39620,407151,38775,1900,149,533,3006,26191,26191,3539,26191,12,0
KS,845,8239,0,961,198,379,759,180,197,0,B,25,198,485619,39620,407151,38775,1900,149,98,763,9084,9084,861,9084,3,15
KY,955,17812,0,961,5109,379,759,180,197,0,A,45,5109,485619,39620,407151,38775,1900,149,38,2066,18767,18767,2104,18767,5,0
LA,14867,54299,0,1981,5109,379,759,552,197,0,A,512,5109,485619,39620,407151,38775,1900,149,1857,6984,69166,69166,8841,69166,35,0
MA,13739,62720,0,1667,1667,379,759,180,197,0,B,448,1667,485619,39620,407151,38775,1900,149,1337,3155,76459,76459,4492,76459,78,35
MD,4045,25572,0,961,1059,379,759,180,197,184,A,138,1059,485619,39620,407151,38775,131,7,436,844,29617,29617,1280,29617,16,123
ME,499,6088,0,961,92,379,759,180,197,158,A,10,92,485619,39620,407151,38775,1900,149,29,0,6587,6587,29,6587,0,6
MI,25785,47262,0,961,5109,379,759,180,197,56,B,1291,5109,72281,25019,47262,26290,1377,66,1327,3108,73047,73047,4435,73047,141,0
MN,1330,29155,0,115,223,57,90,180,197,440,A,30,223,30485,39620,407151,38775,1900,149,113,1065,30485,30485,1178,30485,1,21
MO,2722,27113,0,439,5109,379,759,180,197,0,A,39,5109,31954,3673,28257,38775,1900,149,355,2231,29835,29835,2586,29835,5,0
MP,8,13,10,961,5109,379,759,180,197,0,,1,5109,485619,39620,407151,38775,1900,149,0,0,31,21,0,21,0,0
MS,1738,18632,0,961,475,379,759,180,197,0,A,51,475,485619,39620,407151,38775,1900,149,100,13052,20370,20370,13152,20370,8,0
MT,299,6491,0,961,24,379,759,180,197,0,A,6,24,485619,39620,407151,38775,1900,149,13,174,6790,6790,187,6790,0,0
NC,2870,37856,0,270,5109,379,759,180,197,0,A,33,5109,485619,39620,407151,38775,1900,149,285,396,40726,40726,681,40726,2,0
ND,225,6988,0,19,32,379,759,180,197,74,B,3,32,485619,39620,407151,38775,1900,149,18,408,7213,7213,426,7213,0,1
NE,409,6378,8,961,5109,379,759,180,197,0,A,8,5109,485619,39620,407151,38775,1900,149,46,820,6795,6787,866,6787,0,0
NH,669,7701,101,961,92,379,759,180,197,147,B,9,92,485619,39620,407151,38775,1900,149,48,290,8471,8370,338,8370,0,6
NJ,41090,47942,0,6390,5109,379,759,1263,197,0,A,1003,5109,485619,39620,407151,38775,1900,149,3585,3281,89032,89032,6866,89032,86,0
NM,624,18512,0,45,5109,379,759,18,197,130,A,12,5109,485619,39620,407151,38775,1900,149,81,2227,19136,19136,2308,19136,1,0
NV,1953,15676,0,961,5109,379,759,180,197,0,A,79,5109,485619,39620,407151,38775,1900,149,117,681,17629,17629,798,17629,3,0
NY,130689,190122,0,16837,34377,4504,759,180,197,13366,A,4758,34377,485619,39620,407151,38775,1900,149,8658,9873,320811,320811,18531,320811,599,2084
OH,4450,43928,0,961,1214,379,371,180,197,0,B,142,1214,485619,39620,407151,4450,1900,149,407,4215,48378,48378,4622,48378,23,110
OK,1327,1422,0,161,340,143,759,180,197,522,B,51,340,485619,39620,407151,38775,1900,149,75,21,2749,2749,96,2749,5,10
OR,1132,20669,0,961,258,379,759,40,197,0,A,27,258,485619,39620,407151,38775,1900,149,64,1113,21801,21801,1177,21801,0,0
PA,12980,70874,0,961,1145,379,759,533,197,0,A,162,1145,485619,39620,407151,38775,1900,149,1470,4613,83854,83854,6083,83854,12,73
PR,513,3432,1000,961,5109,379,759,180,197,0,A,21,5109,485619,39620,407151,38775,1900,149,38,359,4945,3945,397,3945,1,0
RI,1356,8609,0,109,5109,37,759,26,197,35,B,27,5109,10654,1362,9292,1356,1900,149,206,1577,9965,9965,1783,9965,2,0
SC,2049,16927,0,961,241,379,759,180,197,0,B,44,241,485619,39620,407151,38775,1900,149,0,0,18976,18976,0,18976,0,0
SD,288,5732,0,961,23,379,759,180,197,91,A,4,23,485619,39620,407151,38775,1900,149,48,379,6020,6020,427,6020,2,1
TN,3802,43548,0,834,352,379,759,180,197,356,A,65,352,485619,39620,407151,38775,1900,149,169,1881,47350,47350,2050,47350,21,24
TX,7276,78081,0,1153,5109,379,759,180,197,38,A,140,5109,485619,39620,407151,7276,1900,149,464,13955,85357,85357,14419,85357,13,0
UT,1675,31719,0,961,138,379,759,180,197,0,A,13,138,485619,39620,407151,1675,1900,149,70,2432,33394,33394,2502,33394,5,14
VA,2878,21643,0,961,497,379,145,180,108,0,A,54,497,485619,39620,407151,38775,1900,149,241,609,24521,24521,850,24521,3,66
VI,43,222,20,961,5109,379,759,180,197,36,,1,5109,485619,39620,407151,38775,1900,149,1,16,285,265,17,265,0,0
VT,575,6161,0,28,45,379,759,180,197,15,A,23,45,485619,39620,407151,575,1900,149,32,331,6736,6736,363,6736,1,0
WA,10282,99566,0,638,5109,191,759,180,197,0,A,407,5109,485619,39620,407151,8971,1900,149,329,4807,109848,109848,5136,109848,21,0
WI,2866,26574,0,961,668,379,186,180,197,0,A,77,668,485619,39620,407151,2440,1900,149,223,1405,29440,29440,1628,29440,9,44
WV,345,9595,0,961,5109,379,759,180,197,0,B,4,5109,485619,39620,407151,38775,1900,149,21,1081,9940,9940,1102,9940,1,0
WY,210,3719,0,961,23,379,759,180,197,52,A,0,23,485619,39620,407151,201,1900,149,13,679,3929,3929,692,3929,0,0
AK,185,6099,0,961,20,379,759,180,197,0,A,6,20,6284,39620,407151,185,1900,149,14,230,6284,6284,244,6284,1,4
AL,1796,11282,0,282,231,379,759,180,197,0,B,45,231,485619,39620,407151,1796,1900,149,216,2009,13078,13078,2225,13078,2,19
AR,830,10412,0,67,130,379,759,27,39,97,A,16,130,485619,39620,407151,830,1900,149,87,785,11242,11242,872,11242,2,24
AS,0,3,2,961,5109,379,759,180,197,0,,0,5109,485619,39620,407151,0,1900,149,0,0,5,3,0,3,0,0
AZ,2269,25141,0,961,760,379,759,180,197,0,B,64,760,27410,39620,407151,38775,1900,149,250,0,27410,27410,250,27410,12,49
CA,13438,103095,15000,2398,5109,1040,759,180,197,0,B,319,5109,116533,39620,407151,38775,1900,149,1412,1421,131533,116533,2833,116533,43,0
CO,4565,19335,0,783,875,379,759,180,197,0,A,126,875,485619,39620,407151,38775,1900,149,392,1437,23900,23900,1829,23900,15,52
CT,5675,17595,0,1142,5109,379,759,180,197,0,A,189,5109,23270,39620,407151,38775,69,149,399,842,23270,23270,1241,23270,24,0
DC,998,5836,0,961,5109,379,759,180,197,258,A,22,5109,485619,39620,407151,38775,1900,149,96,300,6834,6834,396,6834,1,0
DE,673,6321,0,101,5109,379,759,180,197,71,C,19,5109,485619,39620,407151,38775,16,3,80,447,6994,6994,527,6994,2,0
FL,12151,101253,1129,961,1572,379,759,180,197,0,A,218,1572,485619,39620,407151,38775,1900,149,1040,10297,114533,113404,11337,113404,27,110
GA,6647,21185,0,961,1283,379,759,180,197,0,A,211,1283,27832,39620,407151,38775,1900,149,487,1051,27832,27832,1538,27832,10,44
GU,112,493,0,21,5109,2,759,180,197,23,,4,5109,485619,39620,407151,38775,1900,149,19,21,605,605,40,605,0,0
HI,351,12604,0,961,19,379,6,180,197,82,A,4,19,485619,39620,407151,38775,1900,149,32,645,12955,12955,677,12955,1,1
IA,868,9973,0,91,165,379,759,180,197,188,C,22,165,485619,39620,407151,868,1900,149,82,519,10841,10841,601,10841,8,12
ID,1077,9184,0,51,66,379,11,180,197,0,A,10,66,10261,39620,407151,38775,1900,149,64,1327,10261,10261,1391,10261,0,4
IL,11256,47727,0,961,5109,379,759,180,197,0,A,274,5109,485619,39620,407151,38775,1900,149,899,4503,58983,58983,5402,58983,31,0
IN,4411,18241,0,961,5109,379,759,180,197,0,B,127,5109,485619,39620,407151,38775,1900,149,458,2394,22652,22652,2852,22652,11,0
KS,747,7476,0,961,183,379,759,180,197,0,B,22,183,485619,39620,407151,38775,1900,149,49,596,8223,8223,645,8223,1,11
KY,917,15746,0,961,5109,379,759,180,197,0,A,40,5109,485619,39620,407151,38775,1900,149,86,1005,16663,16663,1091,16663,3,0
LA,13010,47315,0,1803,5109,379,759,561,197,0,A,477,5109,485619,39620,407151,38775,1900,149,514,1313,60325,60325,1827,60325,68,0
MA,12402,59565,0,1632,1632,379,759,180,197,0,B,370,1632,485619,39620,407151,38775,1900,149,765,2374,71967,71967,3139,71967,66,262
MD,3609,24728,0,961,936,379,759,180,197,159,A,122,936,485619,39620,407151,38775,115,7,484,2243,28337,28337,2727,28337,21,115
ME,470,6088,0,961,86,379,759,180,197,156,A,10,86,485619,39620,407151,38775,1900,149,14,0,6558,6558,14,6558,0,3
MI,24458,44154,0,961,5109,379,759,180,197,56,B,1150,5109,67055,22901,44154,25186,1225,58,877,2949,68612,68612,3826,68612,120,0
MN,1217,28090,0,106,202,48,77,180,197,422,A,29,202,29307,39620,407151,38775,1900,149,59,1403,29307,29307,1462,29307,5,22
MO,2367,24882,0,424,5109,379,759,180,197,0,C,34,5109,30851,3526,27303,38775,1900,149,76,2268,27249,27249,2344,27249,10,0
MP,8,13,10,961,5109,379,759,180,197,0,,1,5109,485619,39620,407151,38775,1900,149,0,0,31,21,0,21,0,0
MS,1638,5580,0,961,475,379,759,180,197,0,B,43,475,485619,39620,407151,38775,1900,149,183,447,7218,7218,630,7218,8,39
MT,286,6317,0,961,24,379,759,180,197,0,A,6,24,485619,39620,407151,38775,1900,149,21,405,6603,6603,426,6603,1,0
NC,2585,37460,0,261,5109,379,759,180,197,0,A,31,5109,485619,39620,407151,38775,1900,149,183,1089,40045,40045,1272,40045,7,0
ND,207,6580,0,20,31,379,759,180,197,63,B,3,31,485619,39620,407151,38775,1900,149,21,559,6787,6787,580,6787,0,1
NE,363,5558,12,961,5109,379,759,180,197,0,A,8,5109,485619,39620,407151,38775,1900,149,42,500,5933,5921,542,5921,2,0
NH,621,7411,93,961,86,379,759,180,197,146,B,9,86,485619,39620,407151,38775,1900,149,81,446,8125,8032,527,8032,2,6
NJ,37505,44661,0,4000,5109,379,759,180,197,0,A,917,5109,485619,39620,407151,38775,1900,149,3381,3429,82166,82166,6810,82166,71,0
NM,543,16285,0,37,5109,379,759,18,197,54,A,11,5109,485619,39620,407151,38775,1900,149,48,1148,16828,16828,1196,16828,1,0
NV,1836,14995,0,961,5109,379,759,180,197,0,A,76,5109,485619,39620,407151,38775,1900,149,94,574,16831,16831,668,16831,6,0
NY,122031,180249,0,16479,32293,4376,759,180,197,12187,A,4159,32293,485619,39620,407151,38775,1900,149,8327,10332,302280,302280,18659,302280,594,2822
OH,4043,39713,0,961,1104,379,346,180,197,0,B,119,1104,485619,39620,407151,4043,1900,149,304,1581,43756,43756,1885,43756,17,98
OK,1252,1401,0,961,330,379,759,180,197,0,B,46,330,485619,39620,407151,38775,1900,149,93,39,2653,2653,132,2653,4,14
OR,1068,19556,0,961,258,379,759,40,197,0,A,27,258,485619,39620,407151,38775,1900,149,69,3021,20624,20624,3090,20624,1,19
PA,11510,66261,0,961,1072,379,759,180,197,0,A,150,1072,485619,39620,407151,38775,1900,149,1493,6248,77771,77771,7741,77771,14,68
PR,475,3073,1039,961,5109,379,759,180,197,0,A,20,5109,485619,39620,407151,38775,1900,149,23,468,4587,3548,491,3548,2,0
RI,1150,7032,0,103,5109,33,759,6,197,35,B,25,5109,8729,1144,7585,1150,1900,149,182,1070,8182,8182,1252,8182,8,0
SC,2049,16927,0,961,241,379,759,180,197,0,B,44,241,485619,39620,407151,38775,1900,149,132,530,18976,18976,662,18976,4,0
SD,240,5353,0,961,22,379,759,180,197,84,A,2,22,485619,39620,407151,38775,1900,149,28,341,5593,5593,369,5593,0,3
TN,3633,41667,0,637,328,379,759,180,197,295,A,44,328,485619,39620,407151,38775,1900,149,312,3597,45300,45300,3909,45300,1,17
TX,6812,64126,0,827,5109,379,759,180,197,38,A,127,5109,485619,39620,407151,6812,1900,149,702,6485,70938,70938,7187,70938,22,0
UT,1605,29287,0,961,124,379,759,180,197,0,A,8,124,485619,39620,407151,1605,1900,149,177,2672,30892,30892,2849,30892,0,7
VA,2637,21034,0,961,431,379,145,180,108,0,A,51,431,485619,39620,407151,38775,1900,149,230,1889,23671,23671,2119,23671,-1,41
VI,42,206,18,961,5109,379,759,180,197,34,,1,5109,485619,39620,407151,38775,1900,149,2,22,266,248,24,248,1,0
VT,543,5830,0,29,45,379,759,180,197,15,A,22,45,485619,39620,407151,543,1900,149,31,588,6373,6373,619,6373,2,0
WA,9953,94759,0,581,5109,178,759,180,197,0,A,386,5109,485619,39620,407151,8576,1900,149,221,1731,104712,104712,1952,104712,21,0
WI,2643,25169,0,961,624,379,175,180,197,0,A,68,624,485619,39620,407151,2267,1900,149,167,1310,27812,27812,1477,27812,12,36
WV,324,8514,0,961,5109,379,759,180,197,0,B,3,5109,485619,39620,407151,38775,1900,149,42,1110,8838,8838,1152,8838,1,0
WY,197,3040,0,961,23,379,759,180,197,50,A,0,23,485619,39620,407151,187,1900,149,10,95,3237,3237,105,3237,0,0
AK,171,5869,0,961,16,379,759,180,197,0,A,5,16,6040,39620,407151,171,1900,149,14,10,6040,6040,24,6040,2,1
AL,1580,9273,0,238,212,379,759,180,197,0,B,43,212,485619,39620,407151,1580,1900,149,148,1086,10853,10853,1234,10853,8,212
AR,743,9627,0,72,106,379,759,23,39,79,A,14,106,485619,39620,407151,743,1900,149,39,632,10370,10370,671,10370,2,1
AS,0,3,2,961,5109,379,759,180,197,0,,0,5109,485619,39620,407151,0,1900,149,0,0,5,3,0,3,0,0
AZ,2019,25141,0,961,711,379,759,180,197,0,B,52,711,27160,39620,407151,38775,1900,149,250,2237,27160,27160,2487,27160,11,44
CA,12026,101674,13000,2300,5109,1008,759,180,197,0,B,276,5109,113700,39620,407151,38775,1900,149,1325,77075,126700,113700,78400,113700,39,0
CO,4173,17898,0,777,823,379,759,180,197,0,A,111,823,485619,39620,407151,38775,1900,149,445,1215,22071,22071,1660,22071,14,113
CT,5276,16753,0,1033,5109,379,759,180,197,0,A,165,5109,22029,39620,407151,38775,36,149,362,1652,22029,22029,2014,22029,34,0
DC,902,5536,0,961,5109,379,759,180,197,235,A,21,5109,485619,39620,407151,38775,1900,149,145,709,6438,6438,854,6438,6,0
DE,593,5874,0,95,5109,379,759,180,197,71,C,17,5109,485619,39620,407151,38775,16,1,143,879,6467,6467,1022,6467,0,0
FL,11111,90956,1281,961,1462,379,759,180,197,0,A,191,1462,485619,39620,407151,38775,1900,149,1526,8819,103348,102067,10345,102067,28,175
GA,6160,20134,0,961,1239,379,759,180,197,0,A,201,1239,26294,39620,407151,38775,1900,149,329,700,26294,26294,1029,26294,17,81
GU,93,472,0,20,5109,2,759,180,197,20,,4,5109,485619,39620,407151,38775,1900,149,9,13,565,565,22,565,0,0
HI,319,11959,0,961,18,379,6,180,197,78,A,3,18,485619,39620,407151,38775,1900,149,34,1753,12278,12278,1787,12278,1,3
IA,786,9454,0,85,153,379,759,180,197,188,C,14,153,485619,39620,407151,786,1900,149,87,700,10240,10240,787,10240,3,15
ID,1013,7857,0,53,62,379,8,180,197,0,A,10,62,8870,39620,407151,38775,1900,149,122,803,8870,8870,925,8870,1,6
IL,10357,43224,0,961,5109,379,759,180,197,0,A,243,5109,485619,39620,407151,38775,1900,149,1453,4080,53581,53581,5533,53581,33,0
IN,3953,15847,0,961,5109,379,759,180,197,0,B,116,5109,485619,39620,407151,38775,1900,149,516,1449,19800,19800,1965,19800,14,0
KS,698,6880,0,961,172,379,759,180,197,0,B,21,172,485619,39620,407151,38775,1900,149,78,426,7578,7578,504,7578,4,21
KY,831,14741,0,961,5109,379,759,180,197,0,A,37,5109,485619,39620,407151,38775,1900,149,61,2707,15572,15572,2768,15572,6,0
LA,12496,46002,0,1726,5109,379,759,571,197,0,A,409,5109,485619,39620,407151,38775,1900,149,2199,2654,58498,58498,4853,58498,39,0
MA,11637,57191,0,1370,1370,379,759,180,197,0,B,304,1370,485619,39620,407151,38775,1900,149,1334,4506,68828,68828,5840,68828,39,404
MD,3125,22485,0,961,821,379,759,180,197,159,A,101,821,485619,39620,407151,38775,94,7,367,1553,25610,25610,1920,25610,17,157
ME,456,6088,0,961,83,379,759,180,197,140,A,10,83,485619,39620,407151,38775,1900,149,24,0,6544,6544,24,6544,1,8
MI,23581,41205,0,961,5109,379,759,180,197,56,B,1030,5109,62205,21000,41205,23908,1092,45,1002,4145,64786,64786,5147,64786,112,0
MN,1158,26687,0,95,180,42,69,180,197,416,A,24,180,27845,39620,407151,38775,1900,149,39,1624,27845,27845,1663,27845,2,24
MO,2291,22614,0,413,5109,379,759,180,197,0,C,24,5109,28877,3277,25580,38775,1900,149,178,3257,24905,24905,3435,24905,5,0
MP,8,13,10,961,5109,379,759,180,197,0,,1,5109,485619,39620,407151,38775,1900,149,0,0,31,21,0,21,0,0
MS,1455,5133,0,961,436,379,759,180,197,0,B,35,436,485619,39620,407151,38775,1900,149,97,380,6588,6588,477,6588,6,16
MT,265,5912,0,961,24,379,759,180,197,0,A,5,24,485619,39620,407151,38775,1900,149,22,579,6177,6177,601,6177,0,0
NC,2402,36371,0,271,5109,379,759,180,197,0,A,24,5109,485619,39620,407151,38775,1900,149,309,6866,38773,38773,7175,38773,5,0
ND,186,6021,0,961,30,379,759,180,197,63,B,3,30,485619,39620,407151,38775,1900,149,13,396,6207,6207,409,6207,0,1
NE,321,5058,10,961,5109,379,759,180,197,0,A,6,5109,485619,39620,407151,38775,1900,149,42,571,5389,5379,613,5379,0,0
NH,540,6965,94,961,80,379,759,180,197,144,B,7,80,485619,39620,407151,38775,1900,149,61,390,7599,7505,451,7505,2,7
NJ,34124,41232,0,4000,5109,379,759,180,197,0,A,846,5109,485619,39620,407151,38775,1900,149,4229,3624,75356,75356,7853,75356,200,0
NM,495,15137,0,41,5109,379,759,18,197,26,A,10,5109,485619,39620,407151,38775,1900,149,92,762,15632,15632,854,15632,3,0
NV,1742,14421,0,961,5109,379,759,180,197,0,A,70,5109,485619,39620,407151,38775,1900,149,228,1403,16163,16163,1631,16163,11,0
NY,113704,169917,0,15905,29471,4126,759,180,197,10478,A,3565,29471,485619,39620,407151,38775,1900,149,10841,12260,283621,283621,23101,283621,630,3261
OH,3739,38132,0,961,1006,379,326,180,197,0,B,102,1006,485619,39620,407151,3739,1900,149,427,3069,41871,41871,3496,41871,11,111
OK,1159,1362,0,961,316,379,759,180,197,0,B,42,316,485619,39620,407151,38775,1900,149,171,47,2521,2521,218,2521,4,27
OR,999,16535,0,961,239,379,759,38,197,0,A,26,239,485619,39620,407151,38775,1900,149,100,0,17534,17534,100,17534,4,35
PA,10017,60013,0,961,1004,379,759,180,197,0,A,136,1004,485619,39620,407151,38775,1900,149,1597,6318,70030,70030,7915,70030,34,152
PR,452,2605,1129,961,5109,379,759,180,197,0,A,18,5109,485619,39620,407151,38775,1900,149,74,556,4186,3057,630,3057,3,0
RI,968,5962,0,93,5109,31,759,6,197,35,B,17,5109,7386,957,6429,968,1900,149,137,620,6930,6930,757,6930,3,0
SC,1917,16397,0,961,241,379,759,180,197,0,B,40,241,485619,39620,407151,38775,1900,149,363,10956,18314,18314,11319,18314,9,0
SD,212,5012,1,961,19,379,759,180,197,76,A,2,19,485619,39620,407151,38775,1900,149,25,419,5225,5224,444,5224,0,2
TN,3321,38070,0,601,311,379,759,180,197,416,A,43,311,485619,39620,407151,38775,1900,149,254,3298,41391,41391,3552,41391,6,18
TX,6110,57641,0,196,5109,379,759,180,197,38,A,105,5109,485619,39620,407151,6110,1900,149,780,7207,63751,63751,7987,63751,15,0
UT,1428,26615,0,961,117,379,759,180,197,0,A,8,117,485619,39620,407151,1428,1900,149,182,3613,28043,28043,3795,28043,1,11
VA,2407,19145,0,961,390,379,145,180,108,0,A,52,390,485619,39620,407151,38775,1900,149,395,2152,21552,21552,2547,21552,6,78
VI,40,184,42,961,5109,379,759,180,197,34,,1400,5109,485619,39620,407151,38775,1900,149,2,30,266,224,32,224,0,0
VT,512,5242,0,29,45,379,759,180,197,15,A,20,45,485619,39620,407151,512,1900,149,52,377,5754,5754,429,5754,3,0
WA,9732,93028,0,574,5109,174,759,180,197,0,A,365,5109,485619,39620,407151,8406,1900,149,247,2367,102760,102760,2614,102760,27,0
WI,2476,23859,0,961,588,379,759,180,197,0,A,56,588,485619,39620,407151,2112,1900,149,213,1482,26335,26335,1695,26335,19,101
WV,282,7404,0,961,5109,379,759,180,197,0,B,2,5109,485619,39620,407151,38775,1900,149,45,1274,7686,7686,1319,7686,0,-1
WY,187,2945,0,961,23,379,759,180,197,49,A,0,23,485619,39620,407151,165,1900,149,25,241,3132,3132,266,3132,0,2
AK,157,5859,0,961,15,379,759,180,197,0,A,3,15,6016,39620,407151,157,1900,149,14,980,6016,6016,994,6016,0,6
AL,1432,8187,0,238,5109,379,759,180,197,0,B,35,5109,485619,39620,407151,1432,1900,149,199,684,9619,9619,883,9619,3,0
AR,704,8995,0,71,105,379,759,26,39,60,A,12,105,485619,39620,407151,704,1900,149,61,1115,9699,9699,1176,9699,0,5
AS,0,3,2,961,5109,379,759,180,197,0,,0,5109,485619,39620,407151,0,1900,149,0,0,5,3,0,3,0,0
AZ,1769,22904,0,961,667,379,759,180,197,0,B,41,667,24673,39620,407151,38775,1900,149,171,1793,24673,24673,1964,24673,9,51
CA,10701,24599,59500,2188,5109,901,759,180,197,0,B,237,5109,35300,39620,407151,38775,1900,149,1510,790,94800,35300,2300,35300,34,0
CO,3728,16683,0,739,710,379,759,180,197,0,A,97,710,485619,39620,407151,38775,1900,149,386,1380,20411,20411,1766,20411,17,90
CT,4914,15101,0,909,5109,379,759,180,197,0,A,131,5109,20015,39620,407151,38775,34,149,1090,625,20015,20015,1715,20015,19,0
DC,757,4827,0,961,5109,379,759,180,197,206,A,15,5109,485619,39620,407151,38775,1900,149,104,410,5584,5584,514,5584,3,0
DE,450,4995,0,63,5109,379,759,180,197,71,C,17,5109,485619,39620,407151,38775,16,1,57,429,5445,5445,486,5445,1,0
FL,9585,82137,1225,961,1287,379,759,180,197,0,A,163,1287,485619,39620,407151,38775,1900,149,1575,12851,92947,91722,14426,91722,35,164
GA,5831,19434,0,961,1158,379,759,180,197,0,A,184,1158,25265,39620,407151,38775,1900,149,483,1825,25265,25265,2308,25265,21,102
GU,84,459,0,19,5109,2,759,180,197,14,,4,5109,485619,39620,407151,38775,1900,149,2,17,543,543,19,543,1,0
HI,285,10206,0,961,15,379,6,180,197,72,A,2,15,485619,39620,407151,38775,1900,149,27,0,10491,10491,27,10491,1,0
IA,699,8754,0,80,138,379,759,180,197,188,C,11,138,485619,39620,407151,699,1900,149,85,700,9453,9453,785,9453,0,18
ID,891,7054,0,45,56,379,7,180,197,0,A,9,56,7945,39620,407151,38775,1900,149,222,441,7945,7945,663,7945,0,7
IL,8904,39144,0,961,5109,379,759,180,197,0,A,210,5109,485619,39620,407151,38775,1900,149,1209,3183,48048,48048,4392,48048,53,0
IN,3437,14398,0,961,5109,379,759,180,197,0,B,102,5109,485619,39620,407151,38775,1900,149,398,1152,17835,17835,1550,17835,24,0
KS,620,6454,0,961,151,379,759,180,197,0,B,17,151,485619,39620,407151,38775,1900,149,68,395,7074,7074,463,7074,4,13
KY,770,12034,0,961,5109,379,759,180,197,0,A,31,5109,485619,39620,407151,38775,1900,149,90,4814,12804,12804,4904,12804,11,0
LA,10297,43348,0,1707,5109,379,759,535,197,0,A,370,5109,485619,39620,407151,38775,1900,149,1147,1412,53645,53645,2559,53645,60,0
MA,10303,52685,0,961,966,379,759,180,197,0,B,265,966,485619,39620,407151,38775,1900,149,1436,4918,62988,62988,6354,62988,36,153
MD,2758,20932,0,961,664,379,759,180,197,159,A,84,664,485619,39620,407151,38775,79,5,427,2042,23690,23690,2469,23690,20,82
ME,432,6088,0,961,75,379,759,180,197,113,A,9,75,485619,39620,407151,38775,1900,149,56,0,6520,6520,56,6520,2,7
MI,22579,37060,0,961,5109,379,759,180,197,56,B,918,5109,55096,18036,37060,23071,985,39,1203,3617,59639,59639,4820,59639,117,0
MN,1119,25063,0,86,156,40,40,180,197,0,A,22,156,26182,39620,407151,38775,1900,149,63,1283,26182,26182,1346,26182,4,18
MO,2113,19357,0,961,5109,379,759,180,197,0,C,19,5109,26710,2978,23715,38775,1900,149,279,1508,21470,21470,1787,21470,0,0
MP,8,13,10,961,5109,379,759,180,197,0,,1,5109,485619,39620,407151,38775,1900,149,0,0,31,21,0,21,0,0
MS,1358,4753,0,961,420,379,759,180,197,0,B,29,420,485619,39620,407151,38775,1900,149,181,0,6111,6111,181,6111,3,60
MT,243,5333,0,961,24,379,759,180,197,0,A,5,24,485619,39620,407151,38775,1900,149,16,240,5576,5576,256,5576,0,4
NC,2093,29505,0,184,5109,379,759,180,197,0,A,19,5109,485619,39620,407151,38775,1900,149,236,2683,31598,31598,2919,31598,3,0
ND,173,5625,0,961,29,379,759,180,197,55,B,3,29,485619,39620,407151,38775,1900,149,14,804,5798,5798,818,5798,0,1
NE,279,4487,11,961,5109,379,759,180,197,0,A,6,5109,485619,39620,407151,38775,1900,149,33,509,4777,4766,542,4766,1,0
NH,479,6575,114,961,73,379,759,180,197,101,B,5,73,485619,39620,407151,38775,1900,149,64,497,7168,7054,561,7054,1,15
NJ,29895,37608,0,3016,5109,379,759,180,197,0,A,646,5109,485619,39620,407151,38775,1900,149,4305,4088,67503,67503,8393,67503,109,0
NM,403,14375,0,31,5109,379,759,180,197,26,A,7,5109,485619,39620,407151,38775,1900,149,40,727,14778,14778,767,14778,1,0
NV,1514,13018,0,961,5109,379,759,180,197,0,A,59,5109,485619,39620,407151,38775,1900,149,56,430,14532,14532,486,14532,8,0
NY,102863,157657,0,14810,26210,3731,759,180,197,8886,A,2935,26210,485619,39620,407151,38775,1900,149,10482,11073,260520,260520,21555,260520,562,3424
OH,3312,35063,0,961,895,379,288,180,197,0,B,91,895,485619,39620,407151,3312,1900,149,410,3047,38375,38375,3457,38375,10,93
OK,988,1315,0,171,289,123,759,180,197,383,B,38,289,485619,39620,407151,38775,1900,149,109,50,2303,2303,159,2303,4,32
OR,899,16535,0,188,204,379,759,38,197,0,A,22,204,485619,39620,407151,38775,1900,149,73,1276,17434,17434,1349,17434,1,16
PA,8420,53695,0,961,852,379,759,180,197,0,A,102,852,485619,39620,407151,38775,1900,149,1404,5997,62115,62115,7401,62115,12,122
PR,378,2049,1055,961,5109,379,759,180,197,0,A,15,5109,485619,39620,407151,38775,1900,149,62,445,3482,2427,507,2427,3,0
RI,831,5342,0,77,5109,14,759,6,197,35,B,14,5109,6583,814,5769,831,1900,149,101,717,6173,6173,818,6173,2,0
SC,1554,5441,0,961,241,379,759,180,197,0,B,31,241,485619,39620,407151,38775,1900,149,0,0,6995,6995,0,6995,0,0
SD,187,4593,3,961,17,379,759,180,197,69,A,2,17,485619,39620,407151,38775,1900,149,22,376,4783,4780,398,4780,0,0
TN,3067,34772,0,625,293,379,759,180,197,248,A,37,293,485619,39620,407151,38775,1900,149,222,3006,37839,37839,3228,37839,5,30
TX,5330,50434,0,196,5109,379,759,180,197,38,A,90,5109,485619,39620,407151,5330,1900,149,661,4424,55764,55764,5085,55764,20,0
UT,1246,23002,0,961,106,379,759,180,197,0,A,7,106,485619,39620,407151,1246,1900,149,172,2847,24248,24248,3019,24248,0,6
VA,2012,16993,0,961,312,379,145,180,108,0,A,46,312,485619,39620,407151,38775,1900,149,306,1110,19005,19005,1416,19005,5,7
VI,38,154,56,961,5109,379,759,180,197,29,,1400,5109,485619,39620,407151,38775,1900,149,5,5,248,192,10,192,0,0
VT,460,4865,0,29,45,379,759,180,197,15,A,17,45,485619,39620,407151,460,1900,149,70,481,5325,5325,551,5325,0,0
WA,9485,90661,0,961,5109,379,759,180,197,0,A,338,5109,485619,39620,407151,8198,1900,149,284,4570,100146,100146,4854,100146,28,0
WI,2263,22377,0,961,487,379,759,180,197,0,A,37,487,485619,39620,407151,1912,1900,149,223,2060,24640,24640,2283,24640,6,26
WV,237,6130,0,961,1,379,759,180,197,0,B,2,1,485619,39620,407151,38775,1900,149,20,854,6367,6367,874,6367,0,0
WY,162,2704,0,961,21,379,759,180,197,37,A,0,21,485619,39620,407151,153,1900,149,12,265,2866,2866,277,2866,0,2
AK,143,4879,0,961,9,379,759,180,197,0,A,3,9,5022,39620,407151,143,1900,149,10,409,5022,5022,419,5022,0,0
AL,1233,7503,0,226,5109,379,759,180,197,0,B,32,5109,485619,39620,407151,1233,1900,149,156,806,8736,8736,962,8736,6,0
AR,643,7880,0,66,100,379,759,23,32,47,A,12,100,485619,39620,407151,643,1900,149,59,526,8523,8523,585,8523,2,10
AS,0,3,2,961,5109,379,759,180,197,0,,0,5109,485619,39620,407151,0,1900,149,0,0,5,3,0,3,0,0
AZ,1598,21111,0,961,616,379,759,180,197,0,B,32,616,22709,39620,407151,38775,1900,149,185,1466,22709,22709,1651,22709,3,34
CA,9191,23809,59500,1922,5109,816,759,180,197,0,B,203,5109,33000,39620,407151,38775,1900,149,1036,2037,92500,33000,3073,33000,32,0
CO,3342,15303,0,698,620,379,759,180,197,0,A,80,620,485619,39620,407151,38775,1900,149,376,1420,18645,18645,1796,18645,11,111
CT,3824,14476,0,827,5109,379,759,180,197,0,A,112,5109,18300,39620,407151,38775,27,149,267,1433,18300,18300,1700,18300,27,0
DC,653,4417,0,961,5109,379,759,180,197,173,A,12,5109,485619,39620,407151,38775,1900,149,67,1155,5070,5070,1222,5070,1,0
DE,393,4566,0,56,5109,379,759,180,197,49,C,16,5109,485619,39620,407151,38775,15,1,25,551,4959,4959,576,4959,3,0
FL,8010,69286,1285,961,1123,379,759,180,197,0,A,128,1123,485619,39620,407151,38775,1900,149,1055,9757,78581,77296,10812,77296,41,174
GA,5348,17609,0,961,1056,379,759,180,197,0,A,163,1056,22957,39620,407151,38775,1900,149,710,1921,22957,22957,2631,22957,24,104
GU,82,442,0,19,5109,2,759,180,197,12,,3,5109,485619,39620,407151,38775,1900,149,5,36,524,524,41,524,0,0
HI,258,10206,0,961,15,379,6,180,197,69,A,1,15,485619,39620,407151,38775,1900,149,50,1485,10464,10464,1535,10464,0,2
IA,614,8054,0,74,120,379,759,180,197,46,C,11,120,485619,39620,407151,614,1900,149,65,750,8668,8668,815,8668,2,21
ID,669,6613,0,49,49,379,7,180,197,0,A,9,49,7282,39620,407151,38775,1900,149,144,537,7282,7282,681,7282,0,3
IL,7695,35961,0,961,5109,379,759,180,197,0,A,157,5109,485619,39620,407151,38775,1900,149,715,2557,43656,43656,3272,43656,16,0
IN,3039,13246,0,961,5109,379,759,180,197,0,B,78,5109,485619,39620,407151,38775,1900,149,474,1436,16285,16285,1910,16285,13,0
KS,552,6059,0,961,138,379,759,180,197,0,B,13,138,485619,39620,407151,38775,1900,149,70,648,6611,6611,718,6611,3,24
KY,680,7220,0,961,5109,379,759,180,197,0,A,20,5109,485619,39620,407151,38775,1900,149,89,255,7900,7900,344,7900,3,0
LA,9150,41936,0,1639,5109,379,759,507,197,0,A,310,5109,485619,39620,407151,38775,1900,149,2726,2584,51086,51086,5310,51086,37,0
MA,8867,47767,0,961,813,379,759,180,197,0,B,229,813,485619,39620,407151,38775,1900,149,1228,3642,56634,56634,4870,56634,42,131
MD,2331,18890,0,961,582,379,759,180,197,81,A,64,582,485619,39620,407151,38775,60,4,346,1657,21221,21221,2003,21221,12,60
ME,376,6088,0,961,68,379,759,180,197,94,A,7,68,485619,39620,407151,38775,1900,149,32,0,6464,6464,32,6464,0,5
MI,21376,33443,0,961,5109,379,759,180,197,0,B,801,5109,49095,15652,33443,22102,879,36,1130,3492,54819,54819,4622,54819,125,0
MN,1056,23780,0,75,138,38,38,180,197,0,A,18,138,24836,39620,407151,38775,1900,149,83,1900,24836,24836,1983,24836,1,16
MO,1834,17849,0,961,5109,379,759,180,197,0,C,19,5109,24415,2700,21700,38775,1900,149,253,2003,19683,19683,2256,19683,1,0
MP,8,13,12,961,5109,379,759,180,197,0,,1,5109,485619,39620,407151,38775,1900,149,2,13,33,21,15,21,1,0
MS,1177,4753,0,961,360,379,759,180,197,0,B,26,360,485619,39620,407151,38775,1900,149,104,1041,5930,5930,1145,5930,4,28
MT,227,5093,0,961,20,379,759,180,197,0,A,5,20,485619,39620,407151,38775,1900,149,19,383,5320,5320,402,5320,0,3
NC,1857,26822,0,184,5109,379,759,180,197,0,A,16,5109,485619,39620,407151,38775,1900,149,273,2163,28679,28679,2436,28679,6,0
ND,159,4821,0,961,28,379,759,180,197,43,B,3,28,485619,39620,407151,38775,1900,149,17,470,4980,4980,487,4980,0,5
NE,246,3978,11,961,5109,379,759,180,197,0,A,5,5109,485619,39620,407151,38775,1900,149,36,503,4235,4224,539,4224,1,0
NH,415,6078,126,961,58,379,759,180,197,91,B,4,58,485619,39620,407151,38775,1900,149,0,93,6619,6493,93,6493,0,2
NJ,25590,33520,0,2000,5109,379,759,180,197,0,A,537,5109,485619,39620,407151,38775,1900,149,3335,3133,59110,59110,6468,59110,182,0
NM,363,13648,0,31,5109,379,759,180,197,26,A,6,5109,485619,39620,407151,38775,1900,149,48,723,14011,14011,771,14011,1,0
NV,1458,12588,0,961,5109,379,759,180,197,0,A,51,5109,485619,39620,407151,38775,1900,149,179,1069,14046,14046,1248,14046,6,0
NY,92381,146584,0,13383,22786,3396,759,180,197,7434,A,2373,22786,485619,39620,407151,38775,1900,149,8669,9416,238965,238965,18085,238965,432,2857
OH,2902,32016,0,961,802,379,260,180,197,0,B,81,802,485619,39620,407151,2902,1900,149,355,5024,34918,34918,5379,34918,16,123
OK,879,1265,0,182,257,144,759,180,197,0,B,34,257,485619,39620,407151,38775,1900,149,160,17,2144,2144,177,2144,4,38
OR,826,15259,0,134,188,379,759,38,197,0,A,21,188,485619,39620,407151,38775,1900,149,90,2123,16085,16085,2213,16085,3,34
PA,7016,47698,0,961,730,379,759,180,197,0,A,90,730,485619,39620,407151,38775,1900,149,1211,5271,54714,54714,6482,54714,16,110
PR,316,1604,1119,961,5109,379,759,180,197,0,A,12,5109,485619,39620,407151,38775,1900,149,30,195,3039,1920,225,1920,1,0
RI,730,4625,0,72,5109,14,759,6,197,35,B,12,5109,5700,706,4994,730,1900,149,62,436,5355,5355,498,5355,2,0
SC,1554,5441,0,961,241,379,759,180,197,0,B,31,241,485619,39620,407151,38775,1900,149,261,408,6995,6995,669,6995,5,139
SD,165,4217,0,961,17,379,759,180,197,57,A,2,17,485619,39620,407151,38775,1900,149,36,314,4382,4382,350,4382,0,5
TN,2845,31766,0,656,263,379,759,180,197,220,A,32,263,485619,39620,407151,38775,1900,149,162,1997,34611,34611,2159,34611,8,63
TX,4669,46010,0,196,5109,379,759,180,197,38,A,70,5109,485619,39620,407151,4669,1900,149,672,2150,50679,50679,2822,50679,12,0
UT,1074,20155,0,961,100,379,759,180,197,0,A,7,100,485619,39620,407151,1074,1900,149,62,0,21229,21229,62,21229,0,9
VA,1706,15883,0,246,305,379,145,180,108,0,A,41,305,485619,39620,407151,38775,1900,149,222,2023,17589,17589,2245,17589,7,0
VI,33,149,42,961,5109,379,759,180,197,25,,1400,5109,485619,39620,407151,38775,1900,149,3,23,224,182,26,182,0,0
VT,390,4384,0,29,45,379,759,180,197,15,A,17,45,485619,39620,407151,390,1900,149,31,222,4774,4774,253,4774,1,0
WA,9201,86091,0,961,5109,379,759,180,197,0,A,310,5109,485619,39620,407151,7784,1900,149,332,4575,95292,95292,4907,95292,28,0
WI,2040,20317,0,961,461,379,759,180,197,0,A,31,461,485619,39620,407151,1730,1900,149,219,1498,22357,22357,1717,22357,7,63
WV,217,5276,0,961,1,379,759,180,197,0,B,2,1,485619,39620,407151,38775,1900,149,26,892,5493,5493,918,5493,1,0
WY,150,2439,0,961,19,379,759,180,197,31,A,0,19,485619,39620,407151,137,1900,149,20,221,2589,2589,241,2589,0,1
AK,133,4470,0,961,9,379,759,180,197,0,A,3,9,4603,39620,407151,133,1900,149,14,876,4603,4603,890,4603,0,2
AL,1077,6697,0,258,5109,379,759,180,197,0,B,26,5109,485619,39620,407151,1077,1900,149,96,399,7774,7774,495,7774,13,0
AR,584,7354,0,56,90,379,759,25,32,42,A,10,90,485619,39620,407151,584,1900,149,61,1395,7938,7938,1456,7938,2,90
AS,0,3,2,961,5109,379,759,180,197,0,,0,5109,485619,39620,407151,0,1900,149,0,0,5,3,0,3,0,0
AZ,1413,19645,0,961,582,379,759,180,197,0,B,29,582,21058,39620,407151,38775,1900,149,124,1563,21058,21058,1687,21058,5,48
CA,8155,21772,57400,1855,5109,774,759,180,197,0,B,171,5109,29927,39620,407151,38775,1900,149,673,0,87327,29927,673,29927,18,0
CO,2966,13883,0,574,509,379,759,180,197,0,A,69,509,485619,39620,407151,38775,1900,149,339,1146,16849,16849,1485,16849,18,95
CT,3557,13043,0,766,5109,379,759,180,197,0,A,85,5109,16600,39620,407151,38775,27,149,429,14,16600,16600,443,16600,16,0
DC,586,3262,2,961,5109,379,759,180,197,142,A,11,5109,485619,39620,407151,38775,1900,149,91,0,3850,3848,91,3848,2,0
DE,368,4015,0,51,5109,379,759,180,197,49,C,13,5109,485619,39620,407151,38775,13,0,49,319,4383,4383,368,4383,1,0
FL,6955,59529,1235,961,949,379,759,180,197,0,A,87,949,485619,39620,407151,38775,1900,149,617,5244,67719,66484,5861,66484,10,126
GA,4638,15688,0,961,952,379,759,180,197,0,A,139,952,20326,39620,407151,38775,1900,149,709,3436,20326,20326,4145,20326,28,119
GU,77,406,0,19,5109,2,759,180,197,9,,3,5109,485619,39620,407151,38775,1900,149,8,35,483,483,43,483,1,0
HI,208,8721,0,961,13,379,6,180,197,58,A,1,13,485619,39620,407151,38775,1900,149,4,250,8929,8929,254,8929,1,1
IA,549,7304,0,63,99,379,759,180,197,118,C,9,99,485619,39620,407151,549,1900,149,52,416,7853,7853,468,7853,2,5
ID,525,6076,0,49,46,379,7,180,197,0,A,9,46,6601,39620,407151,38775,1900,149,110,779,6601,6601,889,6601,2,1
IL,6980,33404,0,961,5109,379,759,180,197,0,A,141,5109,485619,39620,407151,38775,1900,149,986,4173,40384,40384,5159,40384,42,0
IN,2565,11810,0,961,5109,379,759,180,197,0,B,65,5109,485619,39620,407151,38775,1900,149,406,596,14375,14375,1002,14375,16,0
KS,482,5411,0,961,114,379,759,180,197,0,B,10,114,485619,39620,407151,38775,1900,149,54,415,5893,5893,469,5893,1,35
KY,591,6965,0,961,5109,379,759,180,197,0,A,17,5109,485619,39620,407151,38775,1900,149,111,635,7556,7556,746,7556,6,0
LA,6424,39352,0,1498,5109,379,759,490,197,0,A,273,5109,485619,39620,407151,38775,1900,149,1187,5622,45776,45776,6809,45776,34,0
MA,7639,44125,0,961,682,379,759,180,197,0,B,187,682,485619,39620,407151,38775,1900,149,1118,3685,51764,51764,4803,51764,34,120
MD,1985,17233,0,961,522,379,759,180,197,0,A,52,522,485619,39620,407151,38775,50,2,325,2365,19218,19218,2690,19218,9,93
ME,344,6088,0,961,63,379,759,180,197,80,A,7,63,485619,39620,407151,38775,1900,149,41,0,6432,6432,41,6432,2,6
MI,20246,29951,0,961,5109,379,759,180,197,0,B,676,5109,43188,13237,29951,20937,765,35,1592,3617,50197,50197,5209,50197,125,0
MN,973,21880,0,54,122,27,27,180,197,0,A,17,122,22853,39620,407151,38775,1900,149,57,945,22853,22853,1002,22853,5,10
MO,1581,15846,0,961,5109,379,759,180,197,0,C,18,5109,21956,2402,19540,38775,1900,149,254,1232,17427,17427,1486,17427,4,0
MP,6,,0,961,5109,379,759,180,197,0,,1400,5109,485619,39620,407151,38775,1900,149,4,0,6,6,4,6,0,0
MS,1073,3712,0,961,332,379,759,180,197,0,B,22,332,485619,39620,407151,38775,1900,149,136,175,4785,4785,311,4785,2,121
MT,208,4710,0,961,17,379,759,180,197,0,A,5,17,485619,39620,407151,38775,1900,149,24,476,4918,4918,500,4918,1,3
NC,1584,24659,0,204,5109,379,759,180,197,0,A,10,5109,485619,39620,407151,38775,1900,149,86,3051,26243,26243,3137,26243,2,0
ND,142,4351,0,961,23,379,759,180,197,34,B,3,23,485619,39620,407151,38775,1900,149,16,220,4493,4493,236,4493,0,2
NE,210,3475,8,961,5109,379,759,180,197,0,A,4,5109,485619,39620,407151,38775,1900,149,38,544,3693,3685,582,3685,1,0
NH,415,5985,97,961,56,379,759,180,197,56,B,4,56,485619,39620,407151,38775,1900,149,101,572,6497,6400,673,6400,1,11
NJ,22255,30387,0,2000,5109,379,759,180,197,0,A,355,5109,485619,39620,407151,38775,1900,149,3559,3310,52642,52642,6869,52642,88,0
NM,315,12925,0,24,5109,379,759,180,197,26,A,5,5109,485619,39620,407151,38775,1900,149,34,679,13240,13240,713,13240,1,0
NV,1279,11519,0,961,5109,379,759,180,197,0,A,45,5109,485619,39620,407151,38775,1900,149,166,838,12798,12798,1004,12798,8,0
NY,83712,137168,0,12226,19929,3022,759,180,197,6142,A,1941,19929,485619,39620,407151,38775,1900,149,7917,7777,220880,220880,15694,220880,391,2844
OH,2547,26992,0,961,679,379,222,180,197,0,B,65,679,485619,39620,407151,2547,1900,149,348,0,29539,29539,348,29539,10,94
OK,719,1248,0,174,219,98,759,180,197,0,B,30,219,485619,39620,407151,38775,1900,149,154,19,1967,1967,173,1967,7,42
OR,736,13136,0,132,154,379,759,40,197,0,A,18,154,485619,39620,407151,38775,1900,149,46,0,13872,13872,46,13872,0,0
PA,5805,42427,0,961,620,379,759,180,197,0,A,74,620,485619,39620,407151,38775,1900,149,962,4782,48232,48232,5744,48232,11,106
PR,286,1409,897,961,5109,379,759,180,197,0,A,11,5109,485619,39620,407151,38775,1900,149,47,214,2592,1695,261,1695,3,0
RI,668,4189,0,60,5109,14,759,6,197,35,B,10,5109,5171,654,4517,668,1900,149,100,645,4857,4857,745,4857,2,0
SC,1293,5033,0,961,102,379,759,180,197,0,B,26,102,485619,39620,407151,38775,1900,149,210,417,6326,6326,627,6326,4,0
SD,129,3903,0,961,12,379,759,180,197,51,A,2,12,485619,39620,407151,38775,1900,149,21,294,4032,4032,315,4032,1,0
TN,2683,29769,0,486,200,379,759,180,197,137,A,24,200,485619,39620,407151,38775,1900,149,444,4648,32452,32452,5092,32452,1,25
TX,3997,43860,0,196,5109,379,759,180,197,38,A,58,5109,485619,39620,407151,3997,1900,149,731,4134,47857,47857,4865,47857,17,0
UT,1012,20155,0,961,91,379,759,180,197,0,A,7,91,485619,39620,407151,1012,1900,149,125,2529,21167,21167,2654,21167,2,18
VA,1484,13860,0,961,305,379,145,180,108,0,A,34,305,485619,39620,407151,38775,1900,149,234,1709,15344,15344,1943,15344,7,140
VI,30,126,24,961,5109,379,759,180,197,21,,1400,5109,485619,39620,407151,38775,1900,149,0,0,180,156,0,156,0,0
VT,359,4162,0,30,45,379,759,180,197,15,A,16,45,485619,39620,407151,359,1900,149,39,213,4521,4521,252,4521,3,9
WA,8869,81516,0,961,5109,379,759,180,197,0,A,282,5109,485619,39620,407151,7381,1900,149,438,4279,90385,90385,4717,90385,20,0
WI,1821,18819,0,961,398,379,759,180,197,0,A,24,398,485619,39620,407151,1550,1900,149,236,1444,20640,20640,1680,20640,8,61
WV,191,4384,0,961,1,379,759,180,197,0,B,1,1,485619,39620,407151,38775,1900,149,29,403,4575,4575,432,4575,0,0
WY,130,2218,0,961,18,379,759,180,197,31,A,0,18,485619,39620,407151,109,1900,149,21,219,2348,2348,240,2348,0,1
AK,119,3594,0,961,7,379,759,180,197,0,A,3,7,3713,39620,407151,119,1900,149,5,54,3713,3713,59,3713,0,0
AL,981,6298,0,172,5109,379,759,180,197,0,B,13,5109,485619,39620,407151,981,1900,149,122,604,7279,7279,726,7279,7,0
AR,523,5959,0,64,5109,379,759,23,197,35,A,8,5109,485619,39620,407151,523,1900,149,50,697,6482,6482,747,6482,1,0
AS,0,3,2,961,5109,379,759,180,197,0,,0,5109,485619,39620,407151,0,1900,149,0,3,5,3,3,3,0,0
AZ,1289,18082,0,961,534,379,759,180,197,0,B,24,534,19371,39620,407151,38775,1900,149,132,2480,19371,19371,2612,19371,4,56
CA,7482,21772,57400,1617,5109,657,759,180,197,0,B,153,5109,29254,39620,407151,38775,1900,149,1035,1223,86654,29254,2258,29254,20,0
CO,2627,12737,0,503,414,379,759,180,197,0,A,51,414,485619,39620,407151,38775,1900,149,0,0,15364,15364,0,15364,0,0
CT,3128,13029,0,608,5109,379,759,180,197,0,A,69,5109,15600,39620,407151,38775,21,149,557,1000,16157,16157,1557,16157,33,0
DC,495,3262,2,961,5109,379,759,180,197,121,A,9,5109,485619,39620,407151,38775,1900,149,94,580,3759,3757,674,3757,0,0
DE,319,3696,0,57,5109,379,759,180,197,22,C,12,5109,485619,39620,407151,38775,12,0,55,1480,4015,4015,1535,4015,1,0
FL,6338,54285,1163,961,823,379,759,180,197,0,A,77,823,485619,39620,407151,38775,1900,149,865,6060,61786,60623,6925,60623,14,171
GA,3929,12252,0,961,833,379,759,180,197,0,A,111,833,16181,39620,407151,38775,1900,149,1120,2337,16181,16181,3457,16181,24,126
GU,69,371,0,19,5109,2,759,180,197,7,,2,5109,485619,39620,407151,38775,1900,149,11,19,440,440,30,440,1,0
HI,204,8471,0,961,12,379,6,180,197,49,A,1400,12,485619,39620,407151,38775,1900,149,29,646,8675,8675,675,8675,0,0
IA,497,6888,0,61,94,379,759,180,197,33,C,7,94,485619,39620,407151,497,1900,149,73,726,7385,7385,799,7385,1,20
ID,415,5297,0,45,45,379,6,180,197,0,A,7,45,5712,39620,407151,38775,1900,149,105,901,5712,5712,1006,5712,1,6
IL,5994,29231,0,961,5109,379,759,180,197,0,A,99,5109,485619,39620,407151,38775,1900,149,937,3842,35225,35225,4779,35225,26,0
IN,2159,11214,0,961,5109,379,759,180,197,0,B,49,5109,485619,39620,407151,38775,1900,149,373,1342,13373,13373,1715,13373,14,0
KS,428,4996,0,961,79,379,759,180,197,0,B,9,79,485619,39620,407151,38775,1900,149,60,442,5424,5424,502,5424,1,13
KY,480,6330,0,961,5109,379,759,180,197,0,A,11,5109,485619,39620,407151,38775,1900,149,41,751,6810,6810,792,6810,2,0
LA,5237,33730,0,1355,5109,379,759,438,197,0,A,239,5109,485619,39620,407151,38775,1900,149,1212,3722,38967,38967,4934,38967,54,0
MA,6521,40440,0,961,562,379,759,180,197,0,B,153,562,485619,39620,407151,38775,1900,149,868,3274,46961,46961,4142,46961,29,109
MD,1660,14868,0,961,429,379,759,180,197,0,A,43,429,485619,39620,407151,38775,42,1,247,1552,16528,16528,1799,16528,8,76
ME,303,6088,0,961,57,379,759,180,197,68,A,5,57,485619,39620,407151,38775,1900,149,28,2694,6391,6391,2722,6391,2,8
MI,18654,26334,0,961,5109,379,759,180,197,0,B,551,5109,37055,10721,26334,19844,641,33,1291,3071,44988,44988,4362,44988,114,0
MN,916,20935,0,56,112,26,26,180,197,0,A,12,112,21851,39620,407151,38775,1900,149,93,1423,21851,21851,1516,21851,2,20
MO,1327,14614,0,961,5109,379,759,180,197,0,C,14,5109,19189,2037,17138,38775,1900,149,296,1410,15941,15941,1706,15941,1,0
MP,2,,0,961,5109,379,759,180,197,0,,1400,5109,485619,39620,407151,38775,1900,149,0,0,2,2,0,2,0,0
MS,937,3537,0,961,211,379,759,180,197,0,B,20,211,485619,39620,407151,38775,1900,149,90,548,4474,4474,638,4474,4,16
MT,184,4234,0,961,14,379,759,180,197,0,A,4,14,485619,39620,407151,38775,1900,149,13,91,4418,4418,104,4418,0,4
NC,1498,21608,0,157,5109,379,759,180,197,0,A,8,5109,485619,39620,407151,38775,1900,149,191,2051,23106,23106,2242,23106,2,0
ND,126,4131,0,961,21,379,759,180,197,30,B,3,21,485619,39620,407151,38775,1900,149,17,403,4257,4257,420,4257,1,2
NE,172,2931,8,961,5109,379,759,180,197,0,A,3,5109,485619,39620,407151,38775,1900,149,27,347,3111,3103,374,3103,1,0
NH,314,5413,65,961,45,379,759,180,197,0,B,3,45,485619,39620,407151,38775,1900,149,0,27,5792,5727,27,5727,0,0
NJ,18696,27077,0,2000,5109,379,759,180,197,0,A,267,5109,485619,39620,407151,38775,1900,149,2060,1853,45773,45773,3913,45773,69,0
NM,281,12246,0,22,5109,379,759,180,197,26,A,4,5109,485619,39620,407151,38775,1900,149,44,1304,12527,12527,1348,12527,2,0
NV,1113,10681,0,961,5109,379,759,180,197,0,A,37,5109,485619,39620,407151,38775,1900,149,105,474,11794,11794,579,11794,5,0
NY,75795,129391,0,10929,17085,2710,759,180,197,4975,A,1550,17085,485619,39620,407151,38775,1900,149,9298,9420,205186,205186,18718,205186,332,2507
OH,2199,26992,0,961,585,379,198,180,197,0,B,55,585,485619,39620,407151,2199,1900,149,266,1650,29191,29191,1916,29191,16,110
OK,565,1229,0,961,177,83,759,180,197,0,B,23,177,485619,39620,407151,38775,1900,149,84,22,1794,1794,106,1794,6,24
OR,690,13136,0,132,154,379,759,40,197,0,A,18,154,485619,39620,407151,38775,1900,149,84,859,13826,13826,943,13826,2,14
PA,4843,37645,0,961,514,379,759,180,197,0,A,63,514,485619,39620,407151,38775,1900,149,756,3868,42488,42488,4624,42488,14,128
PR,239,1195,854,961,5109,379,759,180,197,0,A,8,5109,485619,39620,407151,38775,1900,149,65,264,2288,1434,329,1434,2,0
RI,568,3544,0,59,5109,9,759,6,197,35,B,8,5109,4373,555,3818,568,1900,149,73,298,4112,4112,371,4112,4,0
SC,1083,4616,0,961,102,379,759,180,197,0,B,22,102,485619,39620,407151,38775,1900,149,158,456,5699,5699,614,5699,4,0
SD,108,3609,0,961,12,379,759,180,197,44,A,1,12,485619,39620,407151,38775,1900,149,7,131,3717,3717,138,3717,0,12
TN,2239,25121,0,9,175,379,759,180,197,121,A,23,175,485619,39620,407151,38775,1900,149,405,3651,27360,27360,4056,27360,10,27
TX,3266,39726,0,196,5109,379,759,180,197,38,A,41,5109,485619,39620,407151,3266,1900,149,389,6723,42992,42992,7112,42992,7,0
UT,887,17626,0,961,73,379,759,180,197,0,A,5,73,485619,39620,407151,887,1900,149,81,2429,18513,18513,2510,18513,1,73
VA,1250,12151,0,961,165,379,759,180,197,0,A,27,165,485619,39620,407151,38775,1900,149,230,1133,13401,13401,1363,13401,2,29
VI,30,126,24,961,5109,379,759,180,197,21,,1400,5109,485619,39620,407151,38775,1900,149,0,0,180,156,0,156,0,0
VT,320,3949,0,21,36,379,759,180,197,15,A,13,36,485619,39620,407151,320,1900,149,27,231,4269,4269,258,4269,1,18
WA,8431,77237,0,961,5109,379,759,180,197,0,A,262,5109,485619,39620,407151,6933,1900,149,311,4395,85668,85668,4706,85668,14,0
WI,1585,17375,0,961,337,379,759,180,197,0,A,16,337,485619,39620,407151,1351,1900,149,163,1519,18960,18960,1682,18960,2,337
WV,162,3981,0,961,1,379,759,180,197,0,B,1,1,485619,39620,407151,38775,1900,149,36,997,4143,4143,1033,4143,0,0
WY,109,1999,0,961,17,379,759,180,197,26,A,0,17,485619,39620,407151,96,1900,149,15,159,2108,2108,174,2108,0,0
AK,114,3540,0,961,7,379,759,180,197,0,A,3,7,3654,39620,407151,114,1900,149,12,308,3654,3654,320,3654,1,1
AL,859,5694,0,156,5109,379,759,180,197,0,B,6,5109,485619,39620,407151,859,1900,149,53,1510,6553,6553,1563,6553,2,0
AR,473,5262,0,62,5109,379,759,21,197,29,A,7,5109,485619,39620,407151,473,1900,149,47,2235,5735,5735,2282,5735,1,0
AS,,,0,961,5109,379,759,180,197,0,,0,5109,485619,39620,407151,0,1900,149,0,0,0,0,0,0,0,0
AZ,1157,15602,0,961,478,379,759,180,197,0,B,20,478,16759,39620,407151,38775,1900,149,238,2649,16759,16759,2887,16759,3,51
CA,6447,20549,64400,1432,5109,597,759,180,197,0,B,133,5109,26996,39620,407151,38775,1900,149,739,0,91396,26996,739,26996,10,0
CO,2627,12737,0,358,414,379,759,180,197,0,A,51,414,485619,39620,407151,38775,1900,149,566,1522,15364,15364,2088,15364,7,140
CT,2571,12029,0,517,5109,379,759,180,197,0,A,36,5109,14600,39620,407151,38775,19,149,578,2122,14600,14600,2700,14600,2,0
DC,401,2682,2,961,5109,379,759,180,197,106,A,9,5109,485619,39620,407151,38775,1900,149,59,213,3085,3083,272,3083,4,0
DE,264,2216,0,45,5109,379,759,180,197,9,C,11,5109,485619,39620,407151,38775,11,0,32,2180,2480,2480,2212,2480,1,0
FL,5473,48225,0,961,652,379,759,180,197,0,A,63,652,485619,39620,407151,38775,1900,149,1227,9155,53698,53698,10382,53698,7,58
GA,2809,9915,0,961,707,379,759,180,197,0,A,87,707,12724,39620,407151,38775,1900,149,158,2,12724,12724,160,12724,7,41
GU,58,352,0,19,5109,2,759,180,197,7,,1,5109,485619,39620,407151,38775,1900,149,2,18,410,410,20,410,0,0
HI,175,7825,0,961,12,379,759,180,197,0,A,1400,12,485619,39620,407151,38775,1900,149,24,976,8000,8000,1000,8000,0,0
IA,424,6162,0,51,74,379,759,180,197,23,C,6,74,485619,39620,407151,424,1900,149,88,1149,6586,6586,1237,6586,2,6
ID,310,4396,0,42,39,379,759,180,197,0,A,6,39,4706,39620,407151,38775,1900,149,49,375,4706,4706,424,4706,1,3
IL,5057,25389,0,961,5109,379,759,180,197,0,A,73,5109,485619,39620,407151,38775,1900,149,461,2223,30446,30446,2684,30446,8,0
IN,1786,9872,0,961,5109,379,759,180,197,0,B,35,5109,485619,39620,407151,38775,1900,149,272,1556,11658,11658,1828,11658,3,0
KS,368,4554,0,961,66,379,759,180,197,0,B,8,66,485619,39620,407151,38775,1900,149,49,360,4922,4922,409,4922,2,11
KY,439,5579,0,961,5109,379,759,180,197,0,A,9,5109,485619,39620,407151,38775,1900,149,45,432,6018,6018,477,6018,0,0
LA,4025,30008,0,1185,5109,379,759,385,197,0,A,185,5109,485619,39620,407151,38775,1900,149,485,5677,34033,34033,6162,34033,34,0
MA,5653,37166,0,961,453,379,759,180,197,0,B,124,453,485619,39620,407151,38775,1900,149,797,2932,42819,42819,3729,42819,25,54
MD,1413,13316,0,961,353,379,759,180,197,0,A,35,353,485619,39620,407151,38775,34,1,174,962,14729,14729,1136,14729,11,76
ME,275,3394,0,961,49,379,759,180,197,41,A,3,49,485619,39620,407151,38775,1900,149,22,0,3669,3669,22,3669,0,49
MI,17363,23263,0,961,5109,379,759,180,197,0,B,437,5109,32172,8909,23263,18318,518,29,1579,5846,40626,40626,7425,40626,86,0
MN,823,19512,0,56,92,24,24,180,197,0,A,10,92,20335,39620,407151,38775,1900,149,98,946,20335,20335,1044,20335,1,17
MO,1031,13204,0,961,5109,379,759,180,197,0,C,13,5109,18299,1898,16387,38775,1900,149,193,1657,14235,14235,1850,14235,3,0
MP,2,,0,961,5109,379,759,180,197,0,,1400,5109,485619,39620,407151,38775,1900,149,0,0,2,2,0,2,0,0
MS,847,2989,0,961,195,379,759,180,197,0,B,16,195,485619,39620,407151,38775,1900,149,89,429,3836,3836,518,3836,2,-40
MT,171,4143,0,961,10,379,759,180,197,0,A,4,10,485619,39620,407151,38775,1900,149,17,0,4314,4314,17,4314,3,2
NC,1307,19557,0,137,5109,379,759,180,197,0,A,6,5109,485619,39620,407151,38775,1900,149,267,1652,20864,20864,1919,20864,2,0
ND,109,3728,0,961,19,379,759,180,197,19,B,2,19,485619,39620,407151,38775,1900,149,11,373,3837,3837,384,3837,1,2
NE,145,2584,5,961,5109,379,759,180,197,0,A,2,5109,485619,39620,407151,38775,1900,149,37,616,2734,2729,653,2729,0,0
NH,314,5386,144,961,45,379,759,180,197,0,B,3,45,485619,39620,407151,38775,1900,149,100,862,5844,5700,962,5700,1,12
NJ,16636,25224,0,2000,5109,379,759,180,197,0,A,198,5109,485619,39620,407151,38775,1900,149,3250,3008,41860,41860,6258,41860,37,0
NM,237,10942,0,22,5109,379,759,180,197,26,A,2,5109,485619,39620,407151,38775,1900,149,0,173,11179,11179,173,11179,0,0
NV,1008,10207,0,961,5109,379,759,180,197,0,A,32,5109,485619,39620,407151,38775,1900,149,270,1795,11215,11215,2065,11215,4,0
NY,66497,119971,0,9517,14578,2352,759,180,197,4204,A,1218,14578,485619,39620,407151,38775,1900,149,6984,7124,186468,186468,14108,186468,253,1883
OH,1933,25342,0,961,475,379,163,180,197,0,B,39,475,485619,39620,407151,1933,1900,149,280,6330,27275,27275,6610,27275,10,72
OK,481,1207,0,961,153,103,759,180,197,0,B,17,153,485619,39620,407151,38775,1900,149,52,2,1688,1688,54,1688,1,13
OR,606,12277,0,132,140,379,759,39,197,0,A,16,140,485619,39620,407151,38775,1900,149,58,1399,12883,12883,1457,12883,3,11
PA,4087,33777,0,961,386,379,759,180,197,0,A,49,386,485619,39620,407151,38775,1900,149,693,3716,37864,37864,4409,37864,11,33
PR,174,931,794,961,5109,379,759,180,197,0,A,6,5109,485619,39620,407151,38775,1900,149,47,90,1899,1105,137,1105,1,0
RI,495,3246,0,41,5109,9,759,6,197,0,B,4,5109,3933,484,3449,495,1900,149,78,190,3741,3741,268,3741,1,0
SC,925,4160,0,961,102,379,759,180,197,0,B,18,102,485619,39620,407151,38775,1900,149,151,1145,5085,5085,1296,5085,2,0
SD,101,3478,0,961,5109,379,759,180,197,34,A,1,5109,485619,39620,407151,38775,1900,149,11,351,3579,3579,362,3579,0,0
TN,1834,21470,0,961,148,379,759,180,197,0,A,13,148,485619,39620,407151,38775,1900,149,297,2433,23304,23304,2730,23304,6,15
TX,2877,33003,0,961,5109,379,759,180,197,38,A,34,5109,485619,39620,407151,2877,1900,149,325,9795,35880,35880,10120,35880,0,0
UT,806,15197,0,961,5109,379,759,180,197,0,A,4,5109,485619,39620,407151,806,1900,149,87,1923,16003,16003,2010,16003,2,0
VA,1020,11018,0,961,136,379,759,180,197,0,A,25,136,485619,39620,407151,38775,1900,149,130,1299,12038,12038,1429,12038,3,24
VI,30,126,24,961,5109,379,759,180,197,0,,1400,5109,485619,39620,407151,38775,1900,149,7,3,180,156,10,156,0,0
VT,293,3718,0,961,18,379,759,180,197,0,A,12,18,485619,39620,407151,293,1900,149,37,235,4011,4011,272,4011,0,0
WA,8120,72842,0,961,5109,379,759,180,197,0,A,248,5109,485619,39620,407151,6464,1900,149,405,4745,80962,80962,5150,80962,11,0
WI,1422,15856,0,961,5109,379,759,180,197,0,A,14,5109,485619,39620,407151,1221,1900,149,146,-694,17278,17278,-548,17278,1,0
WV,126,2984,0,961,1,379,759,180,197,0,B,1,1,485619,39620,407151,38775,1900,149,13,279,3110,3110,292,3110,1,0
WY,94,1840,0,961,17,379,759,180,197,24,A,0,17,485619,39620,407151,87,1900,149,8,286,1934,1934,294,1934,0,2
AK,102,3232,0,961,6,379,759,180,197,0,A,2,6,3334,39620,407151,102,1900,149,17,396,3334,3334,413,3334,0,1
AL,806,4184,0,158,5109,379,759,180,197,0,B,4,5109,485619,39620,407151,806,1900,149,110,0,4990,4990,110,4990,1,0
AR,426,3027,0,43,5109,379,759,16,197,28,A,6,5109,485619,39620,407151,426,1900,149,22,89,3453,3453,111,3453,1,0
AS,,,0,961,5109,379,759,180,197,0,,0,5109,485619,39620,407151,0,1900,149,0,0,0,0,0,0,0,0
AZ,919,12953,0,961,427,379,759,180,197,0,B,17,427,13872,39620,407151,38775,1900,149,46,5498,13872,13872,5544,13872,2,41
CA,5708,20549,64400,1034,5109,410,759,180,197,0,B,123,5109,26257,39620,407151,38775,1900,149,1065,0,90657,26257,1065,26257,22,0
CO,2061,11215,0,332,274,379,759,180,197,0,A,44,274,485619,39620,407151,38775,1900,149,327,1273,13276,13276,1600,13276,13,35
CT,1993,9907,0,404,5109,379,759,180,197,0,A,34,5109,485619,39620,407151,38775,12,149,702,2798,11900,11900,3500,11900,7,0
DC,342,2469,1,961,5109,379,759,180,197,66,A,5,5109,485619,39620,407151,38775,1900,149,38,258,2812,2811,296,2811,1,0
DE,232,36,0,33,5109,379,759,180,197,9,C,10,5109,485619,39620,407151,38775,10,0,18,0,268,268,18,268,1,0
FL,4246,39070,0,961,594,379,759,180,197,0,A,56,594,485619,39620,407151,38775,1900,149,483,3704,43316,43316,4187,43316,2,68
GA,2651,9913,0,961,666,379,759,180,197,0,A,80,666,12564,39620,407151,38775,1900,149,285,1228,12564,12564,1513,12564,11,49
GU,56,334,0,15,5109,379,759,180,197,7,,1,5109,485619,39620,407151,38775,1900,149,1,35,390,390,36,390,0,0
HI,151,6849,0,961,12,379,759,180,197,0,A,1400,12,485619,39620,407151,38775,1900,149,31,2492,7000,7000,2523,7000,0,4
IA,336,5013,0,51,68,379,759,180,197,17,C,4,68,485619,39620,407151,336,1900,149,38,638,5349,5349,676,5349,1,7
ID,261,4021,0,35,36,379,759,180,197,0,A,5,36,4282,39620,407151,38775,1900,149,31,679,4282,4282,710,4282,1,11
IL,4596,23166,0,961,5109,379,759,180,197,0,A,65,5109,485619,39620,407151,38775,1900,149,1105,1166,27762,27762,2271,27762,18,0
IN,1514,8316,0,961,5109,379,759,180,197,0,B,32,5109,485619,39620,407151,38775,1900,149,282,1141,9830,9830,1423,9830,1,0
KS,319,4194,0,961,55,379,759,180,197,0,B,6,55,485619,39620,407151,38775,1900,149,58,523,4513,4513,581,4513,1,28
KY,394,5147,0,961,5109,379,759,180,197,0,A,9,5109,485619,39620,407151,38775,1900,149,92,326,5541,5541,418,5541,1,0
LA,3540,24331,0,1127,5109,379,759,380,197,0,A,151,5109,485619,39620,407151,38775,1900,149,225,2485,27871,27871,2710,27871,14,0
MA,4856,34234,0,961,399,379,759,180,197,0,B,99,399,485619,39620,407151,38775,1900,149,698,3319,39090,39090,4017,39090,27,49
MD,1239,12354,0,961,277,379,759,180,197,0,D,24,277,485619,39620,407151,38775,23,1,247,838,13593,13593,1085,13593,7,51
ME,253,3394,0,961,5109,379,759,180,197,41,A,3,5109,485619,39620,407151,38775,1900,149,42,0,3647,3647,42,3647,2,0
MI,15784,17417,0,961,5109,379,759,180,197,0,B,351,5109,24312,6895,17417,17058,408,25,919,1515,33201,33201,2434,33201,68,0
MN,725,18566,0,39,75,379,17,180,197,243,A,9,75,19291,39620,407151,38775,1900,149,38,1171,19291,19291,1209,19291,4,18
MO,838,11547,0,961,5109,379,759,180,197,0,C,10,5109,17025,1702,15311,38775,1900,149,0,1465,12385,12385,1465,12385,0,0
MP,2,,0,961,5109,379,759,180,197,0,,1400,5109,485619,39620,407151,38775,1900,149,0,0,2,2,0,2,0,0
MS,758,2560,0,961,235,379,759,180,197,0,B,14,235,485619,39620,407151,38775,1900,149,95,0,3318,3318,95,3318,1,16
MT,154,4143,0,961,8,379,759,180,197,0,A,1,8,485619,39620,407151,38775,1900,149,25,887,4297,4297,912,4297,0,1
NC,1040,17905,0,91,5109,379,759,180,197,0,A,4,5109,485619,39620,407151,38775,1900,149,105,1313,18945,18945,1418,18945,0,0
ND,98,3355,0,961,17,379,759,180,197,18,B,1,17,485619,39620,407151,38775,1900,149,15,546,3453,3453,561,3453,0,1
NE,108,1968,4,961,5109,379,759,180,197,0,A,2,5109,485619,39620,407151,38775,1900,149,12,64,2080,2076,76,2076,0,0
NH,214,4524,285,961,33,379,759,180,197,0,B,2,33,485619,39620,407151,38775,1900,149,27,868,5023,4738,895,4738,0,3
NJ,13386,22216,0,2000,5109,379,759,180,197,0,A,161,5109,485619,39620,407151,38775,1900,149,2262,2830,35602,35602,5092,35602,21,0
NM,237,10769,0,19,5109,379,759,180,197,2,A,2,5109,485619,39620,407151,38775,1900,149,46,1573,11006,11006,1619,11006,1,0
NV,738,8412,0,961,5109,379,759,180,197,0,A,28,5109,485619,39620,407151,38775,1900,149,117,511,9150,9150,628,9150,3,0
NY,59513,112847,0,8503,12695,2037,759,180,197,3572,A,965,12695,485619,39620,407151,38775,1900,149,7195,9231,172360,172360,16426,172360,237,2241
OH,1653,19012,0,961,403,379,139,180,197,0,B,29,403,485619,39620,407151,1653,1900,149,247,0,20665,20665,247,20665,4,59
OK,429,1205,0,961,140,379,759,180,197,0,A,16,140,485619,39620,407151,38775,1900,149,52,25,1634,1634,77,1634,1,14
OR,548,10878,0,107,129,379,759,37,197,0,A,13,129,485619,39620,407151,38775,1900,149,69,1185,11426,11426,1254,11426,0,12
PA,3394,30061,0,961,353,379,759,180,197,0,A,38,353,485619,39620,407151,38775,1900,149,643,4807,33455,33455,5450,33455,4,37
PR,127,841,817,961,5109,379,759,180,197,0,A,5,5109,485619,39620,407151,38775,1900,149,27,102,1785,968,129,968,2,0
RI,417,3056,0,35,5109,9,759,6,197,0,B,3,5109,3649,422,3227,417,1900,149,105,314,3473,3473,419,3473,3,0
SC,774,3015,0,961,102,379,759,180,197,0,B,16,102,485619,39620,407151,38775,1900,149,235,607,3789,3789,842,3789,3,0
SD,90,3127,1,961,5109,379,759,180,197,29,A,1,5109,485619,39620,407151,38775,1900,149,22,535,3218,3217,557,3217,0,0
TN,1537,19037,0,961,133,379,759,180,197,0,A,7,133,485619,39620,407151,38775,1900,149,164,2072,20574,20574,2236,20574,1,15
TX,2552,23208,0,961,5109,379,759,180,197,0,A,34,5109,485619,39620,407151,2552,1900,149,500,0,25760,25760,500,25760,7,0
UT,719,13274,0,961,5109,379,759,180,197,0,A,2,5109,485619,39620,407151,719,1900,149,117,2564,13993,13993,2681,13993,0,0
VA,890,9719,0,961,112,379,759,180,197,0,A,22,112,485619,39620,407151,38775,1900,149,151,1292,10609,10609,1443,10609,5,13
VI,23,123,37,961,5109,379,759,180,197,0,,1400,5109,485619,39620,407151,38775,1900,149,1,17,183,146,18,146,0,0
VT,256,3483,0,961,18,379,759,180,197,0,A,12,18,485619,39620,407151,256,1900,149,22,291,3739,3739,313,3739,0,0
WA,7715,68097,0,961,5109,379,759,180,197,0,A,237,5109,485619,39620,407151,5900,1900,149,318,1515,75812,75812,1833,75812,17,0
WI,1276,16550,0,961,5109,379,759,180,197,0,A,13,5109,485619,39620,407151,1112,1900,149,142,1318,17826,17826,1460,17826,0,0
WV,113,2705,0,961,1,379,759,180,197,0,B,0,1,485619,39620,407151,38775,1900,149,17,374,2818,2818,391,2818,0,0
WY,86,1554,0,961,15,379,759,180,197,20,A,0,15,485619,39620,407151,84,1900,149,4,79,1640,1640,83,1640,0,1
AK,85,2836,0,961,5,379,759,180,197,0,A,2,5,2921,39620,407151,85,1900,149,16,517,2921,2921,533,2921,1,2
AL,696,4184,0,134,5109,379,759,180,197,0,B,3,5109,485619,39620,407151,696,1900,149,109,0,4880,4880,109,4880,0,0
AR,404,2938,0,48,5109,379,759,17,197,24,A,5,5109,485619,39620,407151,404,1900,149,23,1393,3342,3342,1416,3342,2,0
AS,,,0,961,5109,379,759,180,197,0,,0,5109,485619,39620,407151,0,1900,149,0,0,0,0,0,0,0,0
AZ,873,7455,21,961,386,379,759,180,197,0,B,15,386,8328,39620,407151,38775,1900,149,137,0,8349,8328,137,8328,2,43
CA,4643,20549,64400,1034,5109,410,759,180,197,0,B,101,5109,25192,39620,407151,38775,1900,149,764,3169,89592,25192,3933,25192,23,0
CO,1734,9942,0,307,239,379,759,180,197,0,A,31,239,485619,39620,407151,38775,1900,149,304,1250,11676,11676,1554,11676,7,55
CT,1291,7109,0,173,5109,379,759,180,197,0,A,27,5109,485619,39620,407151,38775,10,149,0,0,8400,8400,0,8400,0,0
DC,304,2211,1,961,5109,379,759,180,197,51,A,4,5109,485619,39620,407151,38775,1900,149,37,314,2516,2515,351,2515,1,0
DE,214,36,0,31,5109,379,759,180,197,9,C,9,5109,485619,39620,407151,38775,9,0,51,0,250,250,51,250,4,0
FL,3763,35366,0,961,526,379,759,180,197,0,A,54,526,485619,39620,407151,38775,1900,149,998,7180,39129,39129,8178,39129,20,70
GA,2366,8685,0,961,617,379,759,180,197,0,A,69,617,11051,39620,407151,38775,1900,149,365,821,11051,11051,1186,11051,5,51
GU,55,299,0,15,5109,379,759,180,197,7,,1,5109,485619,39620,407151,38775,1900,149,4,0,354,354,4,354,0,0
HI,120,4357,0,961,8,379,759,180,197,0,A,1400,8,485619,39620,407151,38775,1900,149,14,0,4477,4477,14,4477,0,1
IA,298,4375,0,46,61,379,759,180,197,15,C,3,61,485619,39620,407151,298,1900,149,63,635,4673,4673,698,4673,0,11
ID,230,3342,0,37,25,379,759,180,197,0,A,4,25,3572,39620,407151,38775,1900,149,41,674,3572,3572,715,3572,1,25
IL,3491,22000,0,961,5109,379,759,180,197,0,A,47,5109,485619,39620,407151,38775,1900,149,465,3484,25491,25491,3949,25491,13,0
IN,1232,7175,0,961,5109,379,759,180,197,0,B,31,5109,485619,39620,407151,38775,1900,149,251,1220,8407,8407,1471,8407,7,0
KS,261,3671,0,961,27,379,759,180,197,0,B,5,27,485619,39620,407151,38775,1900,149,59,442,3932,3932,501,3932,1,0
KY,302,4821,0,961,5109,379,759,180,197,0,A,8,5109,485619,39620,407151,38775,1900,149,54,1053,5123,5123,1107,5123,2,0
LA,3315,21846,0,927,5109,379,759,336,197,0,A,137,5109,485619,39620,407151,38775,1900,149,569,3233,25161,25161,3802,25161,18,0
MA,4158,30915,0,961,350,379,759,180,197,0,B,72,350,485619,39620,407151,38775,1900,149,1007,4671,35073,35073,5678,35073,15,131
MD,992,11516,0,961,226,379,759,180,197,0,D,17,226,485619,39620,407151,38775,17,149,218,11422,12508,12508,11640,12508,7,53
ME,211,3394,0,961,5109,379,759,180,197,36,A,1,5109,485619,39620,407151,38775,1900,149,43,0,3605,3605,43,3605,0,0
MI,14865,15902,0,961,5109,379,759,180,197,0,B,283,5109,21920,6018,15902,15519,326,19,1066,1762,30767,30767,2828,30767,71,0
MN,687,17395,0,30,57,379,17,180,197,215,A,5,57,18082,39620,407151,38775,1900,149,47,3790,18082,18082,3837,18082,1,6
MO,838,10082,0,961,5109,379,759,180,197,0,C,10,5109,14889,1406,13471,38775,1900,149,169,9713,10920,10920,9882,10920,2,0
MP,2,,0,961,5109,379,759,180,197,0,,1400,5109,485619,39620,407151,38775,1900,149,2,0,2,2,2,2,0,0
MS,663,2560,0,961,219,379,759,180,197,0,B,13,219,485619,39620,407151,38775,1900,149,84,0,3223,3223,84,3223,5,34
MT,129,3256,0,961,7,379,759,180,197,0,A,1,7,485619,39620,407151,38775,1900,149,21,666,3385,3385,687,3385,1,0
NC,935,16592,0,87,5109,379,759,180,197,0,A,4,5109,485619,39620,407151,38775,1900,149,172,2219,17527,17527,2391,17527,1,0
ND,83,2809,0,961,16,379,759,180,197,16,B,1,16,485619,39620,407151,38775,1900,149,18,382,2892,2892,400,2892,1,3
NE,96,1904,0,961,5109,379,759,180,197,0,A,2,5109,485619,39620,407151,38775,1900,149,11,143,2000,2000,154,2000,2,0
NH,187,3656,296,961,30,379,759,180,197,0,B,2,30,485619,39620,407151,38775,1900,149,29,261,4139,3843,290,3843,1,5
NJ,11124,19386,0,2000,5109,379,759,180,197,0,A,140,5109,485619,39620,407151,38775,1900,149,2299,2839,30510,30510,5138,30510,32,0
NM,191,9196,0,17,5109,379,759,180,197,0,A,1,5109,485619,39620,407151,38775,1900,149,55,819,9387,9387,874,9387,0,0
NV,621,7901,0,961,5109,379,759,180,197,0,A,25,5109,485619,39620,407151,38775,1900,149,86,1740,8522,8522,1826,8522,4,0
NY,52318,103616,0,7328,10454,1755,759,180,197,2726,A,728,10454,485619,39620,407151,38775,1900,149,7683,2498,155934,155934,10181,155934,209,1722
OH,1406,19012,0,961,344,379,123,180,197,0,B,25,344,485619,39620,407151,1406,1900,149,269,0,20418,20418,269,20418,6,68
OK,377,1180,0,961,126,379,759,180,197,0,A,15,126,485619,39620,407151,38775,1900,149,55,96,1557,1557,151,1557,7,21
OR,479,9693,0,107,117,379,759,31,197,0,A,13,117,485619,39620,407151,38775,1900,149,65,1183,10172,10172,1248,10172,1,15
PA,2751,25254,0,961,316,379,759,180,197,0,A,34,316,485619,39620,407151,38775,1900,149,533,4238,28005,28005,4771,28005,12,75
PR,100,739,792,961,5109,379,759,180,197,0,A,3,5109,485619,39620,407151,38775,1900,149,21,220,1631,839,241,839,0,0
RI,312,2742,138,29,5109,9,759,6,197,0,B,1400,5109,3187,316,2871,312,1900,149,64,240,3192,3054,304,3054,0,0
SC,539,2408,0,961,102,379,759,180,197,0,B,13,102,485619,39620,407151,38775,1900,149,83,101,2947,2947,184,2947,4,0
SD,68,2592,0,961,5109,379,759,180,197,26,A,1,5109,485619,39620,407151,38775,1900,149,10,205,2660,2660,215,2660,0,0
TN,1373,16965,0,961,118,379,759,180,197,0,A,6,118,485619,39620,407151,38775,1900,149,170,2077,18338,18338,2247,18338,0,15
TX,2052,23208,0,961,5109,379,759,180,197,0,A,27,5109,485619,39620,407151,2052,1900,149,321,1273,25260,25260,1594,25260,4,0
UT,602,10710,0,961,5109,379,759,180,197,0,A,2,5109,485619,39620,407151,602,1900,149,122,1946,11312,11312,2068,11312,0,0
VA,739,8427,0,961,99,379,759,180,197,0,A,17,99,485619,39620,407151,38775,1900,149,135,1694,9166,9166,1829,9166,3,16
VI,22,106,55,961,5109,379,759,180,197,0,,1400,5109,485619,39620,407151,38775,1900,149,3,51,183,128,54,128,0,0
VT,234,3192,0,961,18,379,759,180,197,0,A,12,18,485619,39620,407151,234,1900,149,21,324,3426,3426,345,3426,2,0
WA,7397,66582,0,961,5109,379,759,180,197,0,A,220,5109,485619,39620,407151,5659,1900,149,321,2280,73979,73979,2601,73979,21,0
WI,1134,15232,0,961,5109,379,759,180,197,0,A,13,5109,485619,39620,407151,989,1900,149,165,2092,16366,16366,2257,16366,0,0
WV,96,2331,6,961,1,379,759,180,197,0,B,0,1,485619,39620,407151,38775,1900,149,20,552,2433,2427,572,2427,0,0
WY,82,1475,0,961,14,379,759,180,197,18,A,0,14,485619,39620,407151,73,1900,149,12,264,1557,1557,276,1557,0,3
AK,69,2319,13,961,3,379,759,180,197,0,A,1,3,2388,39620,407151,69,1900,149,10,518,2401,2388,528,2388,0,0
AL,587,4184,0,112,5109,379,759,180,197,0,B,3,5109,485619,39620,407151,587,1900,149,81,591,4771,4771,672,4771,2,0
AR,381,1545,0,48,5109,379,759,17,197,19,A,3,5109,485619,39620,407151,381,1900,149,46,41,1926,1926,87,1926,0,0
AS,,,0,961,5109,379,759,180,197,0,,0,5109,485619,39620,407151,0,1900,149,0,0,0,0,0,0,0,0
AZ,736,7455,30,961,343,379,759,180,197,0,B,13,343,8191,39620,407151,38775,1900,149,159,7108,8221,8191,7267,8191,5,40
CA,3879,17380,57400,746,5109,200,759,180,197,0,B,78,5109,21259,39620,407151,38775,1900,149,873,0,78659,21259,873,21259,13,0
CO,1430,8692,0,278,184,379,759,180,197,0,A,24,184,485619,39620,407151,38775,1900,149,344,1714,10122,10122,2058,10122,5,36
CT,1291,7109,0,173,5109,379,759,180,197,0,A,27,5109,485619,39620,407151,38775,5,149,279,1484,8400,8400,1763,8400,6,0
DC,267,1897,2,961,5109,379,759,180,197,49,A,3,5109,485619,39620,407151,38775,1900,149,36,271,2166,2164,307,2164,0,0
DE,163,36,0,15,5109,379,759,180,197,9,C,5,5109,485619,39620,407151,38775,5,0,33,0,199,199,33,199,2,0
FL,2765,28186,1517,961,456,379,759,180,197,0,A,34,456,485619,39620,407151,38775,1900,149,410,4445,32468,30951,4855,30951,6,50
GA,2001,7864,0,961,566,379,759,180,197,0,A,64,566,9865,39620,407151,38775,1900,149,476,463,9865,9865,939,9865,16,93
GU,51,299,0,13,5109,379,759,180,197,0,,1,5109,485619,39620,407151,38775,1900,149,6,36,350,350,42,350,0,0
HI,106,4357,0,961,7,379,759,180,197,0,A,1400,7,485619,39620,407151,38775,1900,149,11,0,4463,4463,11,4463,0,2
IA,235,3740,0,32,50,379,759,180,197,18,C,3,50,485619,39620,407151,235,1900,149,56,1162,3975,3975,1218,3975,2,4
ID,189,2668,0,31,5109,379,759,180,197,0,A,3,5109,2857,39620,407151,38775,1900,149,66,603,2857,2857,669,2857,3,0
IL,3026,18516,0,961,5109,379,759,180,197,0,A,34,5109,485619,39620,407151,38775,1900,149,488,4423,21542,21542,4911,21542,8,0
IN,981,5955,0,961,5109,379,759,180,197,0,B,24,5109,485619,39620,407151,38775,1900,149,336,1949,6936,6936,2285,6936,7,0
KS,202,3229,0,961,27,379,759,180,197,0,B,4,27,485619,39620,407151,38775,1900,149,34,360,3431,3431,394,3431,1,27
KY,248,3768,0,961,5109,379,759,180,197,0,A,6,5109,485619,39620,407151,38775,1900,149,50,666,4016,4016,716,4016,2,0
LA,2746,18613,0,773,5109,379,759,270,197,0,A,119,5109,485619,39620,407151,38775,1900,149,441,2889,21359,21359,3330,21359,36,0
MA,3151,26244,0,961,219,379,759,180,197,0,B,57,219,485619,39620,407151,38775,1900,149,833,4917,29395,29395,5750,29395,15,0
MD,774,94,0,961,173,379,759,180,197,25,D,10,173,485619,39620,407151,38775,10,149,194,0,868,868,194,868,3,41
ME,168,3394,0,961,5109,379,759,180,197,24,A,1,5109,485619,39620,407151,38775,1900,149,13,0,3562,3562,13,3562,1,0
MI,13799,14140,0,961,5109,379,759,180,197,0,B,212,5109,19133,4993,14140,14625,264,15,1324,2410,27939,27939,3734,27939,53,0
MN,640,13605,0,34,51,379,17,180,197,176,A,4,51,14245,39620,407151,38775,1900,149,75,1001,14245,14245,1076,14245,2,10
MO,669,369,0,961,5109,379,759,180,197,0,C,8,5109,12479,1144,11324,38775,1900,149,167,0,1038,1038,167,1038,0,0
MP,0,,0,961,5109,379,759,180,197,0,,0,5109,485619,39620,407151,38775,1900,149,0,0,0,0,0,0,0,0
MS,579,2560,0,961,185,379,759,180,197,0,B,8,185,485619,39620,407151,38775,1900,149,94,269,3139,3139,363,3139,2,35
MT,108,2590,0,961,7,379,759,180,197,0,A,1400,7,485619,39620,407151,38775,1900,149,37,462,2698,2698,499,2698,0,6
NC,763,14373,0,77,5109,379,759,180,197,0,A,3,5109,485619,39620,407151,38775,1900,149,127,2099,15136,15136,2226,15136,1,0
ND,65,2427,0,961,13,379,759,180,197,15,B,0,13,485619,39620,407151,38775,1900,149,13,388,2492,2492,401,2492,0,3
NE,85,1761,0,961,5109,379,759,180,197,0,A,0,5109,485619,39620,407151,38775,1900,149,12,177,1846,1846,189,1846,0,0
NH,158,3395,592,961,25,379,759,180,197,0,B,1,25,485619,39620,407151,38775,1900,149,21,394,4145,3553,415,3553,0,6
NJ,8825,16547,0,2000,5109,379,759,180,197,0,A,108,5109,485619,39620,407151,38775,1900,149,1949,2886,25372,25372,4835,25372,27,0
NM,136,8377,0,961,5109,379,759,180,197,0,A,1,5109,485619,39620,407151,38775,1900,149,24,696,8513,8513,720,8513,0,0
NV,535,6161,0,961,5109,379,759,180,197,0,A,21,5109,485619,39620,407151,38775,1900,149,115,1464,6696,6696,1579,6696,4,0
NY,44635,101118,0,6481,8732,1583,759,180,197,2045,A,519,8732,485619,39620,407151,38775,1900,149,7377,16272,145753,145753,23649,145753,134,1811
OH,1137,19012,0,961,276,379,107,180,197,0,B,19,276,485619,39620,407151,1137,1900,149,270,2563,20149,20149,2833,20149,4,53
OK,322,1084,0,961,105,379,759,180,197,0,A,8,105,485619,39620,407151,38775,1900,149,74,126,1406,1406,200,1406,1,19
OR,414,8510,0,91,102,379,759,31,197,0,A,12,102,485619,39620,407151,38775,1900,149,87,1557,8924,8924,1644,8924,1,12
PA,2218,21016,0,961,241,379,759,180,197,0,A,22,241,485619,39620,407151,38775,1900,149,531,4575,23234,23234,5106,23234,6,241
PR,79,519,334,961,5109,379,759,180,197,0,A,3,5109,485619,39620,407151,38775,1900,149,15,142,932,598,157,598,1,0
RI,248,2502,138,28,5109,9,759,6,197,0,B,1400,5109,2868,257,2611,248,1900,149,31,202,2888,2750,233,2750,0,0
SC,456,2307,0,961,102,379,759,180,197,0,B,9,102,485619,39620,407151,38775,1900,149,0,0,2763,2763,0,2763,0,0
SD,58,2387,20,961,5109,379,759,180,197,21,A,1,5109,485619,39620,407151,38775,1900,149,12,414,2465,2445,426,2445,0,0
TN,1203,14888,0,961,103,379,759,180,197,0,A,6,103,485619,39620,407151,38775,1900,149,246,936,16091,16091,1182,16091,3,27
TX,1731,21935,0,961,5109,379,759,180,197,0,A,23,5109,485619,39620,407151,1731,1900,149,335,1907,23666,23666,2242,23666,5,0
UT,480,8764,0,961,5109,379,759,180,197,0,A,2,5109,485619,39620,407151,480,1900,149,78,1456,9244,9244,1534,9244,1,0
VA,604,6733,0,961,83,379,759,180,197,0,A,14,83,485619,39620,407151,38775,1900,149,144,1004,7337,7337,1148,7337,1,18
VI,19,55,2,961,5109,379,759,180,197,0,,1400,5109,485619,39620,407151,38775,1900,149,2,0,76,74,2,74,0,0
VT,213,2868,0,961,18,379,759,180,197,0,A,10,18,485619,39620,407151,213,1900,149,28,124,3081,3081,152,3081,1,18
WA,7076,64302,0,961,5109,379,759,180,197,0,A,199,5109,485619,39620,407151,5375,1900,149,376,3984,71378,71378,4360,71378,16,0
WI,969,13140,0,961,5109,379,759,180,197,0,A,13,5109,485619,39620,407151,842,1900,149,163,1557,14109,14109,1720,14109,5,0
WV,76,1779,43,961,1,379,759,180,197,0,B,0,1,485619,39620,407151,38775,1900,149,25,748,1898,1855,773,1855,0,0
WY,70,1211,0,961,11,379,759,180,197,17,A,0,11,485619,39620,407151,54,1900,149,17,159,1281,1281,176,1281,0,11
AK,59,1801,0,961,3,379,759,180,197,0,A,1,3,1860,39620,407151,59,1900,149,17,152,1860,1860,169,1860,0,2
AL,506,3593,0,106,5109,379,759,180,197,0,C,1,5109,485619,39620,407151,506,1900,149,223,1064,4099,4099,1287,4099,1,0
AR,335,1504,0,41,5109,379,759,13,197,13,A,3,5109,485619,39620,407151,335,1900,149,55,67,1839,1839,122,1839,1,0
AS,,,0,961,5109,379,759,180,197,0,,0,5109,485619,39620,407151,0,1900,149,0,0,0,0,0,0,0,0
AZ,577,347,33,961,303,379,759,180,197,0,B,8,303,924,39620,407151,38775,1900,149,127,24,957,924,151,924,2,39
CA,3006,17380,57400,961,5109,379,759,180,197,0,B,65,5109,20386,39620,407151,38775,1900,149,651,1459,77786,20386,2110,20386,12,0
CO,1086,6978,0,230,148,379,759,180,197,0,A,19,148,485619,39620,407151,38775,1900,149,174,189,8064,8064,363,8064,8,64
CT,1012,5625,0,125,5109,379,759,180,197,0,A,21,5109,485619,39620,407151,38775,4,149,137,602,6637,6637,739,6637,2,0
DC,231,1626,1,961,5109,379,759,180,197,21,A,3,5109,485619,39620,407151,38775,1900,149,48,203,1858,1857,251,1857,1,0
DE,130,36,0,13,5109,379,759,180,197,4,C,3,5109,485619,39620,407151,38775,3,0,15,0,166,166,15,166,1,0
FL,2355,23741,1443,961,406,379,759,180,197,0,A,28,406,485619,39620,407151,38775,1900,149,673,8367,27539,26096,9040,26096,6,90
GA,1525,7401,0,961,473,379,759,180,197,0,A,48,473,8926,39620,407151,38775,1900,149,278,2469,8926,8926,2747,8926,8,79
GU,45,263,0,11,5109,379,759,180,197,0,,1,5109,485619,39620,407151,38775,1900,149,8,30,308,308,38,308,0,0
HI,95,4357,0,961,5,379,759,180,197,0,A,1400,5,485619,39620,407151,38775,1900,149,5,0,4452,4452,5,4452,0,-1
IA,179,2578,0,31,46,379,759,180,197,15,C,1,46,485619,39620,407151,179,1900,149,34,0,2757,2757,34,2757,0,10
ID,123,2065,0,34,5109,379,759,180,197,0,A,0,5109,2188,39620,407151,38775,1900,149,50,178,2188,2188,228,2188,0,0
IL,2538,14093,0,961,5109,379,759,180,197,0,A,26,5109,485619,39620,407151,38775,1900,149,673,1749,16631,16631,2422,16631,7,0
IN,645,4006,0,961,5109,379,759,180,197,0,B,17,5109,485619,39620,407151,38775,1900,149,168,1127,4651,4651,1295,4651,3,-1
KS,168,2869,0,961,5109,379,759,180,197,0,B,3,5109,485619,39620,407151,38775,1900,149,42,509,3037,3037,551,3037,0,0
KY,198,3102,0,961,5109,379,759,180,197,0,A,4,5109,485619,39620,407151,38775,1900,149,41,237,3300,3300,278,3300,0,0
LA,2305,15724,0,676,5109,379,759,239,197,0,A,83,5109,485619,39620,407151,38775,1900,149,510,6068,18029,18029,6578,18029,18,0
MA,2318,21327,0,961,219,379,759,180,197,0,B,42,219,485619,39620,407151,38775,1900,149,579,3248,23645,23645,3827,23645,9,116
MD,580,94,0,961,132,379,759,180,197,0,D,7,132,485619,39620,407151,38775,7,149,157,0,674,674,157,674,2,132
ME,155,3394,0,961,5109,379,759,180,197,16,A,1400,5109,485619,39620,407151,38775,1900,149,6,217,3549,3549,223,3549,0,0
MI,12475,11730,0,961,5109,379,759,180,197,0,D,159,5109,15597,3867,11730,13585,197,10,1140,2888,24205,24205,4028,24205,48,0
MN,565,12604,0,31,41,379,759,180,197,0,A,2,41,13169,39620,407151,38775,1900,149,63,1416,13169,13169,1479,13169,1,6
MO,502,369,0,961,5109,379,759,180,197,0,C,8,5109,10044,915,9121,38775,1900,149,146,0,871,871,146,871,0,0
MP,0,,0,961,5109,379,759,180,197,0,,0,5109,485619,39620,407151,38775,1900,149,0,0,0,0,0,0,0,0
MS,485,2291,0,961,150,379,759,180,197,0,B,6,150,485619,39620,407151,38775,1900,149,108,725,2776,2776,833,2776,4,33
MT,71,2128,0,961,1,379,759,180,197,0,C,1400,1,485619,39620,407151,38775,1900,149,18,180,2199,2199,198,2199,0,1
NC,636,12274,0,29,5109,379,759,180,197,0,A,2,5109,485619,39620,407151,38775,1900,149,132,2289,12910,12910,2421,12910,1,0
ND,52,2039,0,961,10,379,759,180,197,0,B,0,10,485619,39620,407151,38775,1900,149,13,305,2091,2091,318,2091,0,2
NE,73,1584,0,961,5109,379,759,180,197,0,A,0,5109,485619,39620,407151,38775,1900,149,12,280,1657,1657,292,1657,0,0
NH,137,3001,712,961,19,379,759,180,197,0,B,1,19,485619,39620,407151,38775,1900,149,29,645,3850,3138,674,3138,0,6
NJ,6876,13661,0,1080,5109,379,759,180,197,0,B,81,5109,485619,39620,407151,38775,1900,149,2474,3209,20537,20537,5683,20537,19,0
NM,112,7681,0,961,5109,379,759,180,197,0,A,1,5109,485619,39620,407151,38775,1900,149,12,939,7793,7793,951,7793,0,0
NV,420,4697,0,961,5109,379,759,180,197,0,A,17,5109,485619,39620,407151,38775,1900,149,99,446,5117,5117,545,5117,4,0
NY,37258,84846,0,5327,6921,1290,759,180,197,0,B,385,6921,485619,39620,407151,38775,1900,149,6447,12178,122104,122104,18625,122104,100,1795
OH,867,16449,0,961,223,379,91,180,197,0,B,15,223,485619,39620,407151,867,1900,149,163,2389,17316,17316,2552,17316,5,41
OK,248,958,0,961,86,379,759,180,197,0,A,7,86,485619,39620,407151,38775,1900,149,84,153,1206,1206,237,1206,2,27
OR,327,6953,0,961,90,379,759,180,197,0,A,11,90,485619,39620,407151,38775,1900,149,118,2603,7280,7280,2721,7280,3,29
PA,1687,16441,0,961,5109,379,759,180,197,0,A,16,5109,485619,39620,407151,38775,1900,149,560,5248,18128,18128,5808,18128,5,0
PR,64,377,335,961,5109,379,759,180,197,0,A,2,5109,485619,39620,407151,38775,1900,149,13,60,776,441,73,441,0,0
RI,217,2300,181,23,5109,9,759,6,197,0,B,1400,5109,2626,230,2396,217,1900,149,41,176,2698,2517,217,2517,0,0
SC,456,2307,0,961,102,379,759,180,197,0,B,9,102,485619,39620,407151,38775,1900,149,32,4,2763,2763,36,2763,2,0
SD,46,1973,125,961,5109,379,759,180,197,16,A,1,5109,485619,39620,407151,38775,1900,149,5,1154,2144,2019,1159,2019,0,0
TN,957,13952,0,961,76,379,759,180,197,0,A,3,76,485619,39620,407151,38775,1900,149,173,2940,14909,14909,3113,14909,0,23
TX,1396,20028,0,961,5109,379,759,180,197,0,A,18,5109,485619,39620,407151,1396,1900,149,422,7508,21424,21424,7930,21424,6,0
UT,402,7308,0,961,5109,379,759,180,197,0,A,1,5109,485619,39620,407151,402,1900,149,56,817,7710,7710,873,7710,0,0
VA,460,5729,0,961,65,379,759,180,197,0,A,13,65,485619,39620,407151,38775,1900,149,69,750,6189,6189,819,6189,4,6
VI,17,55,2,961,5109,379,759,180,197,0,,1400,5109,485619,39620,407151,38775,1900,149,0,0,74,72,0,72,0,0
VT,185,2744,0,961,5109,379,759,180,197,0,A,9,5109,485619,39620,407151,185,1900,149,25,934,2929,2929,959,2929,1,0
WA,6700,60318,0,961,5109,379,759,180,197,0,A,183,5109,485619,39620,407151,4918,1900,149,371,4100,67018,67018,4471,67018,24,0
WI,806,11583,0,961,5109,379,759,180,197,0,A,8,5109,485619,39620,407151,707,1900,149,139,1494,12389,12389,1633,12389,1,0
WV,51,1031,19,961,1,379,759,180,197,0,B,0,1,485619,39620,407151,38775,1900,149,12,272,1101,1082,284,1082,0,0
WY,53,1052,0,961,5109,379,759,180,197,12,A,1400,5109,485619,39620,407151,44,1900,149,9,98,1105,1105,107,1105,0,0
AK,42,1649,0,961,1,379,759,180,197,0,A,1,1,1691,39620,407151,42,1900,149,6,663,1691,1691,669,1691,1,1
AL,283,2529,0,91,5109,379,759,180,197,0,C,0,5109,485619,39620,407151,283,1900,149,68,423,2812,2812,491,2812,0,0
AR,280,1437,0,22,5109,379,759,4,197,11,A,2,5109,485619,39620,407151,280,1900,149,62,490,1717,1717,552,1717,2,0
AS,,,0,961,5109,379,759,180,197,0,,0,5109,485619,39620,407151,0,1900,149,0,0,0,0,0,0,0,0
AZ,450,323,53,961,264,379,759,180,197,0,B,6,264,773,39620,407151,38775,1900,149,93,10,826,773,103,773,1,45
CA,2355,15921,48600,961,5109,379,759,180,197,0,B,53,5109,18276,39620,407151,38775,1900,149,253,2469,66876,18276,2722,18276,13,0
CO,912,6789,0,152,84,379,759,180,197,0,A,11,84,485619,39620,407151,38775,1900,149,192,1285,7701,7701,1477,7701,4,12
CT,875,5023,0,113,5109,379,759,180,197,0,A,19,5109,485619,39620,407151,38775,3,149,257,341,5898,5898,598,5898,7,0
DC,183,1423,3,961,5109,379,759,180,197,0,A,2,5109,485619,39620,407151,38775,1900,149,46,228,1609,1606,274,1606,0,0
DE,115,36,0,11,5109,379,759,180,197,0,C,2,5109,485619,39620,407151,38775,2,0,24,0,151,151,24,151,1,0
FL,1682,15374,1233,961,316,379,759,180,197,0,A,22,316,485619,39620,407151,38775,1900,149,270,2247,18289,17056,2517,17056,4,57
GA,1247,4932,0,961,394,379,759,180,197,0,A,40,394,6179,39620,407151,38775,1900,149,221,474,6179,6179,695,6179,8,394
GU,37,233,0,10,5109,379,759,180,197,0,,1,5109,485619,39620,407151,38775,1900,149,5,32,270,270,37,270,0,0
HI,90,4357,0,961,6,379,759,180,197,0,A,1400,6,485619,39620,407151,38775,1900,149,13,768,4447,4447,781,4447,0,2
IA,145,2578,0,23,36,379,759,180,197,0,C,1,36,485619,39620,407151,145,1900,149,21,263,2723,2723,284,2723,1,9
ID,73,1887,0,961,5109,379,759,180,197,0,A,0,5109,1960,39620,407151,38775,1900,149,23,0,1960,1960,23,1960,0,0
IL,1865,12344,0,961,5109,379,759,180,197,0,A,19,5109,485619,39620,407151,38775,1900,149,330,2410,14209,14209,2740,14209,3,0
IN,477,2879,0,961,1,379,759,180,197,0,B,14,1,485619,39620,407151,38775,1900,149,112,313,3356,3356,425,3356,2,0
KS,126,2360,0,961,5109,379,759,180,197,0,B,3,5109,485619,39620,407151,38775,1900,149,28,274,2486,2486,302,2486,1,0
KY,157,2865,0,961,5109,379,759,180,197,0,A,4,5109,485619,39620,407151,38775,1900,149,33,1103,3022,3022,1136,3022,0,0
LA,1795,9656,0,491,5109,379,759,163,197,0,A,65,5109,485619,39620,407151,38775,1900,149,407,2441,11451,11451,2848,11451,19,0
MA,1739,18079,0,961,103,379,759,180,197,0,B,33,103,485619,39620,407151,38775,1900,149,679,5365,19818,19818,6044,19818,7,9
MD,423,94,0,961,5109,379,759,180,197,0,D,5,5109,485619,39620,407151,38775,5,149,74,0,517,517,74,517,0,0
ME,149,3177,0,961,5109,379,759,180,197,7,A,1400,5109,485619,39620,407151,38775,1900,149,24,163,3326,3326,187,3326,0,0
MI,11335,8842,0,961,5109,379,759,180,197,0,D,111,5109,11782,2940,8842,12288,149,8,1180,1853,20177,20177,3033,20177,25,0
MN,502,11188,0,26,35,379,759,180,197,121,A,1,35,11690,39620,407151,38775,1900,149,58,5638,11690,11690,5696,11690,0,14
MO,356,369,0,961,5109,379,759,180,197,0,C,8,5109,7980,700,7272,38775,1900,149,173,0,725,725,173,725,5,0
MP,0,,0,961,5109,379,759,180,197,0,,0,5109,485619,39620,407151,38775,1900,149,0,0,0,0,0,0,0,0
MS,377,1566,0,961,117,379,759,180,197,0,B,2,117,485619,39620,407151,38775,1900,149,57,14,1943,1943,71,1943,1,31
MT,53,1948,0,961,5109,379,759,180,197,0,C,1400,5109,485619,39620,407151,38775,1900,149,7,305,2001,2001,312,2001,0,0
NC,504,9985,0,29,5109,379,759,180,197,0,A,1,5109,485619,39620,407151,38775,1900,149,106,1844,10489,10489,1950,10489,1,0
ND,39,1734,0,961,8,379,759,180,197,0,B,0,8,485619,39620,407151,38775,1900,149,5,280,1773,1773,285,1773,0,3
NE,61,1304,0,961,5109,379,759,180,197,0,A,0,5109,485619,39620,407151,38775,1900,149,9,329,1365,1365,338,1365,0,0
NH,108,2356,804,961,13,379,759,180,197,0,B,1,13,485619,39620,407151,38775,1900,149,7,909,3268,2464,916,2464,0,2
NJ,4402,10452,0,961,5109,379,759,180,197,0,B,62,5109,485619,39620,407151,38775,1900,149,727,2127,14854,14854,2854,14854,18,0
NM,100,6742,0,961,5109,379,759,180,197,0,A,1,5109,485619,39620,407151,38775,1900,149,17,852,6842,6842,869,6842,1,0
NV,321,4251,0,961,5109,379,759,180,197,0,A,13,5109,485619,39620,407151,38775,1900,149,43,297,4572,4572,340,4572,0,0
NY,30811,72668,0,4079,5126,379,759,180,197,0,B,285,5126,485619,39620,407151,38775,1900,149,5146,7063,103479,103479,12209,103479,75,1085
OH,704,14060,0,961,182,379,74,180,197,0,B,10,182,485619,39620,407151,704,1900,149,140,13920,14764,14764,14060,14764,2,37
OK,164,805,0,961,59,379,759,180,197,0,A,5,59,485619,39620,407151,38775,1900,149,58,70,969,969,128,969,2,34
OR,209,4350,0,961,61,379,759,180,197,0,A,8,61,485619,39620,407151,38775,1900,149,0,0,4559,4559,0,4559,0,0
PA,1127,11193,0,961,5109,379,759,180,197,0,A,11,5109,485619,39620,407151,38775,1900,149,276,2550,12320,12320,2826,12320,4,0
PR,51,317,70,961,5109,379,759,180,197,0,A,2,5109,485619,39620,407151,38775,1900,149,12,49,438,368,61,368,0,0
RI,176,2124,196,15,5109,379,759,180,197,0,B,1400,5109,2410,195,2215,176,1900,149,28,173,2496,2300,201,2300,0,0
SC,424,2303,0,961,102,379,759,180,197,0,B,7,102,485619,39620,407151,38775,1900,149,126,291,2727,2727,417,2727,2,102
SD,41,819,268,961,5109,379,759,180,197,0,A,1,5109,485619,39620,407151,38775,1900,149,11,29,1128,860,40,860,0,0
TN,784,11012,0,961,53,379,759,180,197,0,A,3,53,485619,39620,407151,38775,1900,149,117,495,11796,11796,612,11796,1,53
TX,974,12520,0,961,5109,379,759,180,197,0,A,12,5109,485619,39620,407151,974,1900,149,564,1763,13494,13494,2327,13494,3,0
UT,346,6491,0,961,5109,379,759,180,197,0,A,1,5109,485619,39620,407151,346,1900,149,47,967,6837,6837,1014,6837,0,0
VA,391,4979,0,961,59,379,759,180,197,0,A,9,59,485619,39620,407151,38775,1900,149,101,799,5370,5370,900,5370,2,14
VI,17,55,2,961,5109,379,759,180,197,0,,1400,5109,485619,39620,407151,38775,1900,149,0,55,74,72,55,72,0,0
VT,160,1810,0,961,5109,379,759,180,197,0,A,8,5109,485619,39620,407151,160,1900,149,35,241,1970,1970,276,1970,1,0
WA,6329,56218,0,961,5109,379,759,180,197,0,A,159,5109,485619,39620,407151,4485,1900,149,406,4601,62547,62547,5007,62547,13,0
WI,667,10089,0,961,5109,379,759,180,197,0,A,7,5109,485619,39620,407151,585,1900,149,142,1852,10756,10756,1994,10756,2,0
WV,39,759,6,961,1,379,759,180,197,0,B,0,1,485619,39620,407151,38775,1900,149,19,149,804,798,168,798,0,0
WY,44,954,0,961,5109,379,759,180,197,7,A,1400,5109,485619,39620,407151,30,1900,149,15,244,998,998,259,998,0,0
AK,36,986,0,961,0,379,759,180,197,0,A,0,0,1022,39620,407151,36,1900,149,14,40,1022,1022,54,1022,0,0
AL,215,2106,0,74,5109,379,759,180,197,0,C,0,5109,485619,39620,407151,215,1900,149,48,441,2321,2321,489,2321,0,0
AR,218,947,0,22,5109,379,759,180,197,0,A,0,5109,485619,39620,407151,218,1900,149,44,41,1165,1165,85,1165,0,0
AS,,,0,961,5109,379,759,180,197,0,,0,5109,485619,39620,407151,0,1900,149,0,0,0,0,0,0,0,0
AZ,357,313,22,961,219,379,759,180,197,0,B,5,219,670,39620,407151,38775,1900,149,92,4,692,670,96,670,3,30
CA,2102,13452,12100,961,5109,379,759,180,197,0,B,40,5109,15554,39620,407151,38775,1900,149,369,885,27654,15554,1254,15554,13,0
CO,720,5504,0,116,72,379,759,180,197,0,A,7,72,485619,39620,407151,38775,1900,149,129,659,6224,6224,788,6224,1,14
CT,618,4682,0,71,5109,379,759,180,197,0,A,12,5109,485619,39620,407151,38775,1,149,203,597,5300,5300,800,5300,2,0
DC,137,1195,2,961,5109,379,759,180,197,0,A,2,5109,485619,39620,407151,38775,1900,149,21,82,1334,1332,103,1332,0,0
DE,91,36,0,961,5109,379,759,180,197,0,C,1,5109,485619,39620,407151,38775,1,0,23,0,127,127,23,127,1,0
FL,1412,13127,1008,961,259,379,759,180,197,0,A,18,259,485619,39620,407151,38775,1900,149,241,2064,15547,14539,2305,14539,4,42
GA,1026,4458,0,961,5109,379,759,180,197,0,A,32,5109,5484,39620,407151,38775,1900,149,254,161,5484,5484,415,5484,7,0
GU,32,201,0,5,5109,379,759,180,197,0,,1,5109,485619,39620,407151,38775,1900,149,3,40,233,233,43,233,0,0
HI,77,3589,0,961,4,379,759,180,197,0,A,1400,4,485619,39620,407151,38775,1900,149,21,634,3666,3666,655,3666,0,4
IA,124,2315,0,961,27,379,759,180,197,0,C,1400,27,485619,39620,407151,124,1900,149,19,272,2439,2439,291,2439,0,27
ID,50,1887,0,961,5109,379,759,180,197,0,A,0,5109,1937,39620,407151,38775,1900,149,3,578,1937,1937,581,1937,0,0
IL,1535,9934,0,961,5109,379,759,180,197,0,A,16,5109,485619,39620,407151,38775,1900,149,262,1351,11469,11469,1613,11469,4,0
IN,365,2566,0,961,1,379,759,180,197,0,B,12,1,485619,39620,407151,38775,1900,149,106,865,2931,2931,971,2931,5,0
KS,98,2086,0,961,5109,379,759,180,197,0,B,2,5109,485619,39620,407151,38775,1900,149,16,1669,2184,2184,1685,2184,0,0
KY,124,1762,0,961,5109,379,759,180,197,0,A,4,5109,485619,39620,407151,38775,1900,149,20,0,1886,1886,20,1886,1,0
LA,1388,7215,0,271,5109,379,759,180,197,0,A,46,5109,485619,39620,407151,38775,1900,149,216,2439,8603,8603,2655,8603,12,0
MA,1060,12714,0,961,94,379,759,180,197,0,B,26,94,485619,39620,407151,38775,1900,149,382,4451,13774,13774,4833,13774,9,15
MD,349,94,0,961,5109,379,759,180,197,0,D,5,5109,485619,39620,407151,38775,5,149,61,0,443,443,61,443,1,0
ME,125,3014,0,961,5109,379,759,180,197,0,A,1400,5109,485619,39620,407151,38775,1900,149,18,223,3139,3139,241,3139,0,0
MI,10155,6989,0,961,5109,379,759,180,197,0,D,86,5109,9356,2367,6989,11163,103,7,1093,1142,17144,17144,2235,17144,29,0
MN,444,5550,0,961,21,379,759,180,197,0,A,1,21,5994,39620,407151,38775,1900,149,51,1039,5994,5994,1090,5994,0,4
MO,183,369,0,961,5109,379,759,180,197,0,C,3,5109,6165,520,5639,38775,1900,149,0,0,552,552,0,552,0,0
MP,0,,0,961,5109,379,759,180,197,0,,0,5109,485619,39620,407151,38775,1900,149,0,0,0,0,0,0,0,0
MS,320,1552,0,961,86,379,759,180,197,0,B,1,86,485619,39620,407151,38775,1900,149,71,409,1872,1872,480,1872,0,53
MT,46,1643,0,961,5109,379,759,180,197,0,C,1400,5109,485619,39620,407151,38775,1900,149,12,497,1689,1689,509,1689,0,0
NC,398,8141,0,961,5109,379,759,180,197,0,A,0,5109,485619,39620,407151,38775,1900,149,101,0,8539,8539,101,8539,0,0
ND,34,1454,0,961,5,379,759,180,197,0,B,0,5,485619,39620,407151,38775,1900,149,4,101,1488,1488,105,1488,0,1
NE,52,975,0,961,5109,379,759,180,197,0,A,0,5109,485619,39620,407151,38775,1900,149,2,619,1027,1027,621,1027,0,0
NH,101,1447,869,961,11,379,759,180,197,0,B,1,11,485619,39620,407151,38775,1900,149,23,73,2417,1548,96,1548,1,11
NJ,3675,8325,45,961,5109,379,759,180,197,0,B,44,5109,485619,39620,407151,38775,1900,149,831,7966,12045,12000,8797,12000,17,0
NM,83,5890,0,961,5109,379,759,180,197,0,A,1400,5109,485619,39620,407151,38775,1900,149,18,569,5973,5973,587,5973,0,0
NV,278,3954,0,961,5109,379,759,180,197,0,A,13,5109,485619,39620,407151,38775,1900,149,33,464,4232,4232,497,4232,5,0
NY,25665,65605,0,3343,4041,379,759,180,197,0,B,210,4041,485619,39620,407151,38775,1900,149,4790,8191,91270,91270,12981,91270,96,916
OH,564,140,0,961,145,379,759,180,197,0,D,8,145,485619,39620,407151,564,1900,149,122,0,704,704,122,704,2,41
OK,106,735,0,961,25,379,759,180,197,0,A,3,25,485619,39620,407151,38775,1900,149,25,41,841,841,66,841,1,10
OR,209,4350,0,961,61,379,759,180,197,0,A,8,61,485619,39620,407151,38775,1900,149,18,701,4559,4559,719,4559,3,5
PA,851,8643,0,961,5109,379,759,180,197,0,A,7,5109,485619,39620,407151,38775,1900,149,207,2048,9494,9494,2255,9494,1,0
PR,39,268,42,961,5109,379,759,180,197,0,A,2,5109,485619,39620,407151,38775,1900,149,8,79,349,307,87,307,0,0
RI,148,1951,77,961,5109,379,759,180,197,0,B,1400,5109,2201,169,2032,148,1900,149,19,238,2176,2099,257,2099,0,0
SC,298,2012,0,961,5109,379,759,180,197,0,B,5,5109,485619,39620,407151,38775,1900,149,0,546,2310,2310,546,2310,0,0
SD,30,790,268,961,5109,379,759,180,197,0,A,1,5109,485619,39620,407151,38775,1900,149,2,28,1088,820,30,820,0,0
TN,667,10517,0,961,5109,379,759,180,197,0,A,2,5109,485619,39620,407151,38775,1900,149,52,7245,11184,11184,7297,11184,0,0
TX,410,10757,0,961,5109,379,759,180,197,0,A,9,5109,485619,39620,407151,410,1900,149,58,1054,11167,11167,1112,11167,1,0
UT,299,5524,0,961,5109,379,759,180,197,0,A,1,5109,485619,39620,407151,299,1900,149,42,734,5823,5823,776,5823,0,0
VA,290,4180,0,961,45,379,759,180,197,0,A,7,45,485619,39620,407151,38775,1900,149,36,737,4470,4470,773,4470,1,7
VI,17,,0,961,5109,379,759,180,197,0,,1400,5109,485619,39620,407151,38775,1900,149,0,0,17,17,0,17,0,0
VT,125,1569,0,961,5109,379,759,180,197,0,A,7,5109,485619,39620,407151,125,1900,149,28,145,1694,1694,173,1694,2,0
WA,5923,51617,0,961,5109,379,759,180,197,0,A,146,5109,485619,39620,407151,4047,1900,149,355,4872,57540,57540,5227,57540,9,0
WI,525,8237,0,961,5109,379,759,180,197,0,A,5,5109,485619,39620,407151,457,1900,149,59,1187,8762,8762,1246,8762,0,0
WV,20,610,0,961,1,379,759,180,197,0,B,0,1,485619,39620,407151,38775,1900,149,4,166,630,630,170,630,0,0
WY,29,710,0,961,5109,379,759,180,197,0,A,1400,5109,485619,39620,407151,27,1900,149,3,118,739,739,121,739,0,0
AK,22,946,0,961,0,379,759,180,197,0,A,0,0,968,39620,407151,22,1900,149,0,0,968,968,0,968,0,0
AL,167,1665,0,961,5109,379,759,180,197,0,C,0,5109,485619,39620,407151,167,1900,149,29,201,1832,1832,230,1832,0,0
AR,174,906,0,13,5109,379,759,180,197,0,A,0,5109,485619,39620,407151,174,1900,149,9,195,1080,1080,204,1080,0,0
AS,,,0,961,5109,379,759,180,197,0,,0,5109,485619,39620,407151,0,1900,149,0,0,0,0,0,0,0,0
AZ,265,309,6,961,189,379,759,180,197,0,B,2,189,574,39620,407151,38775,1900,149,113,27,580,574,140,574,0,44
CA,1733,12567,12100,961,5109,379,759,180,197,0,B,27,5109,14300,39620,407151,38775,1900,149,197,1263,26400,14300,1460,14300,0,0
CO,591,4845,0,74,58,379,759,180,197,0,A,6,58,485619,39620,407151,38775,1900,149,116,770,5436,5436,886,5436,1,9
CT,415,4085,0,54,5109,379,759,180,197,0,A,10,5109,485619,39620,407151,38775,1900,149,192,1208,4500,4500,1400,4500,5,0
DC,116,1113,0,961,5109,379,759,180,197,0,A,2,5109,485619,39620,407151,38775,1900,149,18,156,1229,1229,174,1229,1,0
DE,68,36,0,961,5109,379,759,180,197,0,C,0,5109,485619,39620,407151,38775,0,0,12,0,104,104,12,104,0,0
FL,1171,11063,860,961,217,379,759,180,197,0,A,14,217,485619,39620,407151,38775,1900,149,341,3073,13094,12234,3414,12234,1,32
GA,772,4297,0,961,5109,379,759,180,197,0,A,25,5109,5069,39620,407151,38775,1900,149,172,877,5069,5069,1049,5069,2,0
GU,29,161,0,961,5109,379,759,180,197,0,,1,5109,485619,39620,407151,38775,1900,149,2,35,190,190,37,190,0,0
HI,56,2955,0,961,5109,379,759,180,197,0,A,1400,5109,485619,39620,407151,38775,1900,149,8,2692,3011,3011,2700,3011,0,0
IA,105,2043,0,961,5109,379,759,180,197,0,C,1400,5109,485619,39620,407151,105,1900,149,15,828,2148,2148,843,2148,0,0
ID,47,1309,0,961,5109,379,759,180,197,0,A,0,5109,1356,39620,407151,38775,1900,149,5,134,1356,1356,139,1356,0,0
IL,1273,8583,0,961,5109,379,759,180,197,0,A,12,5109,485619,39620,407151,38775,1900,149,224,1312,9856,9856,1536,9856,3,0
IN,259,1701,0,961,1,379,759,180,197,0,B,7,1,485619,39620,407151,38775,1900,149,58,408,1960,1960,466,1960,1,0
KS,82,417,0,961,5109,379,759,180,197,0,B,2,5109,485619,39620,407151,38775,1900,149,18,0,499,499,18,499,0,0
KY,104,1762,0,961,5109,379,759,180,197,0,A,3,5109,485619,39620,407151,38775,1900,149,5,290,1866,1866,295,1866,0,0
LA,1172,4776,0,961,5109,379,759,180,197,0,B,34,5109,485619,39620,407151,38775,1900,149,335,2115,5948,5948,2450,5948,14,0
MA,678,8263,0,961,79,379,759,180,197,0,B,17,79,485619,39620,407151,38775,1900,149,131,2787,8941,8941,2918,8941,6,8
MD,288,94,0,961,5109,379,759,180,197,0,D,4,5109,485619,39620,407151,38775,4,149,44,0,382,382,44,382,0,0
ME,107,2791,0,961,5109,379,759,180,197,0,A,1400,5109,485619,39620,407151,38775,1900,149,18,527,2898,2898,545,2898,0,0
MI,9062,5847,0,961,5109,379,759,180,197,0,D,57,5109,7676,1829,5847,10006,79,3,1240,1056,14909,14909,2296,14909,21,0
MN,393,4511,0,961,17,379,759,180,197,0,A,1,17,4904,39620,407151,38775,1900,149,44,0,4904,4904,44,4904,0,5
MO,183,369,0,961,5109,379,759,180,197,0,C,3,5109,5455,441,5008,38775,1900,149,93,0,552,552,93,552,0,0
MP,0,,0,961,5109,379,759,180,197,0,,0,5109,485619,39620,407151,38775,1900,149,0,0,0,0,0,0,0,0
MS,249,1143,0,961,33,379,759,180,197,0,B,1,33,485619,39620,407151,38775,1900,149,42,29,1392,1392,71,1392,0,0
MT,34,1146,0,961,5109,379,759,180,197,0,C,1400,5109,485619,39620,407151,38775,1900,149,3,0,1180,1180,3,1180,0,0
NC,297,8141,0,961,5109,379,759,180,197,0,A,0,5109,485619,39620,407151,38775,1900,149,42,1958,8438,8438,2000,8438,0,0
ND,30,1353,0,961,4,379,759,180,197,0,B,0,4,485619,39620,407151,38775,1900,149,2,93,1383,1383,95,1383,0,1
NE,50,356,0,961,5109,379,759,180,197,0,A,0,5109,485619,39620,407151,38775,1900,149,2,0,406,406,2,406,0,0
NH,78,1374,889,961,5109,379,759,180,197,0,B,1400,5109,485619,39620,407151,38775,1900,149,13,186,2341,1452,199,1452,0,0
NJ,2844,359,94,961,5109,379,759,180,197,0,B,27,5109,485619,39620,407151,38775,1900,149,930,32,3297,3203,962,3203,7,0
NM,65,5321,0,961,5109,379,759,180,197,0,A,1400,5109,485619,39620,407151,38775,1900,149,8,599,5386,5386,607,5386,0,0
NV,245,3490,0,961,5109,379,759,180,197,0,A,8,5109,485619,39620,407151,38775,1900,149,55,1042,3735,3735,1097,3735,1,0
NY,20875,57414,0,2629,3125,379,759,180,197,0,B,114,3125,485619,39620,407151,38775,1900,149,5707,11181,78289,78289,16888,78289,0,771
OH,442,140,0,961,104,379,759,180,197,0,D,6,104,485619,39620,407151,442,1900,149,91,0,582,582,91,582,3,21
OK,81,694,102,961,15,379,759,180,197,0,A,2,15,485619,39620,407151,38775,1900,149,14,25,877,775,39,775,0,4
OR,191,3649,0,961,56,379,759,180,197,0,A,5,56,485619,39620,407151,38775,1900,149,30,785,3840,3840,815,3840,1,13
PA,644,6595,0,961,5109,379,759,180,197,0,A,6,5109,485619,39620,407151,38775,1900,149,165,1631,7239,7239,1796,7239,4,0
PR,31,189,35,961,5109,379,759,180,197,0,A,2,5109,485619,39620,407151,38775,1900,149,8,6,255,220,14,220,1,0
RI,129,1713,216,961,5109,379,759,180,197,0,B,1400,5109,1938,149,1789,129,1900,149,16,166,2058,1842,182,1842,0,0
SC,298,1466,0,961,5109,379,759,180,197,0,A,5,5109,485619,39620,407151,38775,1900,149,103,0,1764,1764,103,1764,2,0
SD,28,762,265,961,5109,379,759,180,197,0,A,1,5109,485619,39620,407151,38775,1900,149,7,22,1055,790,29,790,0,0
TN,615,3272,0,961,5109,379,759,180,197,0,B,2,5109,485619,39620,407151,38775,1900,149,110,0,3887,3887,110,3887,2,0
TX,352,9703,0,961,5109,379,759,180,197,0,A,8,5109,485619,39620,407151,352,1900,149,18,1281,10055,10055,1299,10055,3,0
UT,257,4790,0,961,5109,379,759,180,197,0,A,1,5109,485619,39620,407151,257,1900,149,76,1282,5047,5047,1358,5047,0,0
VA,254,3443,0,961,38,379,759,180,197,0,A,6,38,485619,39620,407151,38775,1900,149,35,325,3697,3697,360,3697,3,6
VI,17,,0,961,5109,379,759,180,197,0,,1400,5109,485619,39620,407151,38775,1900,149,11,0,17,17,11,17,0,0
VT,97,1424,0,961,5109,379,759,180,197,0,A,5,5109,485619,39620,407151,97,1900,149,21,220,1521,1521,241,1521,3,0
WA,5568,46745,0,961,5109,379,759,180,197,0,A,137,5109,485619,39620,407151,3612,1900,149,447,4856,52313,52313,5303,52313,11,0
WI,466,7050,0,961,5109,379,759,180,197,0,A,5,5109,485619,39620,407151,416,1900,149,41,820,7516,7516,861,7516,1,0
WV,16,444,4,961,1,379,759,180,197,0,B,0,1,485619,39620,407151,38775,1900,149,4,59,464,460,63,460,0,0
WY,26,592,0,961,5109,379,759,180,197,0,A,1400,5109,485619,39620,407151,26,1900,149,2,154,618,618,156,618,0,0
AK,22,946,0,961,0,379,759,180,197,0,,0,0,968,39620,407151,22,1900,149,8,188,968,968,196,968,0,0
AL,138,1464,0,961,5109,379,759,180,197,0,,0,5109,485619,39620,407151,138,1900,149,14,1436,1602,1602,1450,1602,0,0
AR,165,711,119,13,5109,379,759,180,197,0,,0,5109,485619,39620,407151,165,1900,149,47,144,995,876,191,876,0,0
AS,,,0,961,5109,379,759,180,197,0,,0,5109,485619,39620,407151,0,1900,149,0,0,0,0,0,0,0,0
AZ,152,282,87,961,145,379,759,180,197,0,,2,145,434,39620,407151,38775,1900,149,48,42,521,434,90,434,1,17
CA,1536,11304,0,961,5109,379,759,180,197,0,,27,5109,12840,39620,407151,38775,1900,149,257,55,12840,12840,312,12840,3,0
CO,475,4075,0,56,49,379,759,180,197,0,,5,49,485619,39620,407151,38775,1900,149,112,758,4550,4550,870,4550,1,5
CT,223,2877,0,43,5109,379,759,180,197,0,,5,5109,485619,39620,407151,38775,1900,149,29,771,3100,3100,800,3100,1,0
DC,98,957,0,961,5109,379,759,180,197,0,,1,5109,485619,39620,407151,38775,1900,149,21,451,1055,1055,472,1055,0,0
DE,56,36,0,961,5109,379,759,180,197,0,,0,5109,485619,39620,407151,38775,0,0,11,0,92,92,11,92,0,0
FL,830,7990,963,961,185,379,759,180,197,0,,13,185,485619,39620,407151,38775,1900,149,172,1411,9783,8820,1583,8820,1,27
GA,600,3420,0,961,5109,379,759,180,197,0,,23,5109,4020,39620,407151,38775,1900,149,93,863,4020,4020,956,4020,9,0
GU,27,126,0,961,5109,379,759,180,197,0,,1,5109,485619,39620,407151,38775,1900,149,12,18,153,153,30,153,1,0
HI,48,263,0,961,5109,379,759,180,197,0,,1400,5109,485619,39620,407151,38775,1900,149,11,139,311,311,150,311,0,0
IA,90,1215,0,961,5109,379,759,180,197,0,,1400,5109,485619,39620,407151,90,1900,149,22,166,1305,1305,188,1305,0,0
ID,42,1175,0,961,5109,379,759,180,197,0,,0,5109,1217,39620,407151,38775,1900,149,11,295,1217,1217,306,1217,0,0
IL,1049,7271,0,961,5109,379,759,180,197,0,,9,5109,485619,39620,407151,38775,1900,149,296,1783,8320,8320,2079,8320,3,0
IN,201,1293,0,961,1,379,759,180,197,0,,6,1,485619,39620,407151,38775,1900,149,75,586,1494,1494,661,1494,2,0
KS,64,417,0,961,5109,379,759,180,197,0,,2,5109,485619,39620,407151,38775,1900,149,9,0,481,481,9,481,0,0
KY,99,1472,0,961,5109,379,759,180,197,0,,3,5109,485619,39620,407151,38775,1900,149,45,758,1571,1571,803,1571,1,0
LA,837,2661,0,961,5109,379,759,180,197,0,,20,5109,485619,39620,407151,38775,1900,149,257,481,3498,3498,738,3498,4,0
MA,547,5476,0,961,71,379,759,180,197,0,,11,71,485619,39620,407151,38775,1900,149,121,677,6023,6023,798,6023,4,10
MD,244,94,0,961,5109,379,759,180,197,0,,4,5109,485619,39620,407151,38775,4,149,54,0,338,338,54,338,1,0
ME,89,2264,0,961,5109,379,759,180,197,0,,1400,5109,485619,39620,407151,38775,1900,149,16,0,2353,2353,16,2353,0,0
MI,7822,4791,0,961,5109,379,759,180,197,0,,36,5109,6223,1432,4791,8937,54,3,799,705,12613,12613,1504,12613,13,0
MN,349,4511,0,961,12,379,759,180,197,0,,1,12,4860,39620,407151,38775,1900,149,22,559,4860,4860,581,4860,0,12
MO,90,369,0,961,5109,379,759,180,197,0,,3,5109,4642,358,4278,38775,1900,149,17,0,459,459,17,459,0,0
MP,0,,0,961,5109,379,759,180,197,0,,0,5109,485619,39620,407151,38775,1900,149,0,0,0,0,0,0,0,0
MS,207,1114,0,961,33,379,759,180,197,0,,1,33,485619,39620,407151,38775,1900,149,67,419,1321,1321,486,1321,0,33
MT,31,1146,0,961,5109,379,759,180,197,0,,1400,5109,485619,39620,407151,38775,1900,149,11,0,1177,1177,11,1177,0,0
NC,255,6183,0,961,5109,379,759,180,197,0,,0,5109,485619,39620,407151,38775,1900,149,71,1091,6438,6438,1162,6438,0,0
ND,28,1260,0,961,3,379,759,180,197,0,,0,3,485619,39620,407151,38775,1900,149,0,119,1288,1288,119,1288,0,0
NE,48,356,0,961,5109,379,759,180,197,0,,0,5109,485619,39620,407151,38775,1900,149,10,0,404,404,10,404,0,0
NH,65,1188,959,961,5109,379,759,180,197,0,,1400,5109,485619,39620,407151,38775,1900,149,10,215,2212,1253,225,1253,0,0
NJ,1914,327,49,961,5109,379,759,180,197,0,,20,5109,485619,39620,407151,38775,1900,149,587,33,2290,2241,620,2241,4,0
NM,57,4722,0,961,5109,379,759,180,197,0,,1400,5109,485619,39620,407151,38775,1900,149,0,951,4779,4779,951,4779,0,0
NV,190,2448,0,961,5109,379,759,180,197,0,,7,5109,485619,39620,407151,38775,1900,149,66,64,2638,2638,130,2638,2,0
NY,15168,46233,0,2043,2354,379,759,180,197,0,,114,2354,485619,39620,407151,38775,1900,149,4812,11152,61401,61401,15964,61401,70,823
OH,351,140,0,961,83,379,759,180,197,0,,3,83,485619,39620,407151,351,1900,149,104,0,491,491,104,491,0,25
OK,67,669,102,961,11,379,759,180,197,0,,2,11,485619,39620,407151,38775,1900,149,14,109,838,736,123,736,1,1
OR,161,2864,0,961,43,379,759,180,197,0,,4,43,485619,39620,407151,38775,1900,149,47,861,3025,3025,908,3025,1,43
PA,479,4964,0,961,5109,379,759,180,197,0,,2,5109,485619,39620,407151,38775,1900,149,108,1198,5443,5443,1306,5443,0,0
PR,23,183,69,961,5109,379,759,180,197,0,,1,5109,485619,39620,407151,38775,1900,149,2,40,275,206,42,206,1,0
RI,113,1547,216,961,5109,379,759,180,197,0,,1400,5109,1755,135,1620,113,1900,149,25,263,1876,1660,288,1660,0,0
SC,195,1466,0,961,5109,379,759,180,197,0,,3,5109,485619,39620,407151,38775,1900,149,43,211,1661,1661,254,1661,2,0
SD,21,740,277,961,5109,379,759,180,197,0,,1,5109,485619,39620,407151,38775,1900,149,7,49,1038,761,56,761,0,0
TN,505,3272,0,961,5109,379,759,180,197,0,,1400,5109,485619,39620,407151,38775,1900,149,134,0,3777,3777,134,3777,0,0
TX,334,8422,0,961,5109,379,759,180,197,0,,5,5109,485619,39620,407151,334,1900,149,30,2204,8756,8756,2234,8756,0,0
UT,181,3508,0,961,5109,379,759,180,197,0,,1,5109,485619,39620,407151,181,1900,149,45,1084,3689,3689,1129,3689,1,0
VA,219,3118,0,961,32,379,759,180,197,0,,3,32,485619,39620,407151,38775,1900,149,67,480,3337,3337,547,3337,1,7
VI,6,,0,961,5109,379,759,180,197,0,,1400,5109,485619,39620,407151,38775,1900,149,0,0,6,6,0,6,0,0
VT,76,1204,0,961,5109,379,759,180,197,0,,2,5109,485619,39620,407151,76,1900,149,24,124,1280,1280,148,1280,0,0
WA,5121,41889,0,961,5109,379,759,180,197,0,,126,5109,485619,39620,407151,3149,1900,149,284,1604,47010,47010,1888,47010,15,0
WI,425,6230,0,961,5109,379,759,180,197,0,,4,5109,485619,39620,407151,385,1900,149,110,1602,6655,6655,1712,6655,0,0
WV,12,385,1,961,1,379,759,180,197,0,,0,1,485619,39620,407151,38775,1900,149,1,55,398,397,56,397,0,0
WY,24,438,0,961,5109,379,759,180,197,0,,1400,5109,485619,39620,407151,23,1900,149,1,0,462,462,1,462,0,0
AK,14,758,0,961,0,379,759,180,197,0,,0,0,772,39620,407151,14,1900,149,2,72,772,772,74,772,0,0
AL,124,28,0,961,5109,379,759,180,197,0,,0,5109,485619,39620,407151,124,1900,149,43,0,152,152,43,152,0,0
AR,118,567,154,961,5109,379,759,180,197,0,,1400,5109,485619,39620,407151,118,1900,149,22,216,839,685,238,685,0,0
AS,,,0,961,5109,379,759,180,197,0,,0,5109,485619,39620,407151,0,1900,149,0,0,0,0,0,0,0,0
AZ,104,240,122,961,128,379,759,180,197,0,,1,128,344,39620,407151,38775,1900,149,39,29,466,344,68,344,1,20
CA,1279,11249,0,961,5109,379,759,180,197,0,,24,5109,12528,39620,407151,38775,1900,149,216,825,12528,12528,1041,12528,4,0
CO,363,3317,0,961,44,379,759,180,197,0,,4,44,485619,39620,407151,38775,1900,149,86,642,3680,3680,728,3680,1,44
CT,194,2106,0,961,5109,379,759,180,197,0,,4,5109,485619,39620,407151,38775,1900,149,0,1502,2300,2300,1502,2300,1,0
DC,77,506,0,961,5109,379,759,180,197,0,,1,5109,485619,39620,407151,38775,1900,149,6,5,583,583,11,583,0,0
DE,45,36,0,961,5109,379,759,180,197,0,,0,5109,485619,39620,407151,38775,0,0,7,0,81,81,7,81,0,0
FL,658,6579,1002,961,158,379,759,180,197,0,,12,158,485619,39620,407151,38775,1900,149,138,4709,8239,7237,4847,7237,2,158
GA,507,2557,0,961,5109,379,759,180,197,0,,14,5109,3064,39620,407151,38775,1900,149,87,591,3064,3064,678,3064,1,0
GU,15,108,0,961,5109,379,759,180,197,0,,1400,5109,485619,39620,407151,38775,1900,149,1,22,123,123,23,123,0,0
HI,37,124,0,961,5109,379,759,180,197,0,,1400,5109,485619,39620,407151,38775,1900,149,11,0,161,161,11,161,0,0
IA,68,1049,0,961,5109,379,759,180,197,0,,1400,5109,485619,39620,407151,68,1900,149,23,407,1117,1117,430,1117,0,0
ID,31,880,0,961,5109,379,759,180,197,0,,1400,5109,911,39620,407151,38775,1900,149,8,290,911,911,298,911,0,0
IL,753,5488,0,961,5109,379,759,180,197,0,,6,5109,485619,39620,407151,38775,1900,149,168,1792,6241,6241,1960,6241,1,0
IN,126,707,0,961,1,379,759,180,197,0,,4,1,485619,39620,407151,38775,1900,149,47,232,833,833,279,833,2,1
KS,55,417,0,961,5109,379,759,180,197,0,,2,5109,485619,39620,407151,38775,1900,149,11,0,472,472,11,472,1,0
KY,54,714,0,961,5109,379,759,180,197,0,,2,5109,485619,39620,407151,38775,1900,149,7,122,768,768,129,768,1,0
LA,580,2180,0,961,5109,379,759,180,197,0,,16,5109,485619,39620,407151,38775,1900,149,107,1612,2760,2760,1719,2760,4,0
MA,426,4799,0,961,61,379,759,180,197,0,,7,61,485619,39620,407151,38775,1900,149,112,1004,5225,5225,1116,5225,2,61
MD,190,94,0,961,5109,379,759,180,197,0,,3,5109,485619,39620,407151,38775,3,149,41,0,284,284,41,284,0,0
ME,73,2264,0,961,5109,379,759,180,197,0,,1400,5109,485619,39620,407151,38775,1900,149,16,0,2337,2337,16,2337,0,0
MI,7023,4086,0,961,5109,379,759,180,197,0,,23,5109,5203,1117,4086,7726,33,3,804,1045,11109,11109,1849,11109,10,0
MN,327,3952,0,961,5109,379,759,180,197,0,,1,5109,4279,39620,407151,38775,1900,149,24,211,4279,4279,235,4279,1,0
MO,73,369,0,961,5109,379,759,180,197,0,,3,5109,3455,250,3201,38775,1900,149,26,0,442,442,26,442,2,0
MP,0,,0,961,5109,379,759,180,197,0,,0,5109,485619,39620,407151,38775,1900,149,0,0,0,0,0,0,0,0
MS,140,695,0,961,5109,379,759,180,197,0,,1,5109,485619,39620,407151,38775,1900,149,60,0,835,835,60,835,0,0
MT,20,1146,0,961,5109,379,759,180,197,0,,1400,5109,485619,39620,407151,38775,1900,149,4,215,1166,1166,219,1166,0,0
NC,184,5092,0,961,5109,379,759,180,197,0,,0,5109,485619,39620,407151,38775,1900,149,47,1996,5276,5276,2043,5276,0,0
ND,28,1141,0,961,3,379,759,180,197,0,,0,3,485619,39620,407151,38775,1900,149,8,341,1169,1169,349,1169,0,3
NE,38,356,0,961,5109,379,759,180,197,0,,0,5109,485619,39620,407151,38775,1900,149,6,116,394,394,122,394,0,0
NH,55,973,942,961,5109,379,759,180,197,0,,1400,5109,485619,39620,407151,38775,1900,149,11,228,1970,1028,239,1028,0,0
NJ,1327,294,40,961,5109,379,759,180,197,0,,16,5109,485619,39620,407151,38775,1900,149,437,30,1661,1621,467,1621,5,0
NM,57,3771,0,961,5109,379,759,180,197,0,,1400,5109,485619,39620,407151,38775,1900,149,14,0,3828,3828,14,3828,0,0
NV,124,2384,0,961,5109,379,759,180,197,0,,5,5109,485619,39620,407151,38775,1900,149,15,392,2508,2508,407,2508,2,0
NY,10356,35081,0,1436,1531,379,759,180,197,0,,44,1531,485619,39620,407151,38775,1900,149,3254,9756,45437,45437,13010,45437,9,1531
OH,247,140,0,961,58,379,759,180,197,0,,3,58,485619,39620,407151,247,1900,149,78,0,387,387,78,387,2,58
OK,53,560,144,961,10,379,759,180,197,0,,1,10,485619,39620,407151,38775,1900,149,4,22,757,613,26,613,0,10
OR,114,2003,433,961,5109,379,759,180,197,0,,3,5109,485619,39620,407151,38775,1900,149,0,0,2550,2117,0,2117,0,0
PA,371,3766,0,961,5109,379,759,180,197,0,,2,5109,485619,39620,407151,38775,1900,149,103,1192,4137,4137,1295,4137,1,0
PR,21,143,71,961,5109,379,759,180,197,0,,1400,5109,485619,39620,407151,38775,1900,149,7,29,235,164,36,164,0,0
RI,88,1284,290,961,5109,379,759,180,197,0,,1400,5109,1443,105,1338,88,1900,149,14,123,1662,1372,137,1372,0,0
SC,152,1255,0,961,5109,379,759,180,197,0,,1,5109,485619,39620,407151,38775,1900,149,71,422,1407,1407,493,1407,0,0
SD,14,691,268,961,5109,379,759,180,197,0,,1,5109,485619,39620,407151,38775,1900,149,0,28,973,705,28,705,0,0
TN,371,3272,0,961,5109,379,759,180,197,0,,1400,5109,485619,39620,407151,38775,1900,149,143,2709,3643,3643,2852,3643,0,0
TX,304,6218,0,961,5109,379,759,180,197,0,,5,5109,485619,39620,407151,304,1900,149,110,1135,6522,6522,1245,6522,0,0
UT,136,2424,0,961,5109,379,759,180,197,0,,0,5109,485619,39620,407151,136,1900,149,24,389,2560,2560,413,2560,0,0
VA,152,2638,0,961,25,379,759,180,197,0,,2,25,485619,39620,407151,38775,1900,149,38,427,2790,2790,465,2790,0,25
VI,6,,0,961,5109,379,759,180,197,0,,1400,5109,485619,39620,407151,38775,1900,149,3,0,6,6,3,6,0,0
VT,52,1080,0,961,5109,379,759,180,197,0,,2,5109,485619,39620,407151,52,1900,149,8,123,1132,1132,131,1132,0,0
WA,4837,40285,0,961,5109,379,759,180,197,0,,111,5109,485619,39620,407151,2965,1900,149,286,2056,45122,45122,2342,45122,7,0
WI,315,4628,0,961,5109,379,759,180,197,0,,4,5109,485619,39620,407151,281,1900,149,80,1173,4943,4943,1253,4943,1,0
WV,11,330,2,961,1,379,759,180,197,0,,0,1,485619,39620,407151,38775,1900,149,4,111,343,341,115,341,0,1
WY,23,438,0,961,5109,379,759,180,197,0,,1400,5109,485619,39620,407151,20,1900,149,4,107,461,461,111,461,0,0
AK,12,686,0,961,5109,379,759,180,197,0,,0,5109,698,39620,407151,12,1900,149,6,254,698,698,260,698,0,0
AL,81,28,0,961,5109,379,759,180,197,0,,0,5109,485619,39620,407151,81,1900,149,13,0,109,109,13,109,0,0
AR,96,351,203,961,5109,379,759,180,197,0,,1400,5109,485619,39620,407151,96,1900,149,50,41,650,447,91,447,0,0
AS,,,0,961,5109,379,759,180,197,0,,0,5109,485619,39620,407151,0,1900,149,0,0,0,0,0,0,0,0
AZ,65,211,101,961,108,379,759,180,197,0,,0,108,276,39620,407151,38775,1900,149,21,36,377,276,57,276,0,23
CA,1063,10424,0,961,5109,379,759,180,197,0,,20,5109,11487,39620,407151,38775,1900,149,139,1637,11487,11487,1776,11487,2,0
CO,277,2675,0,961,5109,379,759,180,197,0,,3,5109,485619,39620,407151,38775,1900,149,61,563,2952,2952,624,2952,1,0
CT,194,604,0,961,5109,379,759,180,197,0,,3,5109,485619,39620,407151,38775,1900,149,98,0,798,798,98,798,2,0
DC,71,501,1,961,5109,379,759,180,197,0,,1,5109,485619,39620,407151,38775,1900,149,32,348,573,572,380,572,1,0
DE,38,36,0,961,5109,379,759,180,197,0,,0,5109,485619,39620,407151,38775,0,0,8,0,74,74,8,74,0,0
FL,520,1870,1026,961,5109,379,759,180,197,0,,10,5109,485619,39620,407151,38775,1900,149,130,337,3416,2390,467,2390,2,0
GA,420,1966,0,961,5109,379,759,180,197,0,,13,5109,2386,39620,407151,38775,1900,149,133,422,2386,2386,555,2386,3,0
GU,14,86,0,961,5109,379,759,180,197,0,,1400,5109,485619,39620,407151,38775,1900,149,2,17,100,100,19,100,0,0
HI,26,124,0,961,5109,379,759,180,197,0,,1400,5109,485619,39620,407151,38775,1900,149,10,31,150,150,41,150,0,0
IA,45,642,0,961,5109,379,759,180,197,0,,1400,5109,485619,39620,407151,45,1900,149,7,559,687,687,566,687,0,0
ID,23,590,0,961,5109,379,759,180,197,0,,1400,5109,613,39620,407151,38775,1900,149,12,131,613,613,143,613,0,0
IL,585,3696,0,961,5109,379,759,180,197,0,,5,5109,485619,39620,407151,38775,1900,149,163,971,4281,4281,1134,4281,1,0
IN,79,475,0,961,5109,379,759,180,197,0,,2,5109,485619,39620,407151,38775,1900,149,23,151,554,554,174,554,0,0
KS,44,417,0,961,5109,379,759,180,197,0,,1,5109,485619,39620,407151,38775,1900,149,10,0,461,461,10,461,0,0
KY,47,592,0,961,5109,379,759,180,197,0,,1,5109,485619,39620,407151,38775,1900,149,12,138,639,639,150,639,0,0
LA,473,568,0,961,5109,379,759,180,197,0,,12,5109,485619,39620,407151,38775,1900,149,126,110,1041,1041,236,1041,4,0
MA,314,3795,0,961,5109,379,759,180,197,0,,5,5109,485619,39620,407151,38775,1900,149,85,877,4109,4109,962,4109,2,0
MD,149,94,0,961,5109,379,759,180,197,0,,3,5109,485619,39620,407151,38775,3,149,42,0,243,243,42,243,1,0
ME,57,2264,0,961,5109,379,759,180,197,0,,1400,5109,485619,39620,407151,38775,1900,149,4,260,2321,2321,264,2321,0,0
MI,6219,3041,0,961,5109,379,759,180,197,0,,13,5109,3845,804,3041,6938,20,2,943,990,9260,9260,1933,9260,3,0
MN,303,3741,0,961,5109,379,759,180,197,0,,1400,5109,4044,39620,407151,38775,1900,149,16,792,4044,4044,808,4044,0,0
MO,47,369,0,961,5109,379,759,180,197,0,,1,5109,2327,176,2148,38775,1900,149,23,61,416,416,84,416,0,0
MP,0,,0,961,5109,379,759,180,197,0,,0,5109,485619,39620,407151,38775,1900,149,0,0,0,0,0,0,0,0
MS,80,695,0,961,5109,379,759,180,197,0,,1,5109,485619,39620,407151,38775,1900,149,30,143,775,775,173,775,1,0
MT,16,931,0,961,5109,379,759,180,197,0,,1400,5109,485619,39620,407151,38775,1900,149,4,170,947,947,174,947,0,0
NC,137,3096,0,961,5109,379,759,180,197,0,,0,5109,485619,39620,407151,38775,1900,149,40,688,3233,3233,728,3233,0,0
ND,20,800,0,961,5109,379,759,180,197,0,,0,5109,485619,39620,407151,38775,1900,149,5,307,820,820,312,820,0,0
NE,32,240,0,961,5109,379,759,180,197,0,,0,5109,485619,39620,407151,38775,1900,149,5,0,272,272,5,272,0,0
NH,44,745,631,961,5109,379,759,180,197,0,,1400,5109,485619,39620,407151,38775,1900,149,5,124,1420,789,129,789,0,0
NJ,890,264,86,961,5109,379,759,180,197,0,,11,5109,485619,39620,407151,38775,1900,149,148,54,1240,1154,202,1154,2,0
NM,43,3771,0,961,5109,379,759,180,197,0,,1400,5109,485619,39620,407151,38775,1900,149,8,1009,3814,3814,1017,3814,0,0
NV,109,1992,0,961,5109,379,759,180,197,0,,3,5109,485619,39620,407151,38775,1900,149,14,366,2101,2101,380,2101,0,0
NY,7102,25325,0,1042,5109,379,759,180,197,0,,35,5109,485619,39620,407151,38775,1900,149,2950,7193,32427,32427,10143,32427,23,0
OH,169,140,0,961,5109,379,759,180,197,0,,1,5109,485619,39620,407151,169,1900,149,50,0,309,309,50,309,1,0
OK,49,538,374,961,5109,379,759,180,197,0,,1,5109,485619,39620,407151,38775,1900,149,5,72,961,587,77,587,0,0
OR,114,2003,433,961,5109,379,759,180,197,0,,3,5109,485619,39620,407151,38775,1900,149,26,674,2550,2117,700,2117,0,0
PA,268,2574,0,961,5109,379,759,180,197,0,,1,5109,485619,39620,407151,38775,1900,149,83,966,2842,2842,1049,2842,0,0
PR,14,114,52,961,5109,379,759,180,197,0,,1400,5109,485619,39620,407151,38775,1900,149,9,58,180,128,67,128,0,0
RI,74,1161,140,961,5109,379,759,180,197,0,,1400,5109,1296,84,1212,74,1900,149,13,193,1375,1235,206,1235,0,0
SC,81,833,0,961,5109,379,759,180,197,0,,1,5109,485619,39620,407151,38775,1900,149,21,250,914,914,271,914,0,0
SD,14,663,270,961,5109,379,759,180,197,0,,1,5109,485619,39620,407151,38775,1900,149,3,112,947,677,115,677,0,0
TN,228,563,0,961,5109,379,759,180,197,0,,1400,5109,485619,39620,407151,38775,1900,149,74,214,791,791,288,791,0,0
TX,194,5083,0,961,5109,379,759,180,197,0,,5,5109,485619,39620,407151,194,1900,149,51,2871,5277,5277,2922,5277,2,0
UT,112,2035,0,961,5109,379,759,180,197,0,,0,5109,485619,39620,407151,112,1900,149,34,587,2147,2147,621,2147,0,0
VA,114,2211,0,961,5109,379,759,180,197,0,,2,5109,485619,39620,407151,38775,1900,149,20,382,2325,2325,402,2325,0,0
VI,3,,0,961,5109,379,759,180,197,0,,1400,5109,485619,39620,407151,38775,1900,149,0,0,3,3,0,3,0,0
VT,44,957,0,961,5109,379,759,180,197,0,,2,5109,485619,39620,407151,38775,1900,149,16,193,1001,1001,209,1001,2,0
WA,4551,38229,0,961,5109,379,759,180,197,0,,104,5109,485619,39620,407151,2771,1900,149,405,3656,42780,42780,4061,42780,12,0
WI,235,3455,0,961,5109,379,759,180,197,0,,3,5109,485619,39620,407151,206,1900,149,61,1263,3690,3690,1324,3690,3,0
WV,7,219,13,961,5109,379,759,180,197,0,,0,5109,485619,39620,407151,38775,1900,149,5,76,239,226,81,226,0,0
WY,19,331,0,961,5109,379,759,180,197,0,,1400,5109,485619,39620,407151,18,1900,149,1,60,350,350,61,350,0,0
AK,6,432,0,961,5109,379,759,180,197,0,,0,5109,438,39620,407151,6,1900,149,0,26,438,438,26,438,0,0
AL,68,28,0,961,5109,379,759,180,197,0,,0,5109,485619,39620,407151,68,1900,149,22,0,96,96,22,96,0,0
AR,46,310,113,961,5109,379,759,180,197,0,,1400,5109,485619,39620,407151,46,1900,149,13,74,469,356,87,356,0,0
AS,,,0,961,5109,379,759,180,197,0,,0,5109,485619,39620,407151,0,1900,149,0,0,0,0,0,0,0,0
AZ,44,175,130,961,85,379,759,180,197,0,,0,85,219,39620,407151,38775,1900,149,16,27,349,219,43,219,0,18
CA,924,8787,0,961,5109,379,759,180,197,0,,18,5109,9711,39620,407151,38775,1900,149,313,806,9711,9711,1119,9711,5,0
CO,216,2112,0,961,5109,379,759,180,197,0,,2,5109,485619,39620,407151,38775,1900,149,33,495,2328,2328,528,2328,0,0
CT,96,604,0,961,5109,379,759,180,197,0,,1,5109,485619,39620,407151,38775,1900,149,28,479,700,700,507,700,1,0
DC,39,153,11,961,5109,379,759,180,197,0,,0,5109,485619,39620,407151,38775,1900,149,8,15,203,192,23,192,0,0
DE,30,36,0,961,5109,379,759,180,197,0,,0,5109,485619,39620,407151,38775,0,0,5,0,66,66,5,66,0,0
FL,390,1533,1019,961,5109,379,759,180,197,0,,8,5109,485619,39620,407151,38775,1900,149,76,308,2942,1923,384,1923,1,0
GA,287,1544,0,961,5109,379,759,180,197,0,,10,5109,1831,39620,407151,38775,1900,149,90,233,1831,1831,323,1831,9,0
GU,12,69,0,961,5109,379,759,180,197,0,,1400,5109,485619,39620,407151,38775,1900,149,4,12,81,81,16,81,0,0
HI,16,93,0,961,5109,379,759,180,197,0,,1400,5109,485619,39620,407151,38775,1900,149,2,0,109,109,2,109,0,0
IA,38,83,0,961,5109,379,759,180,197,0,,1400,5109,485619,39620,407151,38,1900,149,9,0,121,121,9,121,0,0
ID,11,459,0,961,5109,379,759,180,197,0,,1400,5109,470,39620,407151,38775,1900,149,2,0,470,470,2,470,0,0
IL,422,2725,0,961,5109,379,759,180,197,0,,4,5109,485619,39620,407151,38775,1900,149,134,962,3147,3147,1096,3147,3,0
IN,56,324,0,961,5109,379,759,180,197,0,,2,5109,485619,39620,407151,38775,1900,149,17,170,380,380,187,380,0,0
KS,34,417,0,961,5109,379,759,180,197,0,,1,5109,485619,39620,407151,38775,1900,149,18,0,451,451,18,451,0,0
KY,35,454,0,961,5109,379,759,180,197,0,,1,5109,485619,39620,407151,38775,1900,149,9,100,489,489,109,489,0,0
LA,347,458,0,961,5109,379,759,180,197,0,,8,5109,485619,39620,407151,38775,1900,149,107,123,805,805,230,805,2,0
MA,229,2918,0,961,5109,379,759,180,197,0,,3,5109,485619,39620,407151,38775,1900,149,73,803,3147,3147,876,3147,1,0
MD,107,94,0,961,5109,379,759,180,197,0,,2,5109,485619,39620,407151,38775,2,149,22,0,201,201,22,201,0,0
ME,53,2004,0,961,5109,379,759,180,197,0,,1400,5109,485619,39620,407151,38775,1900,149,10,334,2057,2057,344,2057,0,0
MI,5276,2051,0,961,5109,379,759,180,197,0,,10,5109,2590,539,2051,6150,11,1,745,573,7327,7327,1318,7327,5,0
MN,287,2949,0,961,5109,379,759,180,197,0,,1400,5109,3236,39620,407151,38775,1900,149,18,264,3236,3236,282,3236,0,0
MO,24,308,0,961,5109,379,759,180,197,0,,1,5109,1530,120,1409,38775,1900,149,11,55,332,332,66,332,1,0
MP,0,,0,961,5109,379,759,180,197,0,,0,5109,485619,39620,407151,38775,1900,149,0,0,0,0,0,0,0,0
MS,50,552,0,961,5109,379,759,180,197,0,,1400,5109,485619,39620,407151,38775,1900,149,16,73,602,602,89,602,0,0
MT,12,761,0,961,5109,379,759,180,197,0,,1400,5109,485619,39620,407151,38775,1900,149,2,262,773,773,264,773,0,0
NC,97,2408,0,961,5109,379,759,180,197,0,,0,5109,485619,39620,407151,38775,1900,149,34,621,2505,2505,655,2505,0,0
ND,15,493,0,961,5109,379,759,180,197,0,,0,5109,485619,39620,407151,38775,1900,149,9,225,508,508,234,508,0,0
NE,27,240,0,961,5109,379,759,180,197,0,,0,5109,485619,39620,407151,38775,1900,149,3,34,267,267,37,267,0,0
NH,39,621,231,961,5109,379,759,180,197,0,,1400,5109,485619,39620,407151,38775,1900,149,13,108,891,660,121,660,0,0
NJ,742,210,74,961,5109,379,759,180,197,0,,9,5109,485619,39620,407151,38775,1900,149,315,20,1026,952,335,952,4,0
NM,35,2762,0,961,5109,379,759,180,197,0,,1400,5109,485619,39620,407151,38775,1900,149,7,436,2797,2797,443,2797,0,0
NV,95,1626,0,961,5109,379,759,180,197,0,,3,5109,485619,39620,407151,38775,1900,149,40,1458,1721,1721,1498,1721,1,0
NY,4152,18132,0,617,5109,379,759,180,197,0,,12,5109,485619,39620,407151,38775,1900,149,1770,5917,22284,22284,7687,22284,0,0
OH,119,140,0,961,5109,379,759,180,197,0,,1400,5109,485619,39620,407151,119,1900,149,31,0,259,259,31,259,0,0
OK,44,466,250,961,5109,379,759,180,197,0,,1,5109,485619,39620,407151,38775,1900,149,15,88,760,510,103,510,1,0
OR,88,1329,437,961,5109,379,759,180,197,0,,3,5109,485619,39620,407151,38775,1900,149,13,211,1854,1417,224,1417,0,0
PA,185,1608,0,961,5109,379,759,180,197,0,,1,5109,485619,39620,407151,38775,1900,149,52,421,1793,1793,473,1793,0,0
PR,5,56,29,961,5109,379,759,180,197,0,,1400,5109,485619,39620,407151,38775,1900,149,0,25,90,61,25,61,0,0
RI,61,968,334,961,5109,379,759,180,197,0,,1400,5109,1084,69,1015,61,1900,149,17,249,1363,1029,266,1029,0,0
SC,60,583,0,961,5109,379,759,180,197,0,,1,5109,485619,39620,407151,38775,1900,149,0,0,643,643,0,643,0,0
SD,11,551,385,961,5109,379,759,180,197,0,,1,5109,485619,39620,407151,38775,1900,149,0,0,947,562,0,562,0,0
TN,154,349,0,961,5109,379,759,180,197,0,,1400,5109,485619,39620,407151,38775,1900,149,56,0,503,503,56,503,0,0
TX,143,2212,0,961,5109,379,759,180,197,0,,3,5109,485619,39620,407151,143,1900,149,60,388,2355,2355,448,2355,1,0
UT,78,1448,0,961,5109,379,759,180,197,0,,0,5109,485619,39620,407151,78,1900,149,15,1317,1526,1526,1332,1526,0,0
VA,94,1829,0,961,5109,379,759,180,197,0,,2,5109,485619,39620,407151,38775,1900,149,17,628,1923,1923,645,1923,1,0
VI,3,,0,961,5109,379,759,180,197,0,,1400,5109,485619,39620,407151,38775,1900,149,1,0,3,3,1,3,0,0
VT,28,764,0,961,5109,379,759,180,197,0,,1400,5109,485619,39620,407151,38775,1900,149,7,127,792,792,134,792,0,0
WA,4146,34573,0,961,5109,379,759,180,197,0,,92,5109,485619,39620,407151,2467,1900,149,336,4214,38719,38719,4550,38719,10,0
WI,174,2192,0,961,5109,379,759,180,197,0,,1400,5109,485619,39620,407151,155,1900,149,53,615,2366,2366,668,2366,0,0
WV,2,143,3,961,5109,379,759,180,197,0,,0,5109,485619,39620,407151,38775,1900,149,1,21,148,145,22,145,0,0
WY,18,271,0,961,5109,379,759,180,197,0,,1400,5109,485619,39620,407151,16,1900,149,3,93,289,289,96,289,0,0
AK,6,406,0,961,5109,379,759,180,197,0,,0,5109,412,39620,407151,6,1900,149,3,72,412,412,75,412,0,0
AL,46,28,0,961,5109,379,759,180,197,0,,0,5109,485619,39620,407151,46,1900,149,10,0,74,74,10,74,0,0
AR,33,236,50,961,5109,379,759,180,197,0,,1400,5109,485619,39620,407151,33,1900,149,11,39,319,269,50,269,0,0
AS,,,0,961,5109,379,759,180,197,0,,0,5109,485619,39620,407151,0,1900,149,0,0,0,0,0,0,0,0
AZ,28,148,102,961,67,379,759,180,197,0,,0,67,176,39620,407151,38775,1900,149,8,6,278,176,14,176,0,12
CA,611,7981,0,961,5109,379,759,180,197,0,,13,5109,8592,39620,407151,38775,1900,149,128,0,8592,8592,128,8592,2,0
CO,183,1617,0,961,5109,379,759,180,197,0,,2,5109,485619,39620,407151,38775,1900,149,23,561,1800,1800,584,1800,1,0
CT,68,125,0,961,5109,379,759,180,197,0,,1400,5109,485619,39620,407151,38775,1900,149,27,0,193,193,27,193,0,0
DC,31,138,1,961,5109,379,759,180,197,0,,1400,5109,485619,39620,407151,38775,1900,149,9,34,170,169,43,169,0,0
DE,25,36,0,961,5109,379,759,180,197,0,,0,5109,485619,39620,407151,38775,0,0,9,0,61,61,9,61,0,0
FL,314,1225,954,961,5109,379,759,180,197,0,,7,5109,485619,39620,407151,38775,1900,149,128,285,2493,1539,413,1539,1,0
GA,197,1311,0,961,5109,379,759,180,197,0,,1,5109,1508,39620,407151,38775,1900,149,51,1311,1508,1508,1362,1508,0,0
GU,8,57,0,961,5109,379,759,180,197,0,,1400,5109,485619,39620,407151,38775,1900,149,3,16,65,65,19,65,0,0
HI,14,93,0,961,5109,379,759,180,197,0,,1400,5109,485619,39620,407151,38775,1900,149,4,93,107,107,97,107,0,0
IA,29,83,0,961,5109,379,759,180,197,0,,1400,5109,485619,39620,407151,29,1900,149,6,0,112,112,6,112,0,0
ID,9,459,0,961,5109,379,759,180,197,0,,1400,5109,468,39620,407151,38775,1900,149,2,113,468,468,115,468,0,0
IL,288,1763,0,961,5109,379,759,180,197,0,,1,5109,485619,39620,407151,38775,1900,149,129,423,2051,2051,552,2051,0,0
IN,39,154,0,961,5109,379,759,180,197,0,,2,5109,485619,39620,407151,38775,1900,149,9,25,193,193,34,193,0,0
KS,16,417,0,961,5109,379,759,180,197,0,,1,5109,485619,39620,407151,38775,1900,149,1,35,433,433,36,433,0,0
KY,26,354,0,961,5109,379,759,180,197,0,,1,5109,485619,39620,407151,38775,1900,149,4,59,380,380,63,380,0,0
LA,240,335,0,961,5109,379,759,180,197,0,,6,5109,485619,39620,407151,38775,1900,149,103,49,575,575,152,575,2,0
MA,156,2115,0,961,5109,379,759,180,197,0,,2,5109,485619,39620,407151,38775,1900,149,38,482,2271,2271,520,2271,2,0
MD,85,94,0,961,5109,379,759,180,197,0,,2,5109,485619,39620,407151,38775,2,149,28,0,179,179,28,179,2,0
ME,43,1670,0,961,5109,379,759,180,197,0,,1400,5109,485619,39620,407151,38775,1900,149,11,367,1713,1713,378,1713,0,0
MI,4531,1478,0,961,5109,379,759,180,197,0,,5,5109,1852,374,1478,5221,9,1,872,599,6009,6009,1471,6009,3,0
MN,269,2685,0,961,5109,379,759,180,197,0,,1400,5109,2954,39620,407151,38775,1900,149,23,409,2954,2954,432,2954,0,0
MO,13,253,0,961,5109,379,759,180,197,0,,0,5109,845,70,774,38775,1900,149,5,46,266,266,51,266,0,0
MP,0,,0,961,5109,379,759,180,197,0,,0,5109,485619,39620,407151,38775,1900,149,0,0,0,0,0,0,0,0
MS,34,479,0,961,5109,379,759,180,197,0,,1400,5109,485619,39620,407151,38775,1900,149,13,111,513,513,124,513,0,0
MT,10,499,0,961,5109,379,759,180,197,0,,1400,5109,485619,39620,407151,38775,1900,149,2,196,509,509,198,509,0,0
NC,63,1787,0,961,5109,379,759,180,197,0,,0,5109,485619,39620,407151,38775,1900,149,23,1313,1850,1850,1336,1850,0,0
ND,6,268,0,961,5109,379,759,180,197,0,,0,5109,485619,39620,407151,38775,1900,149,3,48,274,274,51,274,0,0
NE,24,206,0,961,5109,379,759,180,197,0,,1400,5109,485619,39620,407151,38775,1900,149,3,0,230,230,3,230,0,0
NH,26,513,208,961,5109,379,759,180,197,0,,1400,5109,485619,39620,407151,38775,1900,149,9,158,747,539,167,539,0,0
NJ,427,190,21,961,5109,379,759,180,197,0,,5,5109,485619,39620,407151,38775,1900,149,160,27,638,617,187,617,2,0
NM,28,2326,0,961,5109,379,759,180,197,0,,1400,5109,485619,39620,407151,38775,1900,149,5,1077,2354,2354,1082,2354,0,0
NV,55,168,0,961,5109,379,759,180,197,0,,2,5109,485619,39620,407151,38775,1900,149,0,0,223,223,0,223,1,0
NY,2382,12215,0,416,5109,379,759,180,197,0,,12,5109,485619,39620,407151,38775,1900,149,682,6709,14597,14597,7391,14597,5,0
OH,88,140,0,961,5109,379,759,180,197,0,,1400,5109,485619,39620,407151,88,1900,149,21,0,228,228,21,228,0,0
OK,29,378,110,961,5109,379,759,180,197,0,,1400,5109,485619,39620,407151,38775,1900,149,12,131,517,407,143,407,0,0
OR,75,1118,361,961,5109,379,759,180,197,0,,3,5109,485619,39620,407151,38775,1900,149,28,429,1554,1193,457,1193,3,0
PA,133,1187,0,961,5109,379,759,180,197,0,,1,5109,485619,39620,407151,38775,1900,149,37,308,1320,1320,345,1320,1,0
PR,5,31,21,961,5109,379,759,180,197,0,,1400,5109,485619,39620,407151,38775,1900,149,0,18,57,36,18,36,0,0
RI,44,719,334,961,5109,379,759,180,197,0,,1400,5109,805,52,753,44,1900,149,11,111,1097,763,122,763,0,0
SC,60,583,0,961,5109,379,759,180,197,0,,1,5109,485619,39620,407151,38775,1900,149,27,272,643,643,299,643,0,0
SD,11,551,350,961,5109,379,759,180,197,0,,1,5109,485619,39620,407151,38775,1900,149,0,0,912,562,0,562,1,0
TN,98,349,0,961,5109,379,759,180,197,0,,1400,5109,485619,39620,407151,38775,1900,149,25,19,447,447,44,447,0,0
TX,83,1824,0,961,5109,379,759,180,197,0,,2,5109,485619,39620,407151,83,1900,149,19,620,1907,1907,639,1907,1,0
UT,63,131,0,961,5109,379,759,180,197,0,,0,5109,485619,39620,407151,63,1900,149,12,0,194,194,12,194,0,0
VA,77,1201,0,961,5109,379,759,180,197,0,,1,5109,485619,39620,407151,38775,1900,149,10,240,1278,1278,250,1278,0,0
VI,2,,0,961,5109,379,759,180,197,0,,1400,5109,485619,39620,407151,38775,1900,149,0,0,2,2,0,2,0,0
VT,21,637,0,961,5109,379,759,180,197,0,,1400,5109,485619,39620,407151,38775,1900,149,2,56,658,658,58,658,0,0
WA,3810,30359,0,961,5109,379,759,180,197,0,,82,5109,485619,39620,407151,2134,1900,149,378,4362,34169,34169,4740,34169,4,0
WI,121,1577,0,961,5109,379,759,180,197,0,,1400,5109,485619,39620,407151,106,1900,149,38,539,1698,1698,577,1698,0,0
WV,1,122,14,961,5109,379,759,180,197,0,,0,5109,485619,39620,407151,38775,1900,149,1,42,137,123,43,123,0,0
WY,15,178,0,961,5109,379,759,180,197,0,,1400,5109,485619,39620,407151,11,1900,149,5,83,193,193,88,193,0,0
AK,3,334,0,961,5109,379,759,180,197,0,,0,5109,337,39620,407151,3,1900,149,2,191,337,337,193,337,0,0
AL,36,28,0,961,5109,379,759,180,197,0,,0,5109,485619,39620,407151,36,1900,149,8,0,64,64,8,64,0,0
AR,22,197,41,961,5109,379,759,180,197,0,,1400,5109,485619,39620,407151,22,1900,149,0,65,260,219,65,219,0,0
AS,,,0,961,5109,379,759,180,197,0,,1400,5109,485619,39620,407151,0,1900,149,0,0,0,0,0,0,0,0
AZ,20,142,66,961,55,379,759,180,197,0,,0,55,162,39620,407151,38775,1900,149,2,17,228,162,19,162,0,13
CA,483,7981,0,961,5109,379,759,180,197,0,,11,5109,8464,39620,407151,38775,1900,149,148,0,8464,8464,148,8464,5,0
CO,160,1056,0,961,5109,379,759,180,197,0,,1,5109,485619,39620,407151,38775,1900,149,29,429,1216,1216,458,1216,0,0
CT,41,125,0,961,5109,379,759,180,197,0,,1400,5109,485619,39620,407151,38775,1900,149,15,0,166,166,15,166,0,0
DC,22,104,0,961,5109,379,759,180,197,0,,1400,5109,485619,39620,407151,38775,1900,149,5,8,126,126,13,126,0,0
DE,16,36,0,961,5109,379,759,180,197,0,,0,5109,485619,39620,407151,38775,0,0,8,0,52,52,8,52,0,0
FL,186,940,872,961,5109,379,759,180,197,0,,6,5109,485619,39620,407151,38775,1900,149,45,256,1998,1126,301,1126,2,0
GA,146,,0,961,5109,379,759,180,197,0,,1,5109,146,39620,407151,38775,1900,149,25,0,146,146,25,146,0,0
GU,5,41,0,961,5109,379,759,180,197,0,,1400,5109,485619,39620,407151,38775,1900,149,2,18,46,46,20,46,0,0
HI,10,,0,961,5109,379,759,180,197,0,,1400,5109,485619,39620,407151,38775,1900,149,3,0,10,10,3,10,0,0
IA,23,83,0,961,5109,379,759,180,197,0,,1400,5109,485619,39620,407151,23,1900,149,1,0,106,106,1,106,0,0
ID,7,346,0,961,5109,379,759,180,197,0,,1400,5109,353,39620,407151,38775,1900,149,2,81,353,353,83,353,0,0
IL,159,1340,0,961,5109,379,759,180,197,0,,1,5109,485619,39620,407151,38775,1900,149,66,408,1499,1499,474,1499,1,0
IN,30,129,0,961,5109,379,759,180,197,0,,2,5109,485619,39620,407151,38775,1900,149,6,14,159,159,20,159,1,0
KS,15,382,0,961,5109,379,759,180,197,0,,1,5109,485619,39620,407151,38775,1900,149,4,216,397,397,220,397,0,0
KY,22,295,0,961,5109,379,759,180,197,0,,1,5109,485619,39620,407151,38775,1900,149,1,61,317,317,62,317,0,0
LA,137,286,0,961,5109,379,759,180,197,0,,4,5109,485619,39620,407151,38775,1900,149,22,98,423,423,120,423,2,0
MA,118,1633,0,961,5109,379,759,180,197,0,,1400,5109,485619,39620,407151,38775,1900,149,21,434,1751,1751,455,1751,0,0
MD,57,94,0,961,5109,379,759,180,197,0,,1400,5109,485619,39620,407151,38775,1900,149,20,0,151,151,20,151,-2,0
ME,32,1303,0,961,5109,379,759,180,197,0,,1400,5109,485619,39620,407151,38775,1900,149,15,539,1335,1335,554,1335,0,0
MI,3659,879,0,961,5109,379,759,180,197,0,,2,5109,1100,221,879,4491,4,1,1726,607,4538,4538,2333,4538,2,0
MN,246,2276,0,961,5109,379,759,180,197,0,,1400,5109,2522,39620,407151,38775,1900,149,67,437,2522,2522,504,2522,0,0
MO,8,207,0,961,5109,379,759,180,197,0,,0,5109,405,39,365,38775,1900,149,2,43,215,215,45,215,0,0
MP,0,,0,961,5109,379,759,180,197,0,,1400,5109,485619,39620,407151,38775,1900,149,0,0,0,0,0,0,0,0
MS,21,368,0,961,5109,379,759,180,197,0,,1400,5109,485619,39620,407151,38775,1900,149,9,91,389,389,100,389,0,0
MT,8,303,0,961,5109,379,759,180,197,0,,1400,5109,485619,39620,407151,38775,1900,149,1,105,311,311,106,311,0,0
NC,40,474,0,961,5109,379,759,180,197,0,,0,5109,485619,39620,407151,38775,1900,149,7,178,514,514,185,514,0,0
ND,3,220,0,961,5109,379,759,180,197,0,,0,5109,485619,39620,407151,38775,1900,149,2,97,223,223,99,223,0,0
NE,21,206,0,961,5109,379,759,180,197,0,,1400,5109,485619,39620,407151,38775,1900,149,3,36,227,227,39,227,0,0
NH,17,355,195,961,5109,379,759,180,197,0,,1400,5109,485619,39620,407151,38775,1900,149,4,84,567,372,88,372,0,0
NJ,267,163,55,961,5109,379,759,180,197,0,,3,5109,485619,39620,407151,38775,1900,149,89,43,485,430,132,430,1,0
NM,23,1249,0,961,5109,379,759,180,197,0,,1400,5109,485619,39620,407151,38775,1900,149,6,683,1272,1272,689,1272,0,0
NV,55,168,0,961,5109,379,759,180,197,0,,1,5109,485619,39620,407151,38775,1900,149,10,0,223,223,10,223,0,0
NY,1700,5506,0,325,5109,379,759,180,197,0,,7,5109,485619,39620,407151,38775,1900,149,750,963,7206,7206,1713,7206,0,0
OH,67,140,0,961,5109,379,759,180,197,0,,1400,5109,485619,39620,407151,67,1900,149,17,0,207,207,17,207,0,0
OK,17,247,82,961,5109,379,759,180,197,0,,1400,5109,485619,39620,407151,38775,1900,149,7,73,346,264,80,264,0,0
OR,47,689,184,961,5109,379,759,180,197,0,,1400,5109,485619,39620,407151,38775,1900,149,8,110,920,736,118,736,0,0
PA,96,879,0,961,5109,379,759,180,197,0,,1400,5109,485619,39620,407151,38775,1900,149,20,209,975,975,229,975,0,0
PR,5,13,4,961,5109,379,759,180,197,0,,1400,5109,485619,39620,407151,38775,1900,149,0,4,22,18,4,18,0,0
RI,33,608,149,961,5109,379,759,180,197,0,,1400,5109,677,40,637,33,1900,149,11,153,790,641,164,641,0,0
SC,33,311,0,961,5109,379,759,180,197,0,,1,5109,485619,39620,407151,38775,1900,149,5,76,344,344,81,344,0,0
SD,11,551,35,961,5109,379,759,180,197,0,,1400,5109,485619,39620,407151,38775,1900,149,1,57,597,562,58,562,0,0
TN,73,330,0,961,5109,379,759,180,197,0,,1400,5109,485619,39620,407151,38775,1900,149,21,60,403,403,81,403,0,0
TX,64,1204,0,961,5109,379,759,180,197,0,,1,5109,485619,39620,407151,64,1900,149,7,1204,1268,1268,1211,1268,1,0
UT,51,131,0,961,5109,379,759,180,197,0,,0,5109,485619,39620,407151,51,1900,149,12,0,182,182,12,182,0,0
VA,67,961,0,961,5109,379,759,180,197,0,,1,5109,485619,39620,407151,38775,1900,149,16,523,1028,1028,539,1028,0,0
VI,2,,0,961,5109,379,759,180,197,0,,1400,5109,485619,39620,407151,38775,1900,149,1,0,2,2,1,2,0,0
VT,19,581,0,961,5109,379,759,180,197,0,,1400,5109,485619,39620,407151,38775,1900,149,2,94,600,600,96,600,0,0
WA,3432,25997,0,961,5109,379,759,180,197,0,,78,5109,485619,39620,407151,1845,1900,149,325,4313,29429,29429,4638,29429,9,0
WI,83,1038,0,961,5109,379,759,180,197,0,,1400,5109,485619,39620,407151,72,1900,149,27,534,1121,1121,561,1121,0,0
WV,0,80,4,961,5109,379,759,180,197,0,,0,5109,485619,39620,407151,38775,1900,149,0,0,84,80,0,80,0,0
WY,10,95,0,961,5109,379,759,180,197,0,,1400,5109,485619,39620,407151,3,1900,149,7,95,105,105,102,105,0,0
AK,1,143,0,961,5109,379,759,180,197,0,,0,5109,144,39620,407151,1,1900,149,0,0,144,144,0,144,0,0
AL,28,28,40,961,5109,379,759,180,197,0,,0,5109,485619,39620,407151,28,1900,149,16,0,96,56,16,56,0,0
AR,22,132,14,961,5109,379,759,180,197,0,,1400,5109,485619,39620,407151,22,1900,149,6,29,168,154,35,154,0,0
AS,,,0,961,5109,379,759,180,197,0,,1400,5109,485619,39620,407151,0,1900,149,0,0,0,0,0,0,0,0
AZ,18,125,63,961,42,379,759,180,197,0,,0,42,143,39620,407151,38775,1900,149,6,4,206,143,10,143,0,6
CA,335,7981,0,961,5109,379,759,180,197,0,,6,5109,8316,39620,407151,38775,1900,149,42,7065,8316,8316,7107,8316,1,0
CO,131,627,0,961,5109,379,759,180,197,0,,1,5109,485619,39620,407151,38775,1900,149,0,0,758,758,0,758,0,0
CT,26,125,0,961,5109,379,759,180,197,0,,1400,5109,485619,39620,407151,38775,1900,149,6,0,151,151,6,151,0,0
DC,17,96,7,961,5109,379,759,180,197,0,,1400,5109,485619,39620,407151,38775,1900,149,1,17,120,113,18,113,0,0
DE,8,36,32,961,5109,379,759,180,197,0,,0,5109,485619,39620,407151,38775,0,0,2,0,76,44,2,44,0,0
FL,141,684,514,961,5109,379,759,180,197,0,,4,5109,485619,39620,407151,38775,1900,149,25,6,1339,825,31,825,0,0
GA,121,,0,961,5109,379,759,180,197,0,,1,5109,121,39620,407151,38775,1900,149,22,0,121,121,22,121,0,0
GU,3,23,0,961,5109,379,759,180,197,0,,1400,5109,485619,39620,407151,38775,1900,149,0,0,26,26,0,26,0,0
HI,7,,0,961,5109,379,759,180,197,0,,1400,5109,485619,39620,407151,38775,1900,149,5,0,7,7,5,7,0,0
IA,22,83,0,961,5109,379,759,180,197,0,,1400,5109,485619,39620,407151,22,1900,149,4,0,105,105,4,105,0,0
ID,5,265,0,961,5109,379,759,180,197,0,,1400,5109,270,39620,407151,38775,1900,149,0,91,270,270,91,270,0,0
IL,93,932,0,961,5109,379,759,180,197,0,,1400,5109,485619,39620,407151,38775,1900,149,29,483,1025,1025,512,1025,0,0
IN,24,115,0,961,5109,379,759,180,197,0,,1,5109,485619,39620,407151,38775,1900,149,5,13,139,139,18,139,1,0
KS,11,166,0,961,5109,379,759,180,197,0,,1,5109,485619,39620,407151,38775,1900,149,3,31,177,177,34,177,0,0
KY,21,234,0,961,5109,379,759,180,197,0,,1,5109,485619,39620,407151,38775,1900,149,5,95,255,255,100,255,0,0
LA,115,188,0,961,5109,379,759,180,197,0,,2,5109,485619,39620,407151,38775,1900,149,25,32,303,303,57,303,0,0
MA,97,1199,0,961,5109,379,759,180,197,0,,1400,5109,485619,39620,407151,38775,1900,149,33,615,1296,1296,648,1296,0,0
MD,37,94,0,961,5109,379,759,180,197,0,,2,5109,485619,39620,407151,38775,1900,149,6,0,131,131,6,131,2,0
ME,17,764,0,961,5109,379,759,180,197,0,,1400,5109,485619,39620,407151,38775,1900,149,14,673,781,781,687,781,0,0
MI,1933,272,30,961,5109,379,759,180,197,0,,1400,5109,485619,39620,407151,2873,1,1,453,67,2235,2205,520,2205,0,0
MN,179,1839,0,961,5109,379,759,180,197,0,,1400,5109,2018,39620,407151,38775,1900,149,51,452,2018,2018,503,2018,0,0
MO,6,164,0,961,5109,379,759,180,197,0,,0,5109,287,29,257,38775,1900,149,1,42,170,170,43,170,0,0
MP,0,,0,961,5109,379,759,180,197,0,,1400,5109,485619,39620,407151,38775,1900,149,0,0,0,0,0,0,0,0
MS,12,277,0,961,5109,379,759,180,197,0,,1400,5109,485619,39620,407151,38775,1900,149,2,193,289,289,195,289,0,0
MT,7,198,0,961,5109,379,759,180,197,0,,1400,5109,485619,39620,407151,38775,1900,149,0,95,205,205,95,205,0,0
NC,33,296,151,961,5109,379,759,180,197,0,,0,5109,485619,39620,407151,38775,1900,149,1,69,480,329,70,329,0,0
ND,1,123,0,961,5109,379,759,180,197,0,,0,5109,485619,39620,407151,38775,1900,149,0,28,124,124,28,124,0,0
NE,18,170,0,961,5109,379,759,180,197,0,,1400,5109,485619,39620,407151,38775,1900,149,1,90,188,188,91,188,0,0
NH,13,271,95,961,5109,379,759,180,197,0,,1400,5109,485619,39620,407151,38775,1900,149,0,0,379,284,0,284,0,0
NJ,178,120,20,961,5109,379,759,180,197,0,,2,5109,485619,39620,407151,38775,1900,149,80,0,318,298,80,298,0,0
NM,17,566,0,961,5109,379,759,180,197,0,,1400,5109,485619,39620,407151,38775,1900,149,4,84,583,583,88,583,0,0
NV,45,168,0,961,5109,379,759,180,197,0,,1,5109,485619,39620,407151,38775,1900,149,24,0,213,213,24,213,0,0
NY,950,4543,0,961,5109,379,759,180,197,0,,7,5109,485619,39620,407151,38775,1900,149,221,0,5493,5493,221,5493,4,0
OH,50,140,361,961,5109,379,759,180,197,0,,1400,5109,485619,39620,407151,50,1900,149,14,1,551,190,15,190,0,0
OK,10,174,29,961,5109,379,759,180,197,0,,1400,5109,485619,39620,407151,38775,1900,149,1,56,213,184,57,184,0,0
OR,39,579,182,961,5109,379,759,180,197,0,,1400,5109,485619,39620,407151,38775,1900,149,3,159,800,618,162,618,0,0
PA,76,670,0,961,5109,379,759,180,197,0,,1400,5109,485619,39620,407151,38775,1900,149,13,465,746,746,478,746,0,0
PR,5,9,0,961,5109,379,759,180,197,0,,1400,5109,485619,39620,407151,38775,1900,149,0,0,14,14,0,14,0,0
RI,22,455,149,961,5109,379,759,180,197,0,,1400,5109,499,24,475,22,1900,149,2,91,626,477,93,477,0,0
SC,28,235,0,961,5109,379,759,180,197,0,,1,5109,485619,39620,407151,38775,1900,149,9,81,263,263,90,263,1,0
SD,10,494,0,961,5109,379,759,180,197,0,,1400,5109,485619,39620,407151,38775,1900,149,1,167,504,504,168,504,0,0
TN,52,270,0,961,5109,379,759,180,197,0,,1400,5109,485619,39620,407151,38775,1900,149,13,113,322,322,126,322,0,0
TX,57,,0,961,5109,379,759,180,197,0,,1400,5109,485619,39620,407151,57,1900,149,1,0,57,57,1,57,0,0
UT,39,131,0,961,5109,379,759,180,197,0,,0,5109,485619,39620,407151,39,1900,149,11,0,170,170,11,170,0,0
VA,51,438,0,961,5109,379,759,180,197,0,,1,5109,485619,39620,407151,38775,1900,149,6,75,489,489,81,489,0,0
VI,1,,0,961,5109,379,759,180,197,0,,1400,5109,485619,39620,407151,38775,1900,149,0,0,1,1,0,1,0,0
VT,17,487,0,961,5109,379,759,180,197,0,,1400,5109,485619,39620,407151,38775,1900,149,5,82,504,504,87,504,0,0
WA,3107,21684,0,961,5109,379,759,180,197,0,,69,5109,485619,39620,407151,1581,1900,149,369,4526,24791,24791,4895,24791,12,0
WI,56,504,0,961,5109,379,759,180,197,0,,1400,5109,485619,39620,407151,47,1900,149,19,191,560,560,210,560,0,0
WV,0,80,4,961,5109,379,759,180,197,0,,0,5109,485619,39620,407151,38775,1900,149,0,42,84,80,42,80,0,0
WY,3,,0,961,5109,379,759,180,197,0,,1400,5109,485619,39620,407151,3,1900,149,0,0,3,3,0,3,0,0
AK,1,143,0,961,5109,379,759,180,197,0,,0,5109,144,39620,407151,1,1900,149,0,0,144,144,0,144,0,0
AL,12,28,46,961,5109,379,759,180,197,0,,0,5109,485619,39620,407151,12,1900,149,6,6,86,40,12,40,0,0
AR,16,103,30,961,5109,379,759,180,197,0,,1400,5109,485619,39620,407151,16,1900,149,4,38,149,119,42,119,0,0
AZ,12,121,50,961,36,379,759,180,197,0,,0,36,133,39620,407151,38775,1900,149,0,0,183,133,0,133,0,10
CA,293,916,0,961,5109,379,759,180,197,0,,5,5109,1209,39620,407151,38775,1900,149,41,0,1209,1209,41,1209,0,0
CO,131,627,0,961,5109,379,759,180,197,0,,1,5109,485619,39620,407151,38775,1900,149,30,17,758,758,47,758,0,0
CT,20,125,0,961,5109,379,759,180,197,0,,1400,5109,485619,39620,407151,38775,1900,149,9,0,145,145,9,145,0,0
DC,16,79,20,961,5109,379,759,180,197,0,,1400,5109,485619,39620,407151,38775,1900,149,6,30,115,95,36,95,0,0
DE,6,36,32,961,5109,379,759,180,197,0,,0,5109,485619,39620,407151,38775,0,0,0,0,74,42,0,42,0,0
FL,116,678,454,961,5109,379,759,180,197,0,,4,5109,485619,39620,407151,38775,1900,149,39,200,1248,794,239,794,1,0
GA,99,,0,961,5109,379,759,180,197,0,,1,5109,99,39620,407151,38775,1900,149,33,0,99,99,33,99,0,0
HI,2,,0,961,5109,379,759,180,197,0,,1400,5109,485619,39620,407151,38775,1900,149,0,0,2,2,0,2,0,0
IA,18,83,0,961,5109,379,759,180,197,0,,1400,5109,485619,39620,407151,18,1900,149,1,0,101,101,1,101,0,0
ID,5,174,0,961,5109,379,759,180,197,0,,1400,5109,179,39620,407151,38775,1900,149,3,0,179,179,3,179,0,0
IL,64,449,195,961,5109,379,759,180,197,0,,1400,5109,485619,39620,407151,38775,1900,149,18,133,708,513,151,513,0,0
IN,19,102,0,961,5109,379,759,180,197,0,,0,5109,485619,39620,407151,38775,1900,149,4,28,121,121,32,121,0,0
KS,8,135,0,961,5109,379,759,180,197,0,,1,5109,485619,39620,407151,38775,1900,149,2,42,143,143,44,143,0,0
KY,16,139,0,961,5109,379,759,180,197,0,,1,5109,485619,39620,407151,38775,1900,149,2,0,155,155,2,155,0,0
LA,90,156,0,961,5109,379,759,180,197,0,,2,5109,485619,39620,407151,38775,1900,149,39,47,246,246,86,246,2,0
MA,64,584,0,961,5109,379,759,180,197,0,,1400,5109,485619,39620,407151,38775,1900,149,26,584,648,648,610,648,0,0
MD,31,94,0,961,5109,379,759,180,197,0,,1400,5109,485619,39620,407151,38775,1900,149,5,0,125,125,5,125,0,0
ME,3,91,17,961,5109,379,759,180,197,0,,1400,5109,485619,39620,407151,38775,1900,149,0,0,111,94,0,94,0,0
MI,1480,205,26,961,5109,379,759,180,197,0,,1400,5109,485619,39620,407151,2175,0,1,284,0,1711,1685,284,1685,0,0
MN,128,1387,0,961,5109,379,759,180,197,0,,1400,5109,1515,39620,407151,38775,1900,149,38,540,1515,1515,578,1515,0,0
MO,5,122,0,961,5109,379,759,180,197,0,,0,5109,188,19,168,38775,1900,149,1,32,127,127,33,127,0,0
MS,10,84,0,961,5109,379,759,180,197,0,,1400,5109,485619,39620,407151,38775,1900,149,4,0,94,94,4,94,0,0
MT,7,103,57,961,5109,379,759,180,197,0,,1400,5109,485619,39620,407151,38775,1900,149,2,0,167,110,2,110,0,0
NC,32,227,151,961,5109,379,759,180,197,0,,1400,5109,485619,39620,407151,38775,1900,149,9,90,410,259,99,259,0,0
ND,1,95,4,961,5109,379,759,180,197,0,,0,5109,485619,39620,407151,38775,1900,149,0,41,100,96,41,96,0,0
NE,17,80,33,961,5109,379,759,180,197,0,,1400,5109,485619,39620,407151,38775,1900,149,3,0,130,97,3,97,0,0
NH,13,271,95,961,5109,379,759,180,197,0,,1400,5109,485619,39620,407151,38775,1900,149,6,59,379,284,65,284,0,0
NJ,98,120,34,961,5109,379,759,180,197,0,,2,5109,485619,39620,407151,38775,1900,149,48,23,252,218,71,218,1,0
NM,13,482,0,961,5109,379,759,180,197,0,,1400,5109,485619,39620,407151,38775,1900,149,3,245,495,495,248,495,0,0
NV,21,168,164,961,5109,379,759,180,197,0,,1,5109,485619,39620,407151,38775,1900,149,1,0,353,189,1,189,1,0
NY,729,4543,0,961,5109,379,759,180,197,0,,3,5109,485619,39620,407151,38775,1900,149,205,1764,5272,5272,1969,5272,3,0
OH,36,139,350,961,5109,379,759,180,197,0,,1400,5109,485619,39620,407151,36,1900,149,23,89,525,175,112,175,0,0
OK,9,118,12,961,5109,379,759,180,197,0,,1400,5109,485619,39620,407151,38775,1900,149,5,82,139,127,87,127,0,0
OR,36,420,225,961,5109,379,759,180,197,0,,1400,5109,485619,39620,407151,38775,1900,149,6,83,681,456,89,456,0,0
PA,63,205,183,961,5109,379,759,180,197,0,,1400,5109,485619,39620,407151,38775,1900,149,16,0,451,268,16,268,0,0
RI,20,364,57,961,5109,379,759,180,197,0,,1400,5109,402,22,380,20,1900,149,1,54,441,384,55,384,0,0
SC,19,154,0,961,5109,379,759,180,197,0,,1400,5109,485619,39620,407151,38775,1900,149,6,44,173,173,50,173,0,0
SD,9,327,6,961,5109,379,759,180,197,0,,1400,5109,485619,39620,407151,38775,1900,149,0,145,342,336,145,336,0,0
TN,39,157,0,961,5109,379,759,180,197,0,,1400,5109,485619,39620,407151,38775,1900,149,7,27,196,196,34,196,0,0
TX,56,,0,961,5109,379,759,180,197,0,,1400,5109,485619,39620,407151,56,1900,149,5,0,56,56,5,56,0,0
UT,28,131,0,961,5109,379,759,180,197,0,,0,5109,485619,39620,407151,28,1900,149,22,0,159,159,22,159,0,0
VA,45,363,0,961,5109,379,759,180,197,0,,1,5109,485619,39620,407151,38775,1900,149,15,246,408,408,261,408,1,0
VT,12,405,0,961,5109,379,759,180,197,0,,1400,5109,485619,39620,407151,38775,1900,149,4,73,417,417,77,417,0,0
WA,2738,17158,0,961,5109,379,759,180,197,0,,57,5109,485619,39620,407151,1281,1900,149,254,1435,19896,19896,1689,19896,6,0
WI,37,313,0,961,5109,379,759,180,197,0,,1400,5109,485619,39620,407151,33,1900,149,14,144,350,350,158,350,0,0
WV,0,38,1,961,5109,379,759,180,197,0,,0,5109,485619,39620,407151,38775,1900,149,0,12,39,38,12,38,0,0
WY,3,,0,961,5109,379,759,180,197,0,,1400,5109,485619,39620,407151,2,1900,149,1,0,3,3,1,3,0,0
AK,1,143,0,961,5109,379,759,180,197,0,,0,5109,144,39620,407151,1,1900,149,0,84,144,144,84,144,0,0
AL,6,22,46,961,5109,379,759,180,197,0,,1400,5109,485619,39620,407151,6,1900,149,5,11,74,28,16,28,0,0
AR,12,65,26,961,5109,379,759,180,197,0,,1400,5109,485619,39620,407151,12,1900,149,3,35,103,77,38,77,0,0
AZ,12,121,50,961,26,379,759,180,197,0,,0,26,133,39620,407151,38775,1900,149,3,27,183,133,30,133,0,4
CA,252,916,0,961,5109,379,759,180,197,0,,5,5109,1168,39620,407151,38775,1900,149,50,0,1168,1168,50,1168,1,0
CO,101,610,0,961,5109,379,759,180,197,0,,1,5109,485619,39620,407151,38775,1900,149,29,86,711,711,115,711,1,0
CT,11,125,0,961,5109,379,759,180,197,0,,1400,5109,485619,39620,407151,38775,1900,149,5,26,136,136,31,136,0,0
DC,10,49,10,961,5109,379,759,180,197,0,,1400,5109,485619,39620,407151,38775,1900,149,0,29,69,59,29,59,0,0
DE,6,36,32,961,5109,379,759,180,197,0,,0,5109,485619,39620,407151,38775,0,0,2,6,74,42,8,42,0,0
FL,77,478,221,961,5109,379,759,180,197,0,,3,5109,485619,39620,407151,38775,1900,149,27,0,776,555,27,555,1,0
GA,66,,0,961,5109,379,759,180,197,0,,1,5109,66,39620,407151,38775,1900,149,24,0,66,66,24,66,0,0
HI,2,,0,961,5109,379,759,180,197,0,,1400,5109,485619,39620,407151,38775,1900,149,0,0,2,2,0,2,0,0
IA,17,83,0,961,5109,379,759,180,197,0,,1400,5109,485619,39620,407151,17,1900,149,1,0,100,100,1,100,0,0
ID,2,174,0,961,5109,379,759,180,197,0,,1400,5109,176,39620,407151,38775,1900,149,2,43,176,176,45,176,0,0
IL,46,316,82,961,5109,379,759,180,197,0,,1400,5109,485619,39620,407151,38775,1900,149,14,22,444,362,36,362,0,0
IN,15,74,0,961,5109,379,759,180,197,0,,0,5109,485619,39620,407151,38775,1900,149,3,13,89,89,16,89,0,0
KS,6,93,0,961,5109,379,759,180,197,0,,1,5109,485619,39620,407151,38775,1900,149,0,0,99,99,0,99,1,0
KY,14,139,0,961,5109,379,759,180,197,0,,1,5109,485619,39620,407151,38775,1900,149,3,32,153,153,35,153,1,0
LA,51,109,0,961,5109,379,759,180,197,0,,1400,5109,485619,39620,407151,38775,1900,149,15,72,160,160,87,160,0,0
MA,38,,0,961,5109,379,759,180,197,0,,1400,5109,485619,39620,407151,38775,1900,149,15,0,38,38,15,38,0,0
MD,26,94,0,961,5109,379,759,180,197,0,,1400,5109,485619,39620,407151,38775,1900,149,9,0,120,120,9,120,0,0
ME,3,91,17,961,5109,379,759,180,197,0,,1400,5109,485619,39620,407151,38775,1900,149,0,0,111,94,0,94,0,0
MI,1196,205,26,961,5109,379,759,180,197,0,,1400,5109,485619,39620,407151,1717,0,1,251,72,1427,1401,323,1401,0,0
MN,90,847,0,961,5109,379,759,180,197,0,,1400,5109,937,39620,407151,38775,1900,149,28,306,937,937,334,937,0,0
MO,4,90,0,961,5109,379,759,180,197,0,,0,5109,115,12,102,38775,1900,149,2,19,94,94,21,94,0,0
MS,6,84,0,961,5109,379,759,180,197,0,,1400,5109,485619,39620,407151,38775,1900,149,2,43,90,90,45,90,0,0
MT,5,103,0,961,5109,379,759,180,197,0,,1400,5109,485619,39620,407151,38775,1900,149,4,48,108,108,52,108,0,0
NC,23,137,0,961,5109,379,759,180,197,0,,1400,5109,485619,39620,407151,38775,1900,149,8,51,160,160,59,160,0,0
ND,1,54,14,961,5109,379,759,180,197,0,,0,5109,485619,39620,407151,38775,1900,149,0,15,69,55,15,55,0,0
NE,14,80,33,961,5109,379,759,180,197,0,,1400,5109,485619,39620,407151,38775,1900,149,1,0,127,94,1,94,0,0
NH,7,212,31,961,5109,379,759,180,197,0,,1400,5109,485619,39620,407151,38775,1900,149,1,118,250,219,119,219,0,0
NJ,50,97,80,961,5109,379,759,180,197,0,,1,5109,485619,39620,407151,38775,1900,149,0,0,227,147,0,147,0,0
NM,10,237,0,961,5109,379,759,180,197,0,,1400,5109,485619,39620,407151,38775,1900,149,0,47,247,247,47,247,0,0
NV,20,168,0,961,5109,379,759,180,197,0,,0,5109,485619,39620,407151,38775,1900,149,9,0,188,188,9,188,0,0
NY,524,2779,0,961,5109,379,759,180,197,0,,1400,5109,485619,39620,407151,38775,1900,149,103,0,3303,3303,103,3303,0,0
OH,13,50,159,961,5109,379,759,180,197,0,,1400,5109,485619,39620,407151,13,1900,149,0,0,222,63,0,63,0,0
OK,4,36,37,961,5109,379,759,180,197,0,,1400,5109,485619,39620,407151,38775,1900,149,1,0,77,40,1,40,0,0
OR,30,337,157,961,5109,379,759,180,197,0,,1400,5109,485619,39620,407151,38775,1900,149,0,0,524,367,0,367,0,0
PA,47,205,150,961,5109,379,759,180,197,0,,1400,5109,485619,39620,407151,38775,1900,149,6,65,402,252,71,252,0,0
RI,19,310,57,961,5109,379,759,180,197,0,,1400,5109,347,21,326,19,1900,149,0,86,386,329,86,329,0,0
SC,13,110,0,961,5109,379,759,180,197,0,,1400,5109,485619,39620,407151,38775,1900,149,1,35,123,123,36,123,0,0
SD,9,182,3,961,5109,379,759,180,197,0,,1400,5109,485619,39620,407151,38775,1900,149,0,109,194,191,109,191,0,0
TN,32,130,0,961,5109,379,759,180,197,0,,1400,5109,485619,39620,407151,38775,1900,149,6,14,162,162,20,162,0,0
TX,51,,0,961,5109,379,759,180,197,0,,1400,5109,485619,39620,407151,51,1900,149,12,0,51,51,12,51,0,0
UT,6,131,0,961,5109,379,759,180,197,0,,1400,5109,485619,39620,407151,6,1900,149,0,0,137,137,0,137,0,0
VA,30,117,0,961,5109,379,759,180,197,0,,1400,5109,485619,39620,407151,38775,1900,149,0,0,147,147,0,147,0,0
VT,8,332,0,961,5109,379,759,180,197,0,,1400,5109,485619,39620,407151,38775,1900,149,3,109,340,340,112,340,0,0
WA,2484,15723,0,961,5109,379,759,180,197,0,,51,5109,485619,39620,407151,1174,1900,149,266,2063,18207,18207,2329,18207,4,0
WI,23,169,0,961,5109,379,759,180,197,0,,1400,5109,485619,39620,407151,19,1900,149,0,0,192,192,0,192,0,0
WV,0,26,5,961,5109,379,759,180,197,0,,1400,5109,485619,39620,407151,38775,1900,149,0,9,31,26,9,26,0,0
WY,2,,0,961,5109,379,759,180,197,0,,1400,5109,485619,39620,407151,2,1900,149,1,0,2,2,1,2,0,0
AK,1,59,0,961,5109,379,759,180,197,0,,0,5109,60,39620,407151,1,1900,149,1,13,60,60,14,60,0,0
AL,1,11,0,961,5109,379,759,180,197,0,,1400,5109,485619,39620,407151,1,1900,149,1,1,12,12,2,12,0,0
AR,9,30,22,961,5109,379,759,180,197,0,,1400,5109,485619,39620,407151,9,1900,149,3,6,61,39,9,39,0,0
AZ,9,94,40,961,22,379,759,180,197,0,,0,22,103,39620,407151,38775,1900,149,0,12,143,103,12,103,0,6
CA,202,916,0,961,5109,379,759,180,197,0,,4,5109,1118,39620,407151,38775,1900,149,0,0,1118,1118,0,1118,0,0
CO,72,524,0,961,5109,379,759,180,197,0,,1400,5109,485619,39620,407151,38775,1900,149,27,226,596,596,253,596,0,0
CT,6,99,0,961,5109,379,759,180,197,0,,1400,5109,485619,39620,407151,38775,1900,149,0,10,105,105,10,105,0,0
DC,10,20,0,961,5109,379,759,180,197,0,,1400,5109,485619,39620,407151,38775,1900,149,0,0,30,30,0,30,0,0
DE,4,30,10,961,5109,379,759,180,197,0,,0,5109,485619,39620,407151,38775,0,0,0,7,44,34,7,34,0,0
FL,50,478,221,961,5109,379,759,180,197,0,,2,5109,485619,39620,407151,38775,1900,149,18,177,749,528,195,528,0,0
GA,42,,0,961,5109,379,759,180,197,0,,1,5109,42,39620,407151,38775,1900,149,11,0,42,42,11,42,1,0
HI,2,,0,961,5109,379,759,180,197,0,,1400,5109,485619,39620,407151,38775,1900,149,0,0,2,2,0,2,0,0
IA,16,83,29,961,5109,379,759,180,197,0,,1400,5109,485619,39620,407151,16,1900,149,2,16,128,99,18,99,0,0
ID,0,131,0,961,5109,379,759,180,197,0,,1400,5109,131,39620,407151,38775,1900,149,0,38,131,131,38,131,0,0
IL,32,294,92,961,5109,379,759,180,197,0,,1400,5109,485619,39620,407151,38775,1900,149,7,28,418,326,35,326,0,0
IN,12,61,0,961,5109,379,759,180,197,0,,1400,5109,485619,39620,407151,38775,1900,149,0,9,73,73,9,73,0,0
KS,6,93,0,961,5109,379,759,180,197,0,,1400,5109,485619,39620,407151,38775,1900,149,2,52,99,99,54,99,0,0
KY,11,107,0,961,5109,379,759,180,197,0,,1400,5109,485619,39620,407151,38775,1900,149,3,51,118,118,54,118,0,0
LA,36,37,0,961,5109,379,759,180,197,0,,1400,5109,485619,39620,407151,38775,1900,149,22,0,73,73,22,73,0,0
MA,23,,0,961,5109,379,759,180,197,0,,1400,5109,485619,39620,407151,38775,1900,149,15,0,23,23,15,23,0,0
MD,17,94,0,961,5109,379,759,180,197,0,,1400,5109,485619,39620,407151,38775,1900,149,5,0,111,111,5,111,0,0
ME,3,91,17,961,5109,379,759,180,197,0,,1400,5109,485619,39620,407151,38775,1900,149,2,26,111,94,28,94,0,0
MI,945,133,26,961,5109,379,759,180,197,0,,1400,5109,485619,39620,407151,1353,0,1,243,42,1104,1078,285,1078,0,0
MN,62,541,0,961,5109,379,759,180,197,0,,1400,5109,603,39620,407151,38775,1900,149,19,234,603,603,253,603,0,0
MO,2,71,0,961,5109,379,759,180,197,0,,1400,5109,87,11,76,38775,1900,149,1,7,73,73,8,73,0,0
MS,4,41,0,961,5109,379,759,180,197,0,,1400,5109,485619,39620,407151,38775,1900,149,3,0,45,45,3,45,0,0
MT,1,55,0,961,5109,379,759,180,197,0,,1400,5109,485619,39620,407151,38775,1900,149,0,21,56,56,21,56,0,0
NC,15,86,0,961,5109,379,759,180,197,0,,1400,5109,485619,39620,407151,38775,1900,149,3,26,101,101,29,101,0,0
ND,1,39,12,961,5109,379,759,180,197,0,,0,5109,485619,39620,407151,38775,1900,149,0,27,52,40,27,40,0,0
NE,13,80,33,961,5109,379,759,180,197,0,,1400,5109,485619,39620,407151,38775,1900,149,3,0,126,93,3,93,0,0
NH,6,94,21,961,5109,379,759,180,197,0,,1400,5109,485619,39620,407151,38775,1900,149,0,0,121,100,0,100,0,0
NJ,50,97,80,961,5109,379,759,180,197,0,,1,5109,485619,39620,407151,38775,1900,149,20,23,227,147,43,147,0,0
NM,10,190,0,961,5109,379,759,180,197,0,,1400,5109,485619,39620,407151,38775,1900,149,5,35,200,200,40,200,0,0
NV,11,168,0,961,5109,379,759,180,197,0,,0,5109,485619,39620,407151,38775,1900,149,4,0,179,179,4,179,0,0
NY,421,2779,0,961,5109,379,759,180,197,0,,1400,5109,485619,39620,407151,38775,1900,149,205,2687,3200,3200,2892,3200,0,0
OH,13,50,159,961,5109,379,759,180,197,0,,1400,5109,485619,39620,407151,13,1900,149,8,20,222,63,28,63,0,0
OK,3,36,37,961,5109,379,759,180,197,0,,1400,5109,485619,39620,407151,38775,1900,149,0,0,76,39,0,39,0,0
OR,30,337,157,961,5109,379,759,180,197,0,,1400,5109,485619,39620,407151,38775,1900,149,11,51,524,367,62,367,0,0
PA,41,140,130,961,5109,379,759,180,197,0,,1400,5109,485619,39620,407151,38775,1900,149,19,24,311,181,43,181,0,0
RI,19,224,29,961,5109,379,759,180,197,0,,1400,5109,257,21,236,19,1900,149,6,48,272,243,54,243,0,0
SC,12,75,0,961,5109,379,759,180,197,0,,1400,5109,485619,39620,407151,38775,1900,149,2,27,87,87,29,87,0,0
SD,9,73,11,961,5109,379,759,180,197,0,,1400,5109,485619,39620,407151,38775,1900,149,1,46,93,82,47,82,0,0
TN,26,116,0,961,5109,379,759,180,197,0,,1400,5109,485619,39620,407151,38775,1900,149,8,37,142,142,45,142,0,0
TX,39,,0,961,5109,379,759,180,197,0,,1400,5109,485619,39620,407151,39,1900,149,16,0,39,39,16,39,0,0
UT,6,131,0,961,5109,379,759,180,197,0,,1400,5109,485619,39620,407151,6,1900,149,2,0,137,137,2,137,0,0
VA,30,117,0,961,5109,379,759,180,197,0,,1400,5109,485619,39620,407151,38775,1900,149,13,0,147,147,13,147,0,0
VT,5,223,0,961,5109,379,759,180,197,0,,1400,5109,485619,39620,407151,38775,1900,149,3,87,228,228,90,228,0,0
WA,2218,13660,0,961,5109,379,759,180,197,0,,47,5109,485619,39620,407151,1018,1900,149,297,3937,15878,15878,4234,15878,3,0
WI,23,169,0,961,5109,379,759,180,197,0,,1400,5109,485619,39620,407151,19,1900,149,14,85,192,192,99,192,0,0
WV,0,17,4,961,5109,379,759,180,197,0,,1400,5109,485619,39620,407151,38775,1900,149,0,10,21,17,10,17,0,0
WY,1,,0,961,5109,379,759,180,197,0,,1400,5109,485619,39620,407151,1,1900,149,0,0,1,1,0,1,0,0
AK,0,46,14,961,5109,379,759,180,197,0,,0,5109,46,39620,407151,0,1900,149,0,0,60,46,0,46,0,0
AL,0,10,0,961,5109,379,759,180,197,0,,1400,5109,485619,39620,407151,0,1900,149,0,0,10,10,0,10,0,0
AR,6,24,20,961,5109,379,759,180,197,0,,1400,5109,485619,39620,407151,6,1900,149,6,12,50,30,18,30,0,0
AZ,9,82,24,961,16,379,759,180,197,0,,1400,16,91,39620,407151,38775,1900,149,0,23,115,91,23,91,0,5
CA,202,916,0,961,5109,379,759,180,197,0,,4,5109,1118,39620,407151,38775,1900,149,45,0,1118,1118,45,1118,4,0
CO,45,298,0,961,5109,379,759,180,197,0,,1400,5109,485619,39620,407151,38775,1900,149,17,47,343,343,64,343,0,0
CT,6,89,0,961,5109,379,759,180,197,0,,1400,5109,485619,39620,407151,38775,1900,149,3,18,95,95,21,95,0,0
DC,10,20,0,961,5109,379,759,180,197,0,,1400,5109,485619,39620,407151,38775,1900,149,5,0,30,30,5,30,0,0
DE,4,23,14,961,5109,379,759,180,197,0,,0,5109,485619,39620,407151,38775,0,0,3,6,41,27,9,27,0,0
FL,32,301,147,961,5109,379,759,180,197,0,,2,5109,485619,39620,407151,38775,1900,149,4,0,480,333,4,333,0,0
GA,31,,0,961,5109,379,759,180,197,0,,1400,5109,31,39620,407151,38775,1900,149,9,0,31,31,9,31,0,0
HI,2,,0,961,5109,379,759,180,197,0,,1400,5109,485619,39620,407151,38775,1900,149,0,0,2,2,0,2,0,0
IA,14,67,24,961,5109,379,759,180,197,0,,1400,5109,485619,39620,407151,14,1900,149,1,21,105,81,22,81,0,0
ID,0,93,0,961,5109,379,759,180,197,0,,1400,5109,93,39620,407151,38775,1900,149,0,26,93,93,26,93,0,0
IL,25,266,76,961,5109,379,759,180,197,0,,1400,5109,485619,39620,407151,38775,1900,149,6,22,367,291,28,291,0,0
IN,12,52,0,961,5109,379,759,180,197,0,,1400,5109,485619,39620,407151,38775,1900,149,2,19,64,64,21,64,0,0
KS,4,41,0,961,5109,379,759,180,197,0,,1400,5109,485619,39620,407151,38775,1900,149,3,0,45,45,3,45,0,0
KY,8,56,0,961,5109,379,759,180,197,0,,1400,5109,485619,39620,407151,38775,1900,149,0,10,64,64,10,64,0,0
LA,14,37,0,961,5109,379,759,180,197,0,,1400,5109,485619,39620,407151,38775,1900,149,8,0,51,51,8,51,0,0
MA,8,,0,961,5109,379,759,180,197,0,,1400,5109,485619,39620,407151,38775,1900,149,0,0,8,8,0,8,0,0
MD,12,94,0,961,5109,379,759,180,197,0,,1400,5109,485619,39620,407151,38775,1900,149,3,0,106,106,3,106,0,0
ME,1,65,20,961,5109,379,759,180,197,0,,1400,5109,485619,39620,407151,38775,1900,149,1,23,86,66,24,66,0,0
MI,702,91,27,961,5109,379,759,180,197,0,,1400,5109,485619,39620,407151,996,0,1,205,34,820,793,239,793,0,0
MN,43,307,0,961,5109,379,759,180,197,0,,1400,5109,350,39620,407151,38775,1900,149,22,90,350,350,112,350,0,0
MO,1,64,0,961,5109,379,759,180,197,0,,1400,5109,65,9,56,38775,1900,149,0,64,65,65,64,65,0,0
MS,1,41,0,961,5109,379,759,180,197,0,,1400,5109,485619,39620,407151,38775,1900,149,1,21,42,42,22,42,0,0
MT,1,34,0,961,5109,379,759,180,197,0,,1400,5109,485619,39620,407151,38775,1900,149,1,13,35,35,14,35,0,0
NC,12,60,0,961,5109,379,759,180,197,0,,1400,5109,485619,39620,407151,38775,1900,149,5,60,72,72,65,72,0,0
ND,1,12,14,961,5109,379,759,180,197,0,,1400,5109,485619,39620,407151,38775,1900,149,1,5,27,13,6,13,0,0
NE,10,80,33,961,5109,379,759,180,197,0,,1400,5109,485619,39620,407151,38775,1900,149,5,33,123,90,38,90,0,0
NH,6,94,21,961,5109,379,759,180,197,0,,1400,5109,485619,39620,407151,38775,1900,149,2,56,121,100,58,100,0,0
NJ,30,74,20,961,5109,379,759,180,197,0,,1,5109,485619,39620,407151,38775,1900,149,6,17,124,104,23,104,0,0
NM,5,155,0,961,5109,379,759,180,197,0,,1400,5109,485619,39620,407151,38775,1900,149,2,68,160,160,70,160,0,0
NV,7,168,0,961,5109,379,759,180,197,0,,0,5109,485619,39620,407151,38775,1900,149,2,0,175,175,2,175,0,0
NY,216,92,0,961,5109,379,759,180,197,0,,1400,5109,485619,39620,407151,38775,1900,149,0,0,308,308,0,308,0,0
OH,5,30,52,961,5109,379,759,180,197,0,,1400,5109,485619,39620,407151,5,1900,149,1,9,87,35,10,35,0,0
OK,3,36,4,961,5109,379,759,180,197,0,,1400,5109,485619,39620,407151,38775,1900,149,1,21,43,39,22,39,0,0
OR,19,286,62,961,5109,379,759,180,197,0,,1400,5109,485619,39620,407151,38775,1900,149,0,0,367,305,0,305,0,0
PA,22,116,81,961,5109,379,759,180,197,0,,1400,5109,485619,39620,407151,38775,1900,149,6,28,219,138,34,138,0,0
RI,13,176,8,961,5109,379,759,180,197,0,,1400,5109,201,15,186,13,1900,149,8,37,197,189,45,189,0,0
SC,10,48,0,961,5109,379,759,180,197,0,,1400,5109,485619,39620,407151,38775,1900,149,1,16,58,58,17,58,0,0
SD,8,27,11,961,5109,379,759,180,197,0,,1400,5109,485619,39620,407151,38775,1900,149,3,14,46,35,17,35,0,0
TN,18,79,0,961,5109,379,759,180,197,0,,1400,5109,485619,39620,407151,38775,1900,149,11,29,97,97,40,97,0,0
TX,23,,0,961,5109,379,759,180,197,0,,1400,5109,485619,39620,407151,23,1900,149,2,0,23,23,2,23,0,0
UT,4,131,0,961,5109,379,759,180,197,0,,1400,5109,485619,39620,407151,4,1900,149,2,131,135,135,133,135,0,0
VA,17,117,0,961,5109,379,759,180,197,0,,1400,5109,485619,39620,407151,38775,1900,149,8,57,134,134,65,134,0,0
VT,2,136,0,961,5109,379,759,180,197,0,,1400,5109,485619,39620,407151,38775,1900,149,0,45,138,138,45,138,0,0
WA,1921,9723,0,961,5109,379,759,180,197,0,,44,5109,485619,39620,407151,801,1900,149,256,3508,11644,11644,3764,11644,4,0
WI,9,84,0,961,5109,379,759,180,197,0,,1400,5109,485619,39620,407151,8,1900,149,6,41,93,93,47,93,0,0
WV,0,7,1,961,5109,379,759,180,197,0,,1400,5109,485619,39620,407151,38775,1900,149,0,4,8,7,4,7,0,0
WY,1,,0,961,5109,379,759,180,197,0,,1400,5109,485619,39620,407151,38775,1900,149,1,0,1,1,1,1,0,0
AK,0,46,14,961,5109,379,759,180,197,0,,0,5109,46,39620,407151,0,1900,149,0,23,60,46,23,46,0,0
AL,0,10,0,961,5109,379,759,180,197,0,,1400,5109,485619,39620,407151,0,1900,149,0,10,10,10,10,10,0,0
AR,0,12,14,961,5109,379,759,180,197,0,,1400,5109,485619,39620,407151,0,1900,149,0,0,26,12,0,12,0,0
AZ,9,59,32,961,11,379,759,180,197,0,,1400,11,68,39620,407151,38775,1900,149,3,8,100,68,11,68,0,3
CA,157,916,0,961,5109,379,759,180,197,0,,1400,5109,1073,39620,407151,38775,1900,149,24,226,1073,1073,250,1073,0,0
CO,28,251,0,961,5109,379,759,180,197,0,,1400,5109,485619,39620,407151,38775,1900,149,16,109,279,279,125,279,0,0
CT,3,71,0,961,5109,379,759,180,197,0,,1400,5109,485619,39620,407151,38775,1900,149,1,17,74,74,18,74,0,0
DC,5,20,15,961,5109,379,759,180,197,0,,1400,5109,485619,39620,407151,38775,1900,149,0,3,40,25,3,25,0,0
DE,1,17,2,961,5109,379,759,180,197,0,,0,5109,485619,39620,407151,38775,0,0,1,0,20,18,1,18,0,0
FL,28,301,147,961,5109,379,759,180,197,0,,2,5109,485619,39620,407151,38775,1900,149,9,79,476,329,88,329,2,0
GA,22,,0,961,5109,379,759,180,197,0,,1400,5109,22,39620,407151,38775,1900,149,5,0,22,22,5,22,0,0
HI,2,,0,961,5109,379,759,180,197,0,,1400,5109,485619,39620,407151,38775,1900,149,0,0,2,2,0,2,0,0
IA,13,46,27,961,5109,379,759,180,197,0,,1400,5109,485619,39620,407151,13,1900,149,5,14,86,59,19,59,0,0
ID,0,67,0,961,5109,379,759,180,197,0,,1400,5109,67,39620,407151,38775,1900,149,0,26,67,67,26,67,0,0
IL,19,244,63,961,5109,379,759,180,197,0,,1400,5109,485619,39620,407151,38775,1900,149,0,0,326,263,0,263,0,0
IN,10,33,0,961,5109,379,759,180,197,0,,1400,5109,485619,39620,407151,38775,1900,149,4,3,43,43,7,43,0,0
KS,1,41,0,961,5109,379,759,180,197,0,,1400,5109,485619,39620,407151,38775,1900,149,0,24,42,42,24,42,0,0
KY,8,46,0,961,5109,379,759,180,197,0,,1400,5109,485619,39620,407151,38775,1900,149,2,18,54,54,20,54,0,0
LA,6,37,0,961,5109,379,759,180,197,0,,1400,5109,485619,39620,407151,38775,1900,149,5,26,43,43,31,43,0,0
MD,9,94,0,961,5109,379,759,180,197,0,,1400,5109,485619,39620,407151,38775,1900,149,3,5,103,103,8,103,0,0
ME,0,42,5,961,5109,379,759,180,197,0,,1400,5109,485619,39620,407151,38775,1900,149,0,22,47,42,22,42,0,0
MI,497,57,18,961,5109,379,759,180,197,0,,1400,5109,485619,39620,407151,727,0,0,139,18,572,554,157,554,0,0
MN,21,217,0,961,5109,379,759,180,197,0,,1400,5109,238,39620,407151,38775,1900,149,10,85,238,238,95,238,0,0
MO,1,,0,961,5109,379,759,180,197,0,,1400,5109,54,8,46,38775,1900,149,0,0,1,1,0,1,0,0
MS,0,20,0,961,5109,379,759,180,197,0,,1400,5109,485619,39620,407151,38775,1900,149,0,20,20,20,20,20,0,0
MT,0,21,0,961,5109,379,759,180,197,0,,1400,5109,485619,39620,407151,38775,1900,149,0,6,21,21,6,21,0,0
NC,7,,0,961,5109,379,759,180,197,0,,1400,5109,485619,39620,407151,38775,1900,149,0,0,7,7,0,7,0,0
ND,0,7,6,961,5109,379,759,180,197,0,,1400,5109,485619,39620,407151,38775,1900,149,0,1,13,7,1,7,0,0
NE,5,47,16,961,5109,379,759,180,197,0,,1400,5109,485619,39620,407151,38775,1900,149,2,0,68,52,2,52,0,0
NH,4,38,5,961,5109,379,759,180,197,0,,1400,5109,485619,39620,407151,38775,1900,149,0,0,47,42,0,42,0,0
NJ,24,57,20,961,5109,379,759,180,197,0,,1,5109,485619,39620,407151,38775,1900,149,9,13,101,81,22,81,1,0
NM,3,87,0,961,5109,379,759,180,197,0,,1400,5109,485619,39620,407151,38775,1900,149,3,18,90,90,21,90,0,0
NV,5,168,0,961,5109,379,759,180,197,0,,0,5109,485619,39620,407151,38775,1900,149,4,154,173,173,158,173,0,0
NY,216,92,0,961,5109,379,759,180,197,0,,1400,5109,485619,39620,407151,38775,1900,149,43,0,308,308,43,308,0,0
OH,4,21,24,961,5109,379,759,180,197,0,,1400,5109,485619,39620,407151,4,1900,149,1,7,49,25,8,25,0,0
OK,2,15,11,961,5109,379,759,180,197,0,,1400,5109,485619,39620,407151,38775,1900,149,0,0,28,17,0,17,0,0
OR,19,286,62,961,5109,379,759,180,197,0,,1400,5109,485619,39620,407151,38775,1900,149,4,73,367,305,77,305,0,0
PA,16,88,54,961,5109,379,759,180,197,0,,1400,5109,485619,39620,407151,38775,1900,149,4,88,158,104,92,104,0,0
RI,5,139,24,961,5109,379,759,180,197,0,,1400,5109,150,6,144,5,1900,149,0,34,168,144,34,144,0,0
SC,9,32,0,961,5109,379,759,180,197,0,,1400,5109,485619,39620,407151,38775,1900,149,2,8,41,41,10,41,0,0
SD,5,13,2,961,5109,379,759,180,197,0,,1400,5109,485619,39620,407151,38775,1900,149,5,2,20,18,7,18,0,0
TN,7,50,0,961,5109,379,759,180,197,0,,1400,5109,485619,39620,407151,38775,1900,149,0,50,57,57,50,57,0,0
TX,21,,0,961,5109,379,759,180,197,0,,1400,5109,485619,39620,407151,21,1900,149,8,0,21,21,8,21,0,0
UT,2,,0,961,5109,379,759,180,197,0,,1400,5109,485619,39620,407151,2,1900,149,0,0,2,2,0,2,0,0
VA,9,60,0,961,5109,379,759,180,197,0,,1400,5109,485619,39620,407151,38775,1900,149,1,7,69,69,8,69,0,0
VT,2,91,0,961,5109,379,759,180,197,0,,1400,5109,485619,39620,407151,38775,1900,149,1,31,93,93,32,93,0,0
WA,1665,6215,0,961,5109,379,759,180,197,0,,40,5109,485619,39620,407151,622,1900,149,212,2055,7880,7880,2267,7880,3,0
WI,3,43,0,961,5109,379,759,180,197,0,,1400,5109,485619,39620,407151,3,1900,149,1,7,46,46,8,46,0,0
WV,0,3,2,961,5109,379,759,180,197,0,,1400,5109,485619,39620,407151,38775,1900,149,0,1,5,3,1,3,0,0
WY,0,,0,961,5109,379,759,180,197,0,,1400,5109,485619,39620,407151,38775,1900,149,0,0,0,0,0,0,0,0
AK,0,23,9,961,5109,379,759,180,197,0,,0,5109,23,39620,407151,0,1900,149,0,0,32,23,0,23,0,0
AL,0,0,0,961,5109,379,759,180,197,0,,1400,5109,485619,39620,407151,0,1900,149,0,0,0,0,0,0,0,0
AR,0,12,3,961,5109,379,759,180,197,0,,1400,5109,485619,39620,407151,0,1900,149,0,0,15,12,0,12,0,0
AZ,6,51,27,961,8,379,759,180,197,0,,1400,8,57,39620,407151,38775,1900,149,1,7,84,57,8,57,0,0
CA,133,690,0,961,5109,379,759,180,197,0,,1400,5109,823,39620,407151,38775,1900,149,19,0,823,823,19,823,0,0
CO,12,142,1,961,5109,379,759,180,197,0,,1400,5109,485619,39620,407151,38775,1900,149,3,9,155,154,12,154,0,0
CT,2,54,0,961,5109,379,759,180,197,0,,1400,5109,485619,39620,407151,38775,1900,149,1,8,56,56,9,56,0,0
DC,5,17,2,961,5109,379,759,180,197,0,,1400,5109,485619,39620,407151,38775,1900,149,4,3,24,22,7,22,0,0
DE,0,17,3,961,5109,379,759,180,197,0,,0,5109,485619,39620,407151,38775,0,0,0,2,20,17,2,17,0,0
FL,19,222,155,961,5109,379,759,180,197,0,,1400,5109,485619,39620,407151,38775,1900,149,1,82,396,241,83,241,0,0
GA,17,,0,961,5109,379,759,180,197,0,,1400,5109,17,39620,407151,38775,1900,149,5,0,17,17,5,17,0,0
HI,2,,0,961,5109,379,759,180,197,0,,1400,5109,485619,39620,407151,38775,1900,149,0,0,2,2,0,2,0,0
IA,8,32,11,961,5109,379,759,180,197,0,,1400,5109,485619,39620,407151,8,1900,149,5,6,51,40,11,40,0,0
ID,0,41,0,961,5109,379,759,180,197,0,,1400,5109,41,39620,407151,38775,1900,149,0,0,41,41,0,41,0,0
IL,19,244,63,961,5109,379,759,180,197,0,,1400,5109,485619,39620,407151,38775,1900,149,12,53,326,263,65,263,0,0
IN,6,30,0,961,5109,379,759,180,197,0,,1400,5109,485619,39620,407151,38775,1900,149,4,30,36,36,34,36,0,0
KS,1,17,21,961,5109,379,759,180,197,0,,1400,5109,485619,39620,407151,38775,1900,149,0,6,39,18,6,18,0,0
KY,6,28,0,961,5109,379,759,180,197,0,,1400,5109,485619,39620,407151,38775,1900,149,2,11,34,34,13,34,0,0
LA,1,11,0,961,5109,379,759,180,197,0,,1400,5109,485619,39620,407151,38775,1900,149,0,6,12,12,6,12,0,0
MD,6,89,0,961,5109,379,759,180,197,0,,1400,5109,485619,39620,407151,38775,1900,149,1,16,95,95,17,95,0,0
ME,0,20,5,961,5109,379,759,180,197,0,,1400,5109,485619,39620,407151,38775,1900,149,0,19,25,20,19,20,0,0
MI,358,39,24,961,5109,379,759,180,197,0,,1400,5109,485619,39620,407151,528,0,0,104,3,421,397,107,397,0,0
MN,11,132,0,961,5109,379,759,180,197,0,,1400,5109,143,39620,407151,38775,1900,149,6,52,143,143,58,143,0,0
MO,1,,0,961,5109,379,759,180,197,0,,1400,5109,42,8,34,38775,1900,149,0,0,1,1,0,1,0,0
MS,0,,0,961,5109,379,759,180,197,0,,1400,5109,485619,39620,407151,38775,1900,149,0,0,0,0,0,0,0,0
MT,0,15,0,961,5109,379,759,180,197,0,,1400,5109,485619,39620,407151,38775,1900,149,0,4,15,15,4,15,0,0
NC,7,,0,961,5109,379,759,180,197,0,,1400,5109,485619,39620,407151,38775,1900,149,5,0,7,7,5,7,0,0
ND,0,6,2,961,5109,379,759,180,197,0,,1400,5109,485619,39620,407151,38775,1900,149,0,6,8,6,6,6,0,0
NE,3,47,16,961,5109,379,759,180,197,0,,1400,5109,485619,39620,407151,38775,1900,149,0,11,66,50,11,50,0,0
NH,4,38,5,961,5109,379,759,180,197,0,,1400,5109,485619,39620,407151,38775,1900,149,0,0,47,42,0,42,0,0
NJ,15,44,20,961,5109,379,759,180,197,0,,1400,5109,485619,39620,407151,38775,1900,149,4,9,79,59,13,59,0,0
NM,0,69,0,961,5109,379,759,180,197,0,,1400,5109,485619,39620,407151,38775,1900,149,0,12,69,69,12,69,0,0
NV,1,14,0,961,5109,379,759,180,197,0,,0,5109,485619,39620,407151,38775,1900,149,0,0,15,15,0,15,0,0
NY,173,92,0,961,5109,379,759,180,197,0,,1400,5109,485619,39620,407151,38775,1900,149,31,0,265,265,31,265,0,0
OH,3,14,15,961,5109,379,759,180,197,0,,1400,5109,485619,39620,407151,3,1900,149,0,3,32,17,3,17,0,0
OK,2,15,11,961,5109,379,759,180,197,0,,1400,5109,485619,39620,407151,38775,1900,149,1,7,28,17,8,17,0,0
OR,15,213,67,961,5109,379,759,180,197,0,,1400,5109,485619,39620,407151,38775,1900,149,1,48,295,228,49,228,0,0
PA,12,,0,961,5109,379,759,180,197,0,,1400,5109,485619,39620,407151,38775,1900,149,2,0,12,12,2,12,0,0
RI,5,105,6,961,5109,379,759,180,197,0,,1400,5109,116,6,110,5,1900,149,1,23,116,110,24,110,0,0
SC,7,24,0,961,5109,379,759,180,197,0,,1400,5109,485619,39620,407151,38775,1900,149,0,0,31,31,0,31,0,0
SD,0,11,0,961,5109,379,759,180,197,0,,1400,5109,485619,39620,407151,38775,1900,149,0,6,11,11,6,11,0,0
TN,7,,0,961,5109,379,759,180,197,0,,1400,5109,485619,39620,407151,38775,1900,149,4,0,7,7,4,7,0,0
TX,13,,0,961,5109,379,759,180,197,0,,1400,5109,485619,39620,407151,13,1900,149,1,0,13,13,1,13,0,0
UT,2,,0,961,5109,379,759,180,197,0,,1400,5109,485619,39620,407151,2,1900,149,1,0,2,2,1,2,0,0
VA,8,53,0,961,5109,379,759,180,197,0,,1400,5109,485619,39620,407151,38775,1900,149,5,15,61,61,20,61,0,0
VT,1,60,0,961,5109,379,759,180,197,0,,1400,5109,485619,39620,407151,38775,1900,149,0,24,61,61,24,61,0,0
WA,1453,4160,0,961,5109,379,759,180,197,0,,37,5109,485619,39620,407151,488,1900,149,216,1568,5613,5613,1784,5613,2,0
WI,2,36,0,961,5109,379,759,180,197,0,,1400,5109,485619,39620,407151,2,1900,149,1,0,38,38,1,38,0,0
WV,0,2,3,961,5109,379,759,180,197,0,,1400,5109,485619,39620,407151,38775,1900,149,0,0,5,2,0,2,0,0
WY,0,0,0,961,5109,379,759,180,197,0,,1400,5109,485619,39620,407151,38775,1900,149,0,0,0,0,0,0,0,0
AK,0,23,9,961,5109,379,759,180,197,0,,0,5109,23,39620,407151,0,1900,149,0,9,32,23,9,23,0,0
AL,0,,0,961,5109,379,759,180,197,0,,1400,5109,485619,39620,407151,0,1900,149,0,0,0,0,0,0,0,0
AR,0,12,0,961,5109,379,759,180,197,0,,1400,5109,485619,39620,407151,0,1900,149,0,6,12,12,6,12,0,0
AZ,5,44,7,961,8,379,759,180,197,0,,1400,8,49,39620,407151,38775,1900,149,0,0,56,49,0,49,0,2
CA,114,690,0,961,5109,379,759,180,197,0,,1400,5109,804,39620,407151,38775,1900,149,26,228,804,804,254,804,0,0
CO,9,133,0,961,5109,379,759,180,197,0,,1400,5109,485619,39620,407151,38775,1900,149,1,29,142,142,30,142,0,0
CT,1,46,0,961,5109,379,759,180,197,0,,1400,5109,485619,39620,407151,38775,1900,149,0,17,47,47,17,47,0,0
DC,1,14,3,961,5109,379,759,180,197,0,,1400,5109,485619,39620,407151,38775,1900,149,0,4,18,15,4,15,0,0
DE,0,15,3,961,5109,379,759,180,197,0,,0,5109,485619,39620,407151,38775,0,0,0,5,18,15,5,15,0,0
FL,18,140,115,961,5109,379,759,180,197,0,,1400,5109,485619,39620,407151,38775,1900,149,1,22,273,158,23,158,0,0
GA,12,,0,961,5109,379,759,180,197,0,,1400,5109,12,39620,407151,38775,1900,149,5,0,12,12,5,12,0,0
HI,2,,0,961,5109,379,759,180,197,0,,1400,5109,485619,39620,407151,38775,1900,149,1,0,2,2,1,2,0,0
IA,3,26,8,961,5109,379,759,180,197,0,,1400,5109,485619,39620,407151,3,1900,149,3,11,37,29,14,29,0,0
ID,0,41,0,961,5109,379,759,180,197,0,,1400,5109,41,39620,407151,38775,1900,149,0,14,41,41,14,41,0,0
IL,7,191,44,961,5109,379,759,180,197,0,,1400,5109,485619,39620,407151,38775,1900,149,1,0,242,198,1,198,0,0
IN,2,,0,961,5109,379,759,180,197,0,,1400,5109,485619,39620,407151,38775,1900,149,0,0,2,2,0,2,0,0
KS,1,11,0,961,5109,379,759,180,197,0,,1400,5109,485619,39620,407151,38775,1900,149,0,0,12,12,0,12,0,0
KY,4,17,0,961,5109,379,759,180,197,0,,1400,5109,485619,39620,407151,38775,1900,149,3,4,21,21,7,21,0,0
LA,1,5,0,961,5109,379,759,180,197,0,,1400,5109,485619,39620,407151,38775,1900,149,1,0,6,6,1,6,0,0
MD,5,73,0,961,5109,379,759,180,197,0,,1400,5109,485619,39620,407151,38775,1900,149,2,21,78,78,23,78,0,0
ME,0,1,0,961,5109,379,759,180,197,0,,1400,5109,485619,39620,407151,38775,1900,149,0,0,1,1,0,1,0,0
MI,254,36,11,961,5109,379,759,180,197,0,,1400,5109,485619,39620,407151,372,0,0,86,10,301,290,96,290,0,0
MN,5,80,0,961,5109,379,759,180,197,0,,1400,5109,85,39620,407151,38775,1900,149,3,32,85,85,35,85,0,0
MO,1,,0,961,5109,379,759,180,197,0,,1400,5109,36,7,29,38775,1900,149,0,0,1,1,0,1,0,0
MS,0,,0,961,5109,379,759,180,197,0,,1400,5109,485619,39620,407151,38775,1900,149,0,0,0,0,0,0,0,0
MT,0,11,0,961,5109,379,759,180,197,0,,1400,5109,485619,39620,407151,38775,1900,149,0,0,11,11,0,11,0,0
NC,2,,0,961,5109,379,759,180,197,0,,1400,5109,485619,39620,407151,38775,1900,149,0,0,2,2,0,2,0,0
ND,0,0,0,961,5109,379,759,180,197,0,,1400,5109,485619,39620,407151,38775,1900,149,0,0,0,0,0,0,0,0
NE,3,36,9,961,5109,379,759,180,197,0,,1400,5109,485619,39620,407151,38775,1900,149,2,19,48,39,21,39,0,0
NH,4,38,5,961,5109,379,759,180,197,0,,1400,5109,485619,39620,407151,38775,1900,149,0,0,47,42,0,42,0,0
NJ,11,35,14,961,5109,379,759,180,197,0,,1400,5109,485619,39620,407151,38775,1900,149,5,4,60,46,9,46,0,0
NM,0,57,0,961,5109,379,759,180,197,0,,1400,5109,485619,39620,407151,38775,1900,149,0,9,57,57,9,57,0,0
NV,1,14,0,961,5109,379,759,180,197,0,,0,5109,485619,39620,407151,38775,1900,149,0,0,15,15,0,15,0,0
NY,142,92,0,961,5109,379,759,180,197,0,,1400,5109,485619,39620,407151,38775,1900,149,37,0,234,234,37,234,0,0
OH,3,11,5,961,5109,379,759,180,197,0,,1400,5109,485619,39620,407151,3,1900,149,3,1,19,14,4,14,0,0
OK,1,8,10,961,5109,379,759,180,197,0,,1400,5109,485619,39620,407151,38775,1900,149,0,0,19,9,0,9,0,0
OR,14,165,52,961,5109,379,759,180,197,0,,1400,5109,485619,39620,407151,38775,1900,149,0,65,231,179,65,179,0,0
PA,10,,0,961,5109,379,759,180,197,0,,1400,5109,485619,39620,407151,38775,1900,149,4,0,10,10,4,10,0,0
RI,4,82,6,961,5109,379,759,180,197,0,,1400,5109,89,4,85,4,1900,149,1,15,92,86,16,86,0,0
SC,7,24,0,961,5109,379,759,180,197,0,,1400,5109,485619,39620,407151,38775,1900,149,5,16,31,31,21,31,0,0
SD,0,5,0,961,5109,379,759,180,197,0,,1400,5109,485619,39620,407151,38775,1900,149,0,0,5,5,0,5,0,0
TN,3,,0,961,5109,379,759,180,197,0,,1400,5109,485619,39620,407151,38775,1900,149,0,0,3,3,0,3,0,0
TX,12,,0,961,5109,379,759,180,197,0,,1400,5109,485619,39620,407151,12,1900,149,4,0,12,12,4,12,0,0
UT,1,,0,961,5109,379,759,180,197,0,,1400,5109,485619,39620,407151,1,1900,149,0,0,1,1,0,1,0,0
VA,3,38,9,961,5109,379,759,180,197,0,,1400,5109,485619,39620,407151,38775,1900,149,1,2,50,41,3,41,0,0
VT,1,36,0,961,5109,379,759,180,197,0,,1400,5109,485619,39620,407151,38775,1900,149,0,6,37,37,6,37,0,0
WA,1237,2592,0,961,5109,379,759,180,197,0,,35,5109,485619,39620,407151,378,1900,149,172,852,3829,3829,1024,3829,4,0
WI,1,36,0,961,5109,379,759,180,197,0,,1400,5109,485619,39620,407151,1,1900,149,0,5,37,37,5,37,0,0
WV,0,2,3,961,5109,379,759,180,197,0,,1400,5109,485619,39620,407151,38775,1900,149,0,0,5,2,0,2,0,0
WY,0,,0,961,5109,379,759,180,197,0,,1400,5109,485619,39620,407151,38775,1900,149,0,0,0,0,0,0,0,0
AK,0,14,6,961,5109,379,759,180,197,0,,0,5109,14,39620,407151,0,1900,149,0,2,20,14,2,14,0,0
AL,0,,0,961,5109,379,759,180,197,0,,1400,5109,485619,39620,407151,0,1900,149,0,0,0,0,0,0,0,0
AR,0,6,0,961,5109,379,759,180,197,0,,1400,5109,485619,39620,407151,0,1900,149,0,0,6,6,0,6,0,0
AZ,5,44,7,961,6,379,759,180,197,0,,1400,6,49,39620,407151,38775,1900,149,0,0,56,49,0,49,0,0
CA,88,462,0,961,5109,379,759,180,197,0,,1400,5109,550,39620,407151,38775,1900,149,19,0,550,550,19,550,0,0
CO,8,104,0,961,5109,379,759,180,197,0,,1400,5109,485619,39620,407151,38775,1900,149,0,49,112,112,49,112,0,0
CT,1,29,8,961,5109,379,759,180,197,0,,1400,5109,485619,39620,407151,38775,1900,149,1,29,38,30,30,30,0,0
DC,1,10,0,961,5109,379,759,180,197,0,,1400,5109,485619,39620,407151,38775,1900,149,1,2,11,11,3,11,0,0
DE,0,10,0,961,5109,379,759,180,197,0,,0,5109,485619,39620,407151,38775,0,0,0,0,10,10,0,10,0,0
FL,17,118,108,961,5109,379,759,180,197,0,,1400,5109,485619,39620,407151,38775,1900,149,3,18,243,135,21,135,0,0
GA,7,,0,961,5109,379,759,180,197,0,,1400,5109,7,39620,407151,38775,1900,149,1,0,7,7,1,7,0,0
HI,1,,0,961,5109,379,759,180,197,0,,1400,5109,485619,39620,407151,38775,1900,149,0,0,1,1,0,1,0,0
IA,0,15,2,961,5109,379,759,180,197,0,,1400,5109,485619,39620,407151,0,1900,149,0,0,17,15,0,15,0,0
ID,0,27,0,961,5109,379,759,180,197,0,,1400,5109,27,39620,407151,38775,1900,149,0,0,27,27,0,27,0,0
IL,6,191,44,961,5109,379,759,180,197,0,,1400,5109,485619,39620,407151,38775,1900,149,0,0,241,197,0,197,0,0
IN,2,,0,961,5109,379,759,180,197,0,,1400,5109,485619,39620,407151,38775,1900,149,1,0,2,2,1,2,0,0
KS,1,11,0,961,5109,379,759,180,197,0,,1400,5109,485619,39620,407151,38775,1900,149,1,0,12,12,1,12,0,0
KY,1,13,0,961,5109,379,759,180,197,0,,1400,5109,485619,39620,407151,38775,1900,149,0,4,14,14,4,14,0,0
LA,0,5,0,961,5109,379,759,180,197,0,,1400,5109,485619,39620,407151,38775,1900,149,0,5,5,5,5,5,0,0
MD,3,52,0,961,5109,379,759,180,197,0,,1400,5109,485619,39620,407151,38775,1900,149,0,11,55,55,11,55,0,0
ME,0,1,0,961,5109,379,759,180,197,0,,1400,5109,485619,39620,407151,38775,1900,149,0,0,1,1,0,1,0,0
MI,168,26,10,961,5109,379,759,180,197,0,,1400,5109,485619,39620,407151,251,0,0,40,8,204,194,48,194,0,0
MN,2,48,0,961,5109,379,759,180,197,0,,1400,5109,50,39620,407151,38775,1900,149,0,0,50,50,0,50,0,0
MO,1,,0,961,5109,379,759,180,197,0,,1400,5109,31,7,24,38775,1900,149,1,0,1,1,1,1,0,0
MS,0,,0,961,5109,379,759,180,197,0,,1400,5109,485619,39620,407151,38775,1900,149,0,0,0,0,0,0,0,0
MT,0,11,0,961,5109,379,759,180,197,0,,1400,5109,485619,39620,407151,38775,1900,149,0,0,11,11,0,11,0,0
NC,2,,0,961,5109,379,759,180,197,0,,1400,5109,485619,39620,407151,38775,1900,149,0,0,2,2,0,2,0,0
ND,0,0,0,961,5109,379,759,180,197,0,,1400,5109,485619,39620,407151,38775,1900,149,0,0,0,0,0,0,0,0
NE,1,17,5,961,5109,379,759,180,197,0,,1400,5109,485619,39620,407151,38775,1900,149,0,0,23,18,0,18,0,0
NH,4,38,5,961,5109,379,759,180,197,0,,1400,5109,485619,39620,407151,38775,1900,149,2,18,47,42,20,42,0,0
NJ,6,31,0,961,5109,379,759,180,197,0,,1400,5109,485619,39620,407151,38775,1900,149,2,31,37,37,33,37,0,0
NM,0,48,0,961,5109,379,759,180,197,0,,1400,5109,485619,39620,407151,38775,1900,149,0,0,48,48,0,48,0,0
NV,1,14,0,961,5109,379,759,180,197,0,,0,5109,485619,39620,407151,38775,1900,149,0,0,15,15,0,15,0,0
NY,105,92,0,961,5109,379,759,180,197,0,,1400,5109,485619,39620,407151,38775,1900,149,29,0,197,197,29,197,0,0
OH,0,10,4,961,5109,379,759,180,197,0,,1400,5109,485619,39620,407151,0,1900,149,0,1,14,10,1,10,0,0
OK,1,8,2,961,5109,379,759,180,197,0,,1400,5109,485619,39620,407151,38775,1900,149,0,8,11,9,8,9,0,0
OR,14,100,53,961,5109,379,759,180,197,0,,1400,5109,485619,39620,407151,38775,1900,149,7,23,167,114,30,114,0,0
PA,6,,0,961,5109,379,759,180,197,0,,1400,5109,485619,39620,407151,38775,1900,149,2,0,6,6,2,6,0,0
RI,3,67,12,961,5109,379,759,180,197,0,,1400,5109,73,3,70,3,1900,149,0,18,82,70,18,70,0,0
SC,2,8,0,961,5109,379,759,180,197,0,,1400,5109,485619,39620,407151,38775,1900,149,0,0,10,10,0,10,0,0
SD,0,5,0,961,5109,379,759,180,197,0,,1400,5109,485619,39620,407151,38775,1900,149,0,0,5,5,0,5,0,0
TN,3,,0,961,5109,379,759,180,197,0,,1400,5109,485619,39620,407151,38775,1900,149,2,0,3,3,2,3,0,0
TX,8,,0,961,5109,379,759,180,197,0,,1400,5109,485619,39620,407151,8,1900,149,0,0,8,8,0,8,0,0
UT,1,,0,961,5109,379,759,180,197,0,,1400,5109,485619,39620,407151,1,1900,149,0,0,1,1,0,1,0,0
VA,2,36,6,961,5109,379,759,180,197,0,,1400,5109,485619,39620,407151,38775,1900,149,2,5,44,38,7,38,0,0
VT,1,30,0,961,5109,379,759,180,197,0,,1400,5109,485619,39620,407151,38775,1900,149,0,5,31,31,5,31,0,0
WA,1065,1740,60,961,5109,379,759,180,197,0,,31,5109,485619,39620,407151,317,1900,149,153,370,2865,2805,523,2805,4,0
WI,1,31,12,961,5109,379,759,180,197,0,,1400,5109,485619,39620,407151,1,1900,149,0,0,44,32,0,32,0,0
WV,0,2,3,961,5109,379,759,180,197,0,,1400,5109,485619,39620,407151,38775,1900,149,0,0,5,2,0,2,0,0
WY,0,,0,961,5109,379,759,180,197,0,,1400,5109,485619,39620,407151,38775,1900,149,0,0,0,0,0,0,0,0
AK,0,12,2,961,5109,379,759,180,197,0,,0,5109,12,39620,407151,0,1900,149,0,4,14,12,4,12,0,0
AL,0,,0,961,5109,379,759,180,197,0,,1400,5109,485619,39620,407151,0,1900,149,0,0,0,0,0,0,0,0
AR,0,6,0,961,5109,379,759,180,197,0,,1400,5109,485619,39620,407151,0,1900,149,0,0,6,6,0,6,0,0
AZ,5,44,7,961,6,379,759,180,197,0,,1400,6,49,39620,407151,38775,1900,149,2,11,56,49,13,49,0,0
CA,69,462,0,961,5109,379,759,180,197,0,,1400,5109,531,39620,407151,38775,1900,149,9,0,531,531,9,531,0,0
CO,8,55,69,961,5109,379,759,180,197,0,,1400,5109,485619,39620,407151,38775,1900,149,6,9,132,63,15,63,0,0
CT,0,,0,961,5109,379,759,180,197,0,,1400,5109,485619,39620,407151,38775,1900,149,0,0,0,0,0,0,0,0
DC,0,8,1,961,5109,379,759,180,197,0,,1400,5109,485619,39620,407151,38775,1900,149,0,0,9,8,0,8,0,0
DE,0,10,0,961,5109,379,759,180,197,0,,1400,5109,485619,39620,407151,38775,1900,149,0,0,10,10,0,10,0,0
FL,14,100,88,961,5109,379,759,180,197,0,,1400,5109,485619,39620,407151,38775,1900,149,5,45,202,114,50,114,0,0
GA,6,,0,961,5109,379,759,180,197,0,,1400,5109,6,39620,407151,38775,1900,149,4,0,6,6,4,6,0,0
HI,1,,0,961,5109,379,759,180,197,0,,1400,5109,485619,39620,407151,38775,1900,149,0,0,1,1,0,1,0,0
IA,0,15,2,961,5109,379,759,180,197,0,,1400,5109,485619,39620,407151,0,1900,149,0,0,17,15,0,15,0,0
ID,0,27,0,961,5109,379,759,180,197,0,,1400,5109,27,39620,407151,38775,1900,149,0,0,27,27,0,27,0,0
IL,6,191,44,961,5109,379,759,180,197,0,,1400,5109,485619,39620,407151,38775,1900,149,1,11,241,197,12,197,0,0
IN,1,,0,961,5109,379,759,180,197,0,,1400,5109,485619,39620,407151,38775,1900,149,0,0,1,1,0,1,0,0
KS,0,11,2,961,5109,379,759,180,197,0,,1400,5109,485619,39620,407151,38775,1900,149,0,7,13,11,7,11,0,0
KY,1,9,0,961,5109,379,759,180,197,0,,1400,5109,485619,39620,407151,38775,1900,149,1,2,10,10,3,10,0,0
LA,0,,0,961,5109,379,759,180,197,0,,1400,5109,485619,39620,407151,38775,1900,149,0,0,0,0,0,0,0,0
MD,3,41,0,961,5109,379,759,180,197,0,,1400,5109,485619,39620,407151,38775,1900,149,0,15,44,44,15,44,0,0
ME,0,1,0,961,5109,379,759,180,197,0,,1400,5109,485619,39620,407151,38775,1900,149,0,0,1,1,0,1,0,0
MI,128,18,9,961,5109,379,759,180,197,0,,1400,5109,485619,39620,407151,188,0,0,30,10,155,146,40,146,0,0
MN,2,48,0,961,5109,379,759,180,197,0,,1400,5109,50,39620,407151,38775,1900,149,1,12,50,50,13,50,0,0
MO,0,,0,961,5109,379,759,180,197,0,,1400,5109,23,6,17,38775,1900,149,0,0,0,0,0,0,0,0
MS,0,,0,961,5109,379,759,180,197,0,,1400,5109,485619,39620,407151,38775,1900,149,0,0,0,0,0,0,0,0
MT,0,11,0,961,5109,379,759,180,197,0,,1400,5109,485619,39620,407151,38775,1900,149,0,0,11,11,0,11,0,0
NC,2,,0,961,5109,379,759,180,197,0,,1400,5109,485619,39620,407151,38775,1900,149,0,0,2,2,0,2,0,0
ND,0,0,0,961,5109,379,759,180,197,0,,1400,5109,485619,39620,407151,38775,1900,149,0,0,0,0,0,0,0,0
NE,1,17,5,961,5109,379,759,180,197,0,,1400,5109,485619,39620,407151,38775,1900,149,1,0,23,18,1,18,0,0
NH,2,20,3,961,5109,379,759,180,197,0,,1400,5109,485619,39620,407151,38775,1900,149,0,0,25,22,0,22,0,0
NJ,4,,1,961,5109,379,759,180,197,0,,1400,5109,485619,39620,407151,38775,1900,149,3,0,5,4,3,4,0,0
NM,0,48,0,961,5109,379,759,180,197,0,,1400,5109,485619,39620,407151,38775,1900,149,0,32,48,48,32,48,0,0
NV,1,14,0,961,5109,379,759,180,197,0,,0,5109,485619,39620,407151,38775,1900,149,0,0,15,15,0,15,0,0
NY,76,92,236,961,5109,379,759,180,197,0,,1400,5109,485619,39620,407151,38775,1900,149,43,0,404,168,43,168,0,0
OH,0,9,5,961,5109,379,759,180,197,0,,1400,5109,485619,39620,407151,0,1900,149,0,1,14,9,1,9,0,0
OK,1,,0,961,5109,379,759,180,197,0,,1400,5109,485619,39620,407151,38775,1900,149,0,0,1,1,0,1,0,0
OR,7,77,40,961,5109,379,759,180,197,0,,1400,5109,485619,39620,407151,38775,1900,149,4,13,124,84,17,84,0,0
PA,4,,0,961,5109,379,759,180,197,0,,1400,5109,485619,39620,407151,38775,1900,149,2,0,4,4,2,4,0,0
RI,3,49,0,961,5109,379,759,180,197,0,,1400,5109,55,3,52,3,1900,149,0,19,52,52,19,52,0,0
SC,2,8,0,961,5109,379,759,180,197,0,,1400,5109,485619,39620,407151,38775,1900,149,2,3,10,10,5,10,0,0
SD,0,5,0,961,5109,379,759,180,197,0,,1400,5109,485619,39620,407151,38775,1900,149,0,0,5,5,0,5,0,0
TN,1,,0,961,5109,379,759,180,197,0,,1400,5109,485619,39620,407151,38775,1900,149,0,0,1,1,0,1,0,0
TX,8,,0,961,5109,379,759,180,197,0,,1400,5109,485619,39620,407151,8,1900,149,3,0,8,8,3,8,0,0
UT,1,,0,961,5109,379,759,180,197,0,,1400,5109,485619,39620,407151,1,1900,149,0,0,1,1,0,1,0,0
VA,0,31,7,961,5109,379,759,180,197,0,,1400,5109,485619,39620,407151,38775,1900,149,0,10,38,31,10,31,0,0
VT,1,25,0,961,5109,379,759,180,197,0,,1400,5109,485619,39620,407151,38775,1900,149,1,25,26,26,26,26,0,0
WA,912,1370,66,961,5109,379,759,180,197,0,,27,5109,485619,39620,407151,256,1900,149,99,304,2348,2282,403,2282,1,0
WI,1,31,12,961,5109,379,759,180,197,0,,1400,5109,485619,39620,407151,1,1900,149,0,0,44,32,0,32,0,0
WV,0,2,3,961,5109,379,759,180,197,0,,1400,5109,485619,39620,407151,38775,1900,149,0,1,5,2,1,2,0,0
WY,0,,0,961,5109,379,759,180,197,0,,1400,5109,485619,39620,407151,38775,1900,149,0,0,0,0,0,0,0,0
AK,0,8,1,961,5109,379,759,180,197,0,,0,5109,8,39620,407151,0,1900,149,0,0,9,8,0,8,0,0
AR,0,6,0,961,5109,379,759,180,197,0,,1400,5109,485619,39620,407151,0,1900,149,0,0,6,6,0,6,0,0
AZ,3,33,15,961,6,379,759,180,197,0,,1400,6,36,39620,407151,38775,1900,149,1,5,51,36,6,36,0,1
CA,60,462,0,961,5109,379,759,180,197,0,,1400,5109,522,39620,407151,38775,1900,149,7,0,522,522,7,522,0,0
CO,2,46,30,961,5109,379,759,180,197,0,,1400,5109,485619,39620,407151,38775,1900,149,2,27,78,48,29,48,0,0
DC,0,8,1,961,5109,379,759,180,197,0,,1400,5109,485619,39620,407151,38775,1900,149,0,2,9,8,2,8,0,0
DE,0,10,0,961,5109,379,759,180,197,0,,1400,5109,485619,39620,407151,38775,1900,149,0,0,10,10,0,10,0,0
FL,9,55,51,961,5109,379,759,180,197,0,,1400,5109,485619,39620,407151,38775,1900,149,0,24,115,64,24,64,0,0
GA,2,,0,961,5109,379,759,180,197,0,,1400,5109,2,39620,407151,38775,1900,149,0,0,2,2,0,2,0,0
IA,0,15,2,961,5109,379,759,180,197,0,,1400,5109,485619,39620,407151,0,1900,149,0,0,17,15,0,15,0,0
IL,5,180,35,961,5109,379,759,180,197,0,,1400,5109,485619,39620,407151,38775,1900,149,0,15,220,185,15,185,0,0
IN,1,,0,961,5109,379,759,180,197,0,,1400,5109,485619,39620,407151,38775,1900,149,0,0,1,1,0,1,0,0
KS,0,4,0,961,5109,379,759,180,197,0,,1400,5109,485619,39620,407151,38775,1900,149,0,0,4,4,0,4,0,0
KY,0,7,3,961,5109,379,759,180,197,0,,1400,5109,485619,39620,407151,38775,1900,149,0,0,10,7,0,7,0,0
MD,3,26,12,961,5109,379,759,180,197,0,,1400,5109,485619,39620,407151,38775,1900,149,3,9,41,29,12,29,0,0
MI,98,8,8,961,5109,379,759,180,197,0,,1400,5109,485619,39620,407151,140,0,0,26,0,114,106,26,106,0,0
MN,1,36,0,961,5109,379,759,180,197,0,,1400,5109,37,39620,407151,38775,1900,149,0,0,37,37,0,37,0,0
NC,2,,0,961,5109,379,759,180,197,0,,1400,5109,485619,39620,407151,38775,1900,149,1,0,2,2,1,2,0,0
NE,0,17,5,961,5109,379,759,180,197,0,,1400,5109,485619,39620,407151,38775,1900,149,0,0,22,17,0,17,0,0
NH,2,20,3,961,5109,379,759,180,197,0,,1400,5109,485619,39620,407151,38775,1900,149,0,4,25,22,4,22,0,0
NJ,1,,0,961,5109,379,759,180,197,0,,1400,5109,485619,39620,407151,38775,1900,149,0,0,1,1,0,1,0,0
NM,0,16,0,961,5109,379,759,180,197,0,,1400,5109,485619,39620,407151,38775,1900,149,0,0,16,16,0,16,0,0
NV,1,14,0,961,5109,379,759,180,197,0,,0,5109,485619,39620,407151,74,0,149,0,0,15,15,0,15,0,0
NY,33,92,236,961,5109,379,759,180,197,0,,1400,5109,485619,39620,407151,38775,1900,149,11,16,361,125,27,125,0,0
OH,0,8,2,961,5109,379,759,180,197,0,,1400,5109,485619,39620,407151,0,1900,149,0,1,10,8,1,8,0,0
OR,3,64,28,961,5109,379,759,180,197,0,,1400,5109,485619,39620,407151,38775,1900,149,0,19,95,67,19,67,0,0
PA,2,,0,961,5109,379,759,180,197,0,,1400,5109,485619,39620,407151,38775,1900,149,0,0,2,2,0,2,0,0
RI,3,30,0,961,5109,379,759,180,197,0,,1400,5109,36,3,33,3,1900,149,0,11,33,33,11,33,0,0
SC,0,5,0,961,5109,379,759,180,197,0,,1400,5109,485619,39620,407151,38775,1900,149,0,0,5,5,0,5,0,0
TN,1,,0,961,5109,379,759,180,197,0,,1400,5109,485619,39620,407151,38775,1900,149,0,0,1,1,0,1,0,0
TX,5,,0,961,5109,379,759,180,197,0,,1400,5109,485619,39620,407151,5,1900,149,4,0,5,5,4,5,0,0
VA,0,21,10,961,5109,379,759,180,197,0,,1400,5109,485619,39620,407151,38775,1900,149,0,3,31,21,3,21,0,0
VT,0,0,0,961,5109,379,759,180,197,0,,1400,5109,485619,39620,407151,38775,1900,149,0,0,0,0,0,0,0,0
WA,813,1066,0,961,5109,379,759,180,197,0,,26,5109,485619,39620,407151,218,1900,149,82,394,1879,1879,476,1879,6,0
WI,1,31,12,961,5109,379,759,180,197,0,,1400,5109,485619,39620,407151,1,1900,149,0,12,44,32,12,32,0,0
WV,0,1,4,961,5109,379,759,180,197,0,,1400,5109,485619,39620,407151,38775,1900,149,0,0,5,1,0,1,0,0
AZ,2,28,6,961,5,379,759,180,197,0,,1400,5,30,39620,407151,38775,1900,149,0,1,36,30,1,30,0,1
CA,53,462,0,961,5109,379,759,180,197,0,,1400,5109,515,39620,407151,38775,1900,149,0,0,515,515,0,515,0,0
CO,0,19,21,961,5109,379,759,180,197,0,,1400,5109,485619,39620,407151,38775,1900,149,0,0,40,19,0,19,0,0
DC,0,6,2,961,5109,379,759,180,197,0,,1400,5109,485619,39620,407151,38775,1900,149,0,0,8,6,0,6,0,0
FL,9,31,69,961,5109,379,759,180,197,0,,1400,5109,485619,39620,407151,38775,1900,149,7,7,109,40,14,40,0,0
GA,2,,0,961,5109,379,759,180,197,0,,1400,5109,2,39620,407151,38775,1900,149,0,0,2,2,0,2,0,0
IL,5,165,27,961,5109,379,759,180,197,0,,1400,5109,485619,39620,407151,38775,1900,149,1,41,197,170,42,170,0,0
MD,0,17,14,961,5109,379,759,180,197,0,,1400,5109,485619,39620,407151,38775,1900,149,0,0,31,17,0,17,0,0
MI,72,8,0,961,5109,379,759,180,197,0,,1400,5109,485619,39620,407151,100,0,0,20,8,80,80,28,80,0,0
NC,1,,0,961,5109,379,759,180,197,0,,1400,5109,485619,39620,407151,38775,1900,149,0,0,1,1,0,1,0,0
NE,0,17,5,961,5109,379,759,180,197,0,,1400,5109,485619,39620,407151,38775,1900,149,0,0,22,17,0,17,0,0
NH,2,16,4,961,5109,379,759,180,197,0,,1400,5109,485619,39620,407151,38775,1900,149,0,6,22,18,6,18,0,0
NJ,1,,0,961,5109,379,759,180,197,0,,1400,5109,485619,39620,407151,38775,1900,149,0,0,1,1,0,1,0,0
NV,1,14,0,961,5109,379,759,180,197,0,,0,5109,485619,39620,407151,38775,1900,149,0,0,15,15,0,15,0,0
NY,22,76,24,961,5109,379,759,180,197,0,,1400,5109,485619,39620,407151,38775,1900,149,16,28,122,98,44,98,0,0
OH,0,7,3,961,5109,379,759,180,197,0,,1400,5109,485619,39620,407151,0,1900,149,0,0,10,7,0,7,0,0
OR,3,45,13,961,5109,379,759,180,197,0,,1400,5109,485619,39620,407151,38775,1900,149,0,16,61,48,16,48,0,0
RI,3,19,0,961,5109,379,759,180,197,0,,1400,5109,23,2,21,3,1900,149,1,4,22,22,5,22,0,0
SC,0,5,0,961,5109,379,759,180,197,0,,1400,5109,485619,39620,407151,38775,1900,149,0,0,5,5,0,5,0,0
TN,1,,0,961,5109,379,759,180,197,0,,1400,5109,485619,39620,407151,38775,1900,149,0,0,1,1,0,1,0,0
TX,1,,0,961,5109,379,759,180,197,0,,1400,5109,485619,39620,407151,1,1900,149,0,0,1,1,0,1,0,0
VA,0,18,3,961,5109,379,759,180,197,0,,1400,5109,485619,39620,407151,38775,1900,149,0,0,21,18,0,18,0,0
WA,731,672,0,961,5109,379,759,180,197,0,,20,5109,485619,39620,407151,179,1900,149,105,255,1403,1403,360,1403,4,0
WI,1,19,6,961,5109,379,759,180,197,0,,1400,5109,485619,39620,407151,1,1900,149,0,0,26,20,0,20,0,0
AZ,2,27,5,961,4,379,759,180,197,0,,1400,4,29,39620,407151,38775,1900,149,0,0,34,29,0,29,0,0
CA,53,462,0,961,5109,379,759,180,197,0,,1400,5109,515,39620,407151,38775,1900,149,0,0,515,515,0,515,0,0
FL,2,24,16,961,5109,379,759,180,197,0,,1400,5109,485619,39620,407151,38775,1900,149,0,0,42,26,0,26,0,0
GA,2,,0,961,5109,379,759,180,197,0,,1400,5109,2,39620,407151,38775,1900,149,0,0,2,2,0,2,0,0
IL,4,124,27,961,5109,379,759,180,197,0,,1400,5109,485619,39620,407151,38775,1900,149,0,0,155,128,0,128,0,0
MI,52,,0,961,5109,379,759,180,197,0,,1400,5109,485619,39620,407151,74,0,0,18,0,52,52,18,52,0,0
NC,1,,0,961,5109,379,759,180,197,0,,1400,5109,485619,39620,407151,38775,1900,149,0,0,1,1,0,1,0,0
NH,2,10,7,961,5109,379,759,180,197,0,,1400,5109,485619,39620,407151,38775,1900,149,0,0,19,12,0,12,0,0
NY,6,48,24,961,5109,379,759,180,197,0,,1400,5109,485619,39620,407151,14,0,149,0,0,78,54,0,54,0,0
OR,3,29,18,961,5109,379,759,180,197,0,,1400,5109,485619,39620,407151,38775,1900,149,0,0,50,32,0,32,0,0
RI,2,15,0,961,5109,379,759,180,197,0,,1400,5109,19,2,17,2,1900,149,0,10,17,17,10,17,0,0
SC,0,5,0,961,5109,379,759,180,197,0,,1400,5109,485619,39620,407151,38775,1900,149,0,0,5,5,0,5,0,0
TX,1,,0,961,5109,379,759,180,197,0,,1400,5109,485619,39620,407151,1,1900,149,0,0,1,1,0,1,0,0
WA,626,417,0,961,5109,379,759,180,197,0,,16,5109,485619,39620,407151,128,1900,149,92,153,1043,1043,245,1043,2,0
WI,1,19,6,961,5109,379,759,180,197,0,,1400,5109,485619,39620,407151,1,1900,149,0,0,26,20,0,20,0,0
MI,34,,0,961,5109,379,759,180,197,0,,1400,5109,485619,39620,407151,50,1900,0,16,0,34,34,16,34,0,0
RI,2,5,0,961,5109,379,759,180,197,0,,1400,5109,7,2,5,2,1900,149,0,2,7,7,2,7,0,0
WA,534,264,0,961,5109,379,759,180,197,0,,14,5109,485619,39620,407151,90,1900,149,84,141,798,798,225,798,3,0
MI,18,,0,961,5109,379,759,180,197,0,,1400,5109,485619,39620,407151,27,1900,0,9,0,18,18,9,18,0,0
RI,2,3,0,961,5109,379,759,180,197,0,,1400,5109,5,2,3,2,1900,149,0,1,5,5,1,5,0,0
WA,450,123,0,961,5109,379,759,180,197,0,,11,5109,485619,39620,407151,65,1900,149,73,111,573,573,184,573,3,0
MI,9,,0,961,5109,379,759,180,197,0,,1400,5109,485619,39620,407151,14,0,0,0,0,9,9,0,9,0,0
RI,2,2,0,961,5109,379,759,180,197,0,,1400,5109,4,2,2,2,1900,149,0,0,4,4,0,4,0,0
WA,377,12,0,961,5109,379,759,180,197,0,,8,5109,485619,39620,407151,34,1900,149,78,-5,389,389,73,389,3,0
WA,299,17,0,961,5109,379,759,180,197,0,,5,5109,485619,39620,407151,18,1900,149,24,17,316,316,41,316,1,0
WA,275,0,0,961,5109,379,759,180,197,0,,4,5109,485619,39620,407151,38775,1900,149,40,0,275,275,40,275,2,0
WA,235,0,0,961,5109,379,759,180,197,0,,2,5109,485619,39620,407151,38775,1900,149,27,0,235,235,27,235,0,0
WA,208,0,0,961,5109,379,759,180,197,0,,2,5109,485619,39620,407151,38775,1900,149,29,0,208,208,29,208,2,0
WA,179,0,0,961,5109,379,759,180,197,0,,1400,5109,485619,39620,407151,38775,1900,149,31,0,179,179,31,179,0,0
WA,148,0,0,961,5109,379,759,180,197,0,,1400,5109,485619,39620,407151,38775,1900,149,26,0,148,148,26,148,0,0
WA,122,0,0,961,5109,379,759,180,197,0,,1400,5109,485619,39620,407151,38775,1900,149,16,0,122,122,16,122,0,0
WA,106,0,0,961,5109,379,759,180,197,0,,1400,5109,485619,39620,407151,38775,1900,149,13,0,106,106,13,106,0,0
WA,93,0,0,961,5109,379,759,180,197,0,,1400,5109,485619,39620,407151,38775,1900,149,11,0,93,93,11,93,0,0
WA,82,0,0,961,5109,379,759,180,197,0,,1400,5109,485619,39620,407151,38775,1900,149,13,0,82,82,13,82,0,0
WA,69,0,0,961,5109,379,759,180,197,0,,1400,5109,485619,39620,407151,38775,1900,149,10,0,69,69,10,69,0,0
WA,59,0,0,961,5109,379,759,180,197,0,,1400,5109,485619,39620,407151,38775,1900,149,9,0,59,59,9,59,0,0
WA,50,0,0,961,5109,379,759,180,197,0,,1400,5109,485619,39620,407151,38775,1900,149,15,0,50,50,15,50,0,0
WA,35,0,0,961,5109,379,759,180,197,0,,1400,5109,485619,39620,407151,38775,1900,149,7,0,35,35,7,35,0,0
WA,28,0,0,961,5109,379,759,180,197,0,,1400,5109,485619,39620,407151,38775,1900,149,7,0,28,28,7,28,0,0
WA,21,0,0,961,5109,379,759,180,197,0,,1400,5109,485619,39620,407151,38775,1900,149,3,0,21,21,3,21,0,0
WA,18,0,0,961,5109,379,759,180,197,0,,1400,5109,485619,39620,407151,38775,1900,149,0,0,18,18,0,18,0,0
WA,18,0,0,961,5109,379,759,180,197,0,,1400,5109,485619,39620,407151,38775,1900,149,1,0,18,18,1,18,0,0
WA,17,0,0,961,5109,379,759,180,197,0,,1400,5109,485619,39620,407151,38775,1900,149,1,0,17,17,1,17,0,0
WA,16,0,0,961,5109,379,759,180,197,0,,1400,5109,485619,39620,407151,38775,1900,149,3,0,16,16,3,16,0,0
WA,13,0,0,961,5109,379,759,180,197,0,,1400,5109,485619,39620,407151,38775,1900,149,0,0,13,13,0,13,0,0
WA,13,0,0,961,5109,379,759,180,197,0,,1400,5109,485619,39620,407151,38775,1900,149,1,0,13,13,1,13,0,0
WA,12,0,0,961,5109,379,759,180,197,0,,1400,5109,485619,39620,407151,38775,1900,149,1,0,12,12,1,12,0,0
WA,11,0,0,961,5109,379,759,180,197,0,,1400,5109,485619,39620,407151,38775,1900,149,3,0,11,11,3,11,0,0
WA,8,0,0,961,5109,379,759,180,197,0,,1400,5109,485619,39620,407151,38775,1900,149,0,0,8,8,0,8,0,0
WA,8,0,0,961,5109,379,759,180,197,0,,1400,5109,485619,39620,407151,38775,1900,149,1,0,8,8,1,8,0,0
WA,7,0,0,961,5109,379,759,180,197,0,,1400,5109,485619,39620,407151,38775,1900,149,1,0,7,7,1,7,0,0
WA,6,0,0,961,5109,379,759,180,197,0,,1400,5109,485619,39620,407151,38775,1900,149,2,0,6,6,2,6,0,0
WA,4,0,0,961,5109,379,759,180,197,0,,1400,5109,485619,39620,407151,38775,1900,149,1,0,4,4,1,4,0,0
WA,3,0,0,961,5109,379,759,180,197,0,,1400,5109,485619,39620,407151,38775,1900,149,0,0,3,3,0,3,0,0
WA,3,0,0,961,5109,379,759,180,197,0,,1400,5109,485619,39620,407151,38775,1900,149,0,0,3,3,0,3,0,0
WA,3,0,0,961,5109,379,759,180,197,0,,1400,5109,485619,39620,407151,38775,1900,149,1,0,3,3,1,3,0,0
WA,2,0,0,961,5109,379,759,180,197,0,,1400,5109,485619,39620,407151,38775,1900,149,0,0,2,2,0,2,0,0
WA,2,0,0,961,5109,379,759,180,197,0,,1400,5109,485619,39620,407151,38775,1900,149,0,0,2,2,0,2,0,0
WA,2,0,0,961,5109,379,759,180,197,0,,1400,5109,485619,39620,407151,38775,1900,149,0,0,2,2,0,2,0,0
WA,2,0,0,961,5109,379,759,180,197,0,,1400,5109,485619,39620,407151,38775,1900,149,0,0,2,2,0,2,0,0
WA,2,0,0,961,5109,379,759,180,197,0,,1400,5109,485619,39620,407151,38775,1900,149,0,0,2,2,0,2,0,0
WA,2,0,0,961,5109,379,759,180,197,0,,1400,5109,485619,39620,407151,38775,1900,149,0,0,2,2,0,2,0,0
WA,2,0,0,961,5109,379,759,180,197,0,,1400,5109,485619,39620,407151,38775,1900,149,0,0,2,2,0,2,0,0